Product code,Product name ,Unit name,Quantity,Rate,Amount,Tax,Gross amount,Month
12,7DAYS BABY WIPES,PIECE,1,8500,7203,1297,8500,January
27,ABC DENT 70G,PIECE,1,2000,1695,305,2000,January
61,AFROCARE JELLY 100G,PIECE,1,3000,2542,458,3000,January
62,AFROCARE PERFUMED GLYCERINE,PIECE,1,2500,2119,381,2500,January
66,AKABANGA CHILI OIL 20ML,PIECE,1,2500,2119,381,2500,January
88,ALWAYS LONG,PIECE,1,4200,3559,641,4200,January
91,ALWAYS ULTRA THIN,PIECE,1,3500,2966,534,3500,January
98,AMARA ALOEVERA 400ML,PIECE,1,8500,7203,1297,8500,January
111,AMARA HYDRATING GLYCERINE 400ML LOTION,PIECE,1,8500,7203,1297,8500,January
115,AMARA RAW SHEA 200ML,PIECE,1,5500,4661,839,5500,January
118,AMARA REJUVENATING ALOE 200ML,PIECE,1,6000,5085,915,6000,January
123,AMERICAN GARDEN BBQ SAUCE 510G,PIECE,1,17000,14407,2593,17000,January
131,AMERICAN GARDEN MUSTARD 14OZ,PIECE,1,15000,12712,2288,15000,January
136,AMERICAN GREEN GARDEN HONEY 200G,PIECE,1,8000,6780,1220,8000,January
209,Ariel color and style,PIECE,1,8000,6780,1220,8000,January
211,ARIEL DOWNY 1KG,PIECE,1,15500,13136,2364,15500,January
212,ARIEL DOWNY 500G,PIECE,1,8000,6780,1220,8000,January
214,ARIEL LAVENDER 1KG,PIECE,1,15500,13136,2364,15500,January
218,ARMAF AIR FRESHNER SPRING,PIECE,1,10000,8475,1525,10000,January
245,ARMF BEAU SPLASH FOR MEN,PIECE,1,16000,13559,2441,16000,January
279,ASANTEE PAPAYA SOAP,PIECE,1,6500,5508,992,6500,January
312,AUNT PORRIDGE 2KG,PIECE,1,28000,23729,4271,28000,January
331,AXE DARK TEMPTATION,PIECE,1,12000,10169,1831,12000,January
371,"BABY BASIN 20,000",PIECE,1,20000,16949,3051,20000,January
383,BABY BOTTLE 092 6000,PIECE,1,6000,5085,915,6000,January
388,BABY BOTTLES 12000,PIECE,1,12000,10169,1831,12000,January
413,BABY CUPS 3000,PIECE,1,3000,2542,458,3000,January
421,BABY DOLL LONG 50000,PIECE,1,50000,42373,7627,50000,January
443,BABY JUNIOR JELLY 24ML,PIECE,1,700,593,107,700,January
447,BABY JUNIOR100g,PIECE,1,3500,2966,534,3500,January
450,BABY LOVE TOY 15000,PIECE,1,15000,12712,2288,15000,January
466,BABY RATTLES,PIECE,1,22000,18644,3356,22000,January
480,BABY SPOONS 10000,PIECE,1,10000,8475,1525,10000,January
497,BABY& ME BABYJELLY 240ML,PIECE,1,5000,4237,763,5000,January
526,BALLET ALOE VERA 120MLS,PIECE,1,5000,4237,763,5000,January
532,BALLET BABY LOTION 240ML,PIECE,1,12000,10169,1831,12000,January
545,BALLOON NUMBERS 1500,PIECE,1,1500,1271,229,1500,January
551,BALLS 12000,PIECE,1,12000,10169,1831,12000,January
590,BASKETS 5000,PIECE,1,5000,4237,763,5000,January
667,BIRTHDAY CROWNS 5000,PIECE,1,5000,4237,763,5000,January
688,BIYINZIKA STANDARD1.2KG,PIECE,1,25000,21186,3814,25000,January
724,BLUE LADY SPRAY,PIECE,1,15000,12712,2288,15000,January
740,BODY LUXE PETROLEUM JELLY,PIECE,1,4500,3814,686,4500,January
745,BODYLUXE JELLY 500G,PIECE,1,10000,8475,1525,10000,January
765,BOTTLES 12000,PIECE,1,12000,10169,1831,12000,January
766,BOTTLES 17000,PIECE,1,17000,14407,2593,17000,January
767,BOTTLES 10000,PIECE,1,10000,8475,1525,10000,January
768,BOTTLES 13000,PIECE,1,13000,11017,1983,13000,January
769,BOTTLES 15000,PIECE,1,15000,12712,2288,15000,January
771,BOTTLES 18000,PIECE,1,18000,15254,2746,18000,January
790,BOX FILES 6000,PIECE,1,7000,5932,1068,7000,January
817,BRITANIA BUTTER 1KG,PIECE,1,20000,16949,3051,20000,January
828,BRITANIA NICE BISCUITS 1KG,PIECE,1,20000,16949,3051,20000,January
866,BUCKET 7000,PIECE,1,7000,5932,1068,7000,January
873,BUCKETS CLEAR 3000,PIECE,1,3000,2542,458,3000,January
876,BUCKETS KENPOLY 20000,PIECE,1,20000,16949,3051,20000,January
884,BUGSTONE VEST 10000,PIECE,1,10000,8475,1525,10000,January
888,BUILDING BLOCKS GOOD PARTNER 18000,PIECE,1,18000,15254,2746,18000,January
907,C.B DOULBLES CHOCOLATE,PIECE,1,3000,2542,458,3000,January
941,CADBURY DAIRYMILK 10G CHOCOLATE,PIECE,1,1500,1271,229,1500,January
945,CADBURY DRINKING CHOCOLATE 450G,PIECE,1,22000,18644,3356,22000,January
1011,CAR TOYS 3000,PIECE,1,3000,2542,458,3000,January
1020,CARDS 2500,PIECE,1,2500,2119,381,2500,January
1025,CARPET BRUSH 7000,PIECE,1,7000,5932,1068,7000,January
1038,CASIO 401/991MS CALCULATOR,PIECE,1,45000,38136,6864,45000,January
1060,CELOTAPE BLACK,PIECE,1,1500,1271,229,1500,January
1062,CELOTAPE BROWN SMALL,PIECE,1,3000,2542,458,3000,January
1098,CHAPATI ROLLER 25000,PIECE,1,20000,16949,3051,20000,January
1108,CHASTITY RASASI SPRAY,PIECE,1,12000,10169,1831,12000,January
1163,CLAIRMEN CREAM 120ML,PIECE,1,7000,5932,1068,7000,January
1166,PICFARE GOLD 96PGS,PIECE,1,1000,847,153,1000,January
1182,CLEOS HOT SAUCE 125G,PIECE,1,3500,2966,534,3500,January
1186,CLERE BABY JELLY 100G,PIECE,1,3000,2542,458,3000,January
1199,CLIMAX EXOTIC TROPICAL FRUITS 170G,PIECE,1,6000,5085,915,6000,January
1235,COCONUT PRADIP,PIECE,1,4500,3814,686,4500,January
1279,COMB WITH MIRROR 1500,PIECE,1,1500,1271,229,1500,January
1306,CONTAINERS 3500,PIECE,1,5000,4237,763,5000,January
1348,COW&GATE 3 NUTRIJUNIOR,PIECE,1,44000,37288,6712,44000,January
1351,CRANE BOOK 96PGS,PIECE,1,1000,847,153,1000,January
1380,CUPS 7000,PIECE,1,7000,5932,1068,7000,January
1393,CUSSONS BABY OIL PINK 200MLS,PIECE,1,16000,13559,2441,16000,January
1397,CUSSONS BABY UNPERFUMED JELLY 200ML,PIECE,1,12000,10169,1831,12000,January
1420,D.L CHOCO BOMB 70ML,PIECE,1,2500,2119,381,2500,January
1441,D.L VANILLA 1LTR,PIECE,1,18000,15254,2746,18000,January
1446,D.L VAN-STRAW 1LTR,PIECE,1,18000,15254,2746,18000,January
1457,DAIRIES 12000,PIECE,1,12000,10169,1831,12000,January
1458,DAIRIES 17000,PIECE,1,15000,12712,2288,15000,January
1500,DEAR BODY THURSDAY BODY MIST,PIECE,1,16000,13559,2441,16000,January
1515,DEMICH SKIMMED MILK 500G,PIECE,1,16000,13559,2441,16000,January
1544,DETTOL EVENTONE 175G,PIECE,1,6500,5508,992,6500,January
1551,DETTOL HERBAL 175G,PIECE,1,6500,5508,992,6500,January
1553,DETTOL LIQUID 250 MLS,PIECE,1,15000,12712,2288,15000,January
1643,DOLL 4000,PIECE,1,4000,3390,610,4000,January
1644,DOLL 8000,PIECE,1,8000,6780,1220,8000,January
1655,DOLLS 8000 WANJU,PIECE,1,8000,6780,1220,8000,January
1656,DOLLS BABY 35000,PIECE,1,35000,29661,5339,35000,January
1659,DOLLS MOTHER 6000,PIECE,1,6000,5085,915,6000,January
1667,DOMS COLOUR PENCILS SHORT,PIECE,1,4000,3390,610,4000,January
1670,DOMS PENCILS A1 5000,PIECE,1,5000,4237,763,5000,January
1697,DOVE CUCUMBER&GREENTEA SHOWERGEL,PIECE,1,20000,16949,3051,20000,January
1703,DOVE GLOWINGRITUAL 750ML,PIECE,1,27000,22881,4119,27000,January
1709,DOVE INVIGORATING 750ML,PIECE,1,27000,22881,4119,27000,January
1715,DOVE MEN SOAP ULTRA,PIECE,1,7500,6356,1144,7500,January
1759,DRINKING CHOCOLATE 225G,PIECE,1,13000,11017,1983,13000,January
1772,DURU CARING MILK,PIECE,1,4500,3814,686,4500,January
1774,DURU DOLCE ALMOND,PIECE,1,4500,3814,686,4500,January
1776,DURU FLORAL INFUSION,PIECE,1,14000,11864,2136,14000,January
1783,DURU MISKET 4PCS,PIECE,1,16000,13559,2441,16000,January
1786,DURU NATURAL OLIVE 720G,PIECE,1,18000,15254,2746,18000,January
1799,DUSTBIN 7000,PIECE,1,7000,5932,1068,7000,January
1816,EAST AFRICAN HONEY 350G,PIECE,1,13000,11017,1983,13000,January
1820,EAST AFRICAN ORGANIC HONEY 450G,PIECE,1,12000,10169,1831,12000,January
1825,ECO STYLING GEL 236ML,PIECE,1,11000,9322,1678,11000,January
1840,EDEN BODY MILK 500ML,PIECE,1,25000,21186,3814,25000,January
1853,EGGS HALF TRAY,PIECE,1,7000,5932,1068,7000,January
1861,ELEGANCE COCOA BUTTER,PIECE,1,6000,5085,915,6000,January
1869,ELEGANT BLACK A.F,PIECE,1,7000,5932,1068,7000,January
1890,ELGON BLEND 250G,PIECE,1,14000,11864,2136,14000,January
1909,ENVELOPES 1000,PIECE,1,1000,847,153,1000,January
1938,F.D FLAVOURED MILK BOX46000,BOX,1,45000,38136,6864,45000,January
1948,F.D PLAIN 250G,PIECE,1,2500,2119,381,2500,January
1983,FA MEN ATTRACTION FORCE,PIECE,1,6500,5508,992,6500,January
1995,FA WHITENING & CARE,PIECE,1,6500,5508,992,6500,January
2002,FACE TOWEL 3000 WHITE,PIECE,1,3000,2542,458,3000,January
2011,FAMILY CARE 200G,PIECE,1,4500,3814,686,4500,January
2023,FAMILY TEA 250G,PIECE,1,7500,6356,1144,7500,January
2055,FAY FACIAL TISSUE WHITE,PIECE,1,4000,3390,610,4000,January
2114,FLYMEEGO VESTS 25000,PIECE,1,25000,21186,3814,25000,January
2123,FOGG ELEGANCE ROLLON,PIECE,1,8500,7203,1297,8500,January
2128,FOGG MARCO SPRAY,PIECE,1,18000,15254,2746,18000,January
2129,FOGG MASTER AGAR,PIECE,1,18500,15678,2822,18500,January
2130,FOGG MASTER CEDAR,PIECE,1,18500,15678,2822,18500,January
2131,FOGG MASTER OAK,PIECE,1,18500,15678,2822,18500,January
2135,FOGG PARADISE,PIECE,1,18000,15254,2746,18000,January
2136,FOGG ROYAL SPRAY,PIECE,1,18000,15254,2746,18000,January
2137,FOGG SPLENDID ROLLON,PIECE,1,8500,7203,1297,8500,January
2149,FOOD COLOUR BLACK,PIECE,1,1000,847,153,1000,January
2155,FOOD COLOUR PINK,PIECE,1,1000,847,153,1000,January
2184,FOUNTAIN PENS 2000,PIECE,1,2000,1695,305,2000,January
2263,GALAXY BLOOMING SPRAY,PIECE,1,12000,10169,1831,12000,January
2276,GARDEN FRESH 50G,PIECE,1,2000,1695,305,2000,January
2277,GARDEN FRESH TEA 100G,PIECE,1,4000,3390,610,4000,January
2280,GARDEN TEA 100G,PIECE,1,5000,4237,763,5000,January
2319,GIFT BAG FLORAL SMALL,PIECE,1,2000,1695,305,2000,January
2344,GIRL BIKE 8000,PIECE,1,8000,6780,1220,8000,January
2360,GLASSES 8000 PCS,PIECE,1,8000,6780,1220,8000,January
2393,GOLDEN CLING FILM 25000,PIECE,1,25000,21186,3814,25000,January
2551,HIGHWAY EAR BUDS,PIECE,1,2500,2119,381,2500,January
2559,HIT INSECT KILLER GREENTEA 275ML,PIECE,1,12000,10169,1831,12000,January
2608,HUGGIES 3 H.C,PIECE,1,58000,49153,8847,58000,January
2628,HUGGIES WIPES NATURAL CARE,PIECE,1,9000,7627,1373,9000,January
2658,IMPERIAL LEATHER MEN COOL 400L LOTION,PIECE,1,13000,11017,1983,13000,January
2668,IMPERIAL LEATHER UPLIFTING 400ML LOTION,PIECE,1,12000,10169,1831,12000,January
2674,INDOCAFE 100G,PIECE,1,17000,14407,2593,17000,January
2707,JAGO 500MLS,PIECE,1,10000,8475,1525,10000,January
2715,JAGO SCRUB 500G,PIECE,1,13000,11017,1983,13000,January
2768,JCJ HAND WRITING BOOK 2000,PIECE,1,2000,1695,305,2000,January
2783,JESA FLAVOURED MILK BOX,BOX,1,30000,25424,4576,30000,January
2796,JESA PLAIN YOGHURT 500G,PIECE,1,3700,3136,564,3700,January
2826,JIB WATER 20LTRS TAP NEW,PIECE,1,50000,42373,7627,50000,January
2932,"KABODY BABY BOOSTER,S.R WITH ENKEJJE",PIECE,1,6500,5508,992,6500,January
2934,KABODY COMPOSITE FLOUR,PIECE,1,6500,5508,992,6500,January
2943,KABODY QUICK PORRIDGE1KG,PIECE,1,6000,5085,915,6000,January
2945,KABODY SOYA PORRIDGE,PIECE,1,6000,5085,915,6000,January
2946,KABODY SOYA RICE 1KG,PIECE,1,6500,5508,992,6500,January
2948,KADIO CALCULATOR,PIECE,1,15000,12712,2288,15000,January
2956,KALARA CHILLI OIL 20ML,PIECE,1,2500,2119,381,2500,January
2960,KANGARO STAPLER DS-E335,PIECE,1,14000,11864,2136,14000,January
2999,KENPOLY LUNCH BOX,PIECE,1,5000,4237,763,5000,January
3049,KEY HOLDERS 2000,PIECE,1,2000,1695,305,2000,January
3050,KEY HOLDERS 2500,PIECE,1,2500,2119,381,2500,January
3051,KEY HOLDERS 3500,PIECE,1,3500,2966,534,3500,January
3054,KIBIMBA RICE IKG,PIECE,1,8000,6780,1220,8000,January
3071,KIDS BOXERS 6000,PIECE,1,6000,5085,915,6000,January
3087,KIDS VEST 3000,PIECE,1,3000,2542,458,3000,January
3090,KIDS VESTS CLEVER GOLD 20K,PIECE,1,20000,16949,3051,20000,January
3093,KIDS WATCHES 5000 GODLER,PIECE,1,5000,4237,763,5000,January
3100,KIMBO 500G,PIECE,1,7500,6356,1144,7500,January
3105,KINKIZI TEA 250G,PIECE,1,9000,7627,1373,9000,January
3113,KIRUNGI KAZI BOOSTER 280ML,PIECE,1,1000,847,153,1000,January
3119,KISUBI 85GM,PIECE,1,1500,1271,229,1500,January
3137,KIWI DARK TAN 32G,PIECE,1,4500,3814,686,4500,January
3159,KNIFE 3000,PIECE,1,3000,2542,458,3000,January
3184,KOOKSY MANGO V 500ML,PIECE,1,4500,3814,686,4500,January
3195,KOOKSY VAN-CHOC 500ML,PIECE,1,5000,4237,763,5000,January
3199,KOOKSY VANILLA 250ML,PIECE,1,3500,2966,534,3500,January
3200,KOOKSY VANILLA 500ML,PIECE,1,5000,4237,763,5000,January
3208,KOOKSY VANILLA STRAWBERRY 250ML,PIECE,1,3500,2966,534,3500,January
3219,KRISHNA MATCH BOX 1000,PIECE,1,1000,847,153,1000,January
3246,LA BELLE JELLY 250G,PIECE,1,6000,5085,915,6000,January
3278,LANZO MENTHOL SOAP,PIECE,1,4500,3814,686,4500,January
3289,LATO FLAVOURED 250ML 46000,PIECE,1,46000,38983,7017,46000,January
3388,LIQUID SOAP 1LTR 3000,PIECE,1,3000,2542,458,3000,January
3402,LONDON FACIAL WIPES,PIECE,1,3500,2966,534,3500,January
3404,LONG DUSTPAN 18OOO,PIECE,1,18000,15254,2746,18000,January
3406,LORD CROWN PERFUME,PIECE,1,10000,8475,1525,10000,January
3445,LUNCH BOX 42000,PIECE,1,42000,35593,6407,42000,January
3461,M&G CALCULATOR 20000,PIECE,1,20000,16949,3051,20000,January
3478,M&G MATHEMATICAL SET,PIECE,1,5000,4237,763,5000,January
3484,M&G PAPER CLIPS 1500,PIECE,1,1500,1271,229,1500,January
3486,M&G PUNCHING MACHINE,PIECE,1,15000,12712,2288,15000,January
3495,M&G STICKY NOTES 2000,PIECE,1,2000,1695,305,2000,January
3496,M&G STICKY NOTES PLAIN YELLOW,PIECE,1,2000,1695,305,2000,January
3597,MANUSCRIPT 3Q BOOK,PIECE,1,16000,13559,2441,16000,January
3621,MATHEMATICAL SET 3500 KYLIAN,PIECE,1,4000,3390,610,4000,January
3622,CAR TOY 15000,PIECE,1,15000,12712,2288,15000,January
3634,MELAMINE PLATES 5000,PIECE,1,5000,4237,763,5000,January
3667,MEN BOXERS 7000,PIECE,1,7000,5932,1068,7000,January
3709,MILO 100G,PIECE,1,11000,9322,1678,11000,January
3811,MOPPER PVA 35000,PIECE,1,35000,29661,5339,35000,January
3847,MOSQUITO NET 13000,PIECE,1,13000,11017,1983,13000,January
3858,MOTHERS PRIDE MILK BREAD 1KG,PIECE,1,5500,4661,839,5500,January
3871,MOVIT BABY JELLY 425g,PIECE,1,11000,9322,1678,11000,January
3872,MOVIT BABY JELLY 70g,PIECE,1,2000,1695,305,2000,January
3889,MOVIT FAMILY SOAP ALOE 230G,PIECE,1,4000,3390,610,4000,January
3912,MOVIT JELLY 110G,PIECE,1,3500,2966,534,3500,January
3917,MOVIT JELLY 85ML,PIECE,1,2000,1695,305,2000,January
3935,MOZZARELLA CHEESE 500G,PIECE,1,25000,21186,3814,25000,January
3947,MUKWANO BASIN 6000,PIECE,1,6000,5085,915,6000,January
3967,MUSAWO BODY JELLY,PIECE,1,2500,2119,381,2500,January
3973,MUSAWO SOAP 240G,PIECE,1,3000,2542,458,3000,January
4044,NESCAFE CLASSIC 200G,PIECE,1,29000,24576,4424,29000,January
4052,NEVIA PEARL&BEAUTY ROLLON,PIECE,1,11000,9322,1678,11000,January
4085,NICE&LOVELY ALOE 200ML,PIECE,1,6000,5085,915,6000,January
4100,NIGINA 10000,PIECE,1,10000,8475,1525,10000,January
4115,NISA CAMEL MILK CARROT SOAP,PIECE,1,5000,4237,763,5000,January
4118,NISA HAIR REMOVAL CUCUMBER 100ML,PIECE,1,10000,8475,1525,10000,January
4125,NISA ROSE HAIR REMOVAL CREAM 20ML,PIECE,1,2000,1695,305,2000,January
4134,NIVEA BLACK & WHITE 50ML,PIECE,1,11000,9322,1678,11000,January
4142,NIVEA DRY COMFORT ROLLON,PIECE,1,11000,9322,1678,11000,January
4148,NIVEA FRESH NATURAL ROLLON,PIECE,1,10000,8475,1525,10000,January
4158,NIVEA MEN DEEP ROLLON,PIECE,1,11000,9322,1678,11000,January
4177,NIVEA PROTECT&CARE BODY SPRAY,PIECE,1,16000,13559,2441,16000,January
4178,NIVEA REPAIR& CARE 72H 400ML,PIECE,1,19000,16102,2898,19000,January
4197,NOTE BOOK 3500,PIECE,1,3500,2966,534,3500,January
4272,NUVITA LEMON BISCUITS 750,PIECE,1,1500,1271,229,1500,January
4293,ODONIL DISINFECTANT,PIECE,1,7000,5932,1068,7000,January
4294,OFFICE GLUE 1KG,PIECE,1,7000,5932,1068,7000,January
4297,OFFICE POINT STICK GLUE,PIECE,1,2000,1695,305,2000,January
4312,OLD SPICE PURE SPORT63G,PIECE,1,20000,16949,3051,20000,January
4322,OLITALIA OLIVE OIL POMACE 250ML,PIECE,1,27000,22881,4119,27000,January
4330,OLIVE OIL SPRAY 85ML,PIECE,1,7500,6356,1144,7500,January
4345,OMO FAST ACTION 3.5KG,PIECE,1,40000,33898,6102,40000,January
4383,ORGANIC COCOABUTTER&SHEA BUTTER,PIECE,1,22000,18644,3356,22000,January
4463,PAMPERS WIPES COMPLETE CLEAN,PIECE,1,13500,11441,2059,13500,January
4466,PANASONIC BIG,PIECE,1,6000,5085,915,6000,January
4473,PANT PEG 5000,PIECE,1,5000,4237,763,5000,January
4499,PASSION STRAWBERRY,PIECE,1,16000,13559,2441,16000,January
4555,PETTI COT 5000,PIECE,1,5000,4237,763,5000,January
4568,"PHOTO ALBUMS HY,4R",PIECE,1,18000,15254,2746,18000,January
4573,PIANO TOYS 4000,PIECE,1,4000,3390,610,4000,January
4577,PICFARE 192 PAGES 6000,PIECE,1,6000,5085,915,6000,January
4578,PICFARE 2 QUIRE,PIECE,1,5000,4237,763,5000,January
4592,PICFARE SET,PIECE,1,6000,5085,915,6000,January
4602,PICK-UP POLICE CAR 13000,PIECE,1,13000,11017,1983,13000,January
4667,POPPER 7000,PIECE,1,7000,5932,1068,7000,January
4672,POTATO BABY BOTTLE P10675 18000,PIECE,1,18000,15254,2746,18000,January
4694,POULTRY VIENNAS 1KG,PIECE,1,36000,30508,5492,36000,January
4696,POULTRY VIENNAS 500G,PIECE,1,21000,17797,3203,21000,January
4713,PRESSOL HAIR GEL 125G,PIECE,1,5500,4661,839,5500,January
4720,PRICETAGS 1000,PIECE,1,1000,847,153,1000,January
4722,PRIDE DISH WASHING PASTE LIME 400G,PIECE,1,10000,8475,1525,10000,January
4733,PRINCESS ULTRA THIN,PIECE,1,3000,2542,458,3000,January
4735,PRINGLES BBQ 40G,PIECE,1,5500,4661,839,5500,January
4740,PRINGLES KETCHUP 165G,PIECE,1,11000,9322,1678,11000,January
4746,PRINGLES SOUR CREAM 165G,PIECE,1,12000,10169,1831,12000,January
4753,PRIVE INTERMAT BODYSPLASH,PIECE,1,15000,12712,2288,15000,January
4757,PRIVE MODA POUR FEMME,PIECE,1,15000,12712,2288,15000,January
4789,PUCELLE JOLLY RHYTHM 150MLS,PIECE,1,7500,6356,1144,7500,January
4799,PUCELLE WAVY OCEAN 150MLS,PIECE,1,7500,6356,1144,7500,January
4814,Pure soft facial wipes,PIECE,1,3000,2542,458,3000,January
4849,RAHA COCOA 100G,PIECE,1,8000,6780,1220,8000,January
4852,RAHA DRINKING CHOCOLATE 200G,PIECE,1,10000,8475,1525,10000,January
4859,RAKES 9000,PIECE,1,9000,7627,1373,9000,January
4871,RASPBERRY MIST PASSION,PIECE,1,16000,13559,2441,16000,January
4878,RAZAC HAND&BODY LOTION 20Z,PIECE,1,5000,4237,763,5000,January
4879,RAZAC HAND&BODY LOTION 40Z,PIECE,1,7500,6356,1144,7500,January
4882,RAZOR BLADE,PIECE,1,300,254,46,300,January
4889,RECEIPT BOOKS CARBONATED,PIECE,1,6000,5085,915,6000,January
4890,RECEIPT BOOKS NORMAL,PIECE,1,3000,2542,458,3000,January
4919,REXONA COTTON DRY,PIECE,1,5000,4237,763,5000,January
4934,RIBBONS 2500,PIECE,1,2500,2119,381,2500,January
4974,RINJU SHEA BUTTER 59ML,PIECE,1,5000,4237,763,5000,January
4976,RIOLA LUNCH BOX,PIECE,1,6000,5085,915,6000,January
4994,ROMANCE BODY SPRAY,PIECE,1,12000,10169,1831,12000,January
5007,ROTATRIM,PIECE,1,28000,23729,4271,28000,January
5013,ROYAL POUR HOMME BLACK,PIECE,1,12000,10169,1831,12000,January
5030,RUBEE LOTION 59ML,PIECE,1,5000,4237,763,5000,January
5059,SAF-INSTANT YEAST 500G,PIECE,1,16000,13559,2441,16000,January
5060,SAFISHA DISINFECTOR 200G,PIECE,1,7800,6610,1190,7800,January
5078,SAMONA HERBAL JELLY 150G,PIECE,1,5000,4237,763,5000,January
5086,SANDALS 5000,PIECE,1,5000,4237,763,5000,January
5087,SANDALS 6000,PIECE,1,6000,5085,915,6000,January
5105,SAPIL PINK NANCY,PIECE,1,15000,12712,2288,15000,January
5144,SAVANNAH COCOPINE 5LTR,PIECE,1,35000,29661,5339,35000,January
5145,SAVANNAH LEMON 3LTR,PIECE,1,22000,18644,3356,22000,January
5157,SAVLON 500MLS,PIECE,1,16000,13559,2441,16000,January
5166,SCHOOL BUS TOY,PIECE,1,10000,8475,1525,10000,January
5183,SCOURING PADS NICE CLEAN,PIECE,1,6000,5085,915,6000,January
5191,SCRUBBING HAND BRUSH 8000,PIECE,1,8000,6780,1220,8000,January
5198,SCRUBING HAND BRUSH 3000,PIECE,1,3000,2542,458,3000,January
5229,SERVING SPOONS 3000,PIECE,1,3000,2542,458,3000,January
5230,SERVING SPOONS 8000,PIECE,1,8000,6780,1220,8000,January
5253,SHAKERS 12000,PIECE,1,12000,10169,1831,12000,January
5255,SHAKERS 4000,PIECE,1,4000,3390,610,4000,January
5264,SHENKE COIL 4500,PIECE,1,4500,3814,686,4500,January
5281,SHIVA HONEY 250G,PIECE,1,8000,6780,1220,8000,January
5301,SHOWER 2 SHOWER CONFIDENT,PIECE,1,6000,5085,915,6000,January
5302,SHOWER CAPS,PIECE,1,2000,1695,305,2000,January
5303,SHOWER TO SHOWER HAPPY DAYS,PIECE,1,6000,5085,915,6000,January
5328,SHREEJI SHORTHAND BOOK,PIECE,1,2000,1695,305,2000,January
5361,SIMBA MBILI 200G,PIECE,1,9500,8051,1449,9500,January
5379,SIMKA VANILLA 120MLS,PIECE,1,1000,847,153,1000,January
5387,SKALA ALOEVERA CREAM 200G,PIECE,1,4000,3390,610,4000,January
5389,SKALA CARROT BODY CREAM,PIECE,1,4000,3390,610,4000,January
5390,SKALA CARROT LOTION 400ML,PIECE,1,6000,5085,915,6000,January
5395,SKALA PAPAYA LOTION,PIECE,1,6000,5085,915,6000,January
5399,SKIN CARE 100G,PIECE,1,3000,2542,458,3000,January
5402,SKIN CARE 250G,PIECE,1,6500,5508,992,6500,January
5408,SKIN DOCTOR HERBAL 250G,PIECE,1,7000,5932,1068,7000,January
5485,SO SOFT KITCHEN TOWEL,PIECE,1,8000,6780,1220,8000,January
5491,SOAP DISH 2000,PIECE,1,2000,1695,305,2000,January
5515,SOFT BROOM 15000,PIECE,1,15000,12712,2288,15000,January
5528,SOFTCARE BABY PANTS M44,PIECE,1,27000,22881,4119,27000,January
5557,SOSOFT BABY 2.5L,PIECE,1,29000,24576,4424,29000,January
5568,SOY SAUCE LIGHT 150G,PIECE,1,5000,4237,763,5000,January
5574,SPARKLING CANDLES 8000,PIECE,1,7000,5932,1068,7000,January
5575,SPARKLING CANDLES 9000,PIECE,1,9000,7627,1373,9000,January
5629,SQUEEZER 11000,PIECE,1,11000,9322,1678,11000,January
5632,SQUEEZERS METALLIC 14000,PIECE,1,14000,11864,2136,14000,January
5638,SSCHOOL SOCKS WHITE,PIECE,1,4000,3390,610,4000,January
5642,STA SOFT SPRINGFRESH 2LTR,PIECE,1,25000,21186,3814,25000,January
5651,STAR COFFEE 50G,PIECE,1,9000,7627,1373,9000,January
5662,STELAR 70MM,PIECE,1,20000,16949,3051,20000,January
5675,STONEY ZERO 350MLS,PIECE,1,1000,847,153,1000,January
5696,STRAWS 2500,PIECE,1,2500,2119,381,2500,January
5697,STREPSILS ORIGINAL,PIECE,1,1000,847,153,1000,January
5737,SUMZ CORN CRAX PKT 13000,PIECE,1,13000,11017,1983,13000,January
5782,SUNLIGHT DISHWASJING STRAWBERRY 400ML,PIECE,1,6500,5508,992,6500,January
5784,SUNLIGHT LAVENDER 1KG,PIECE,1,11000,9322,1678,11000,January
5792,SUNLIGHT SOAP 175G,PIECE,1,2500,2119,381,2500,January
5793,SUNLIGHT SPRING 3.5KG,PIECE,1,34000,28814,5186,34000,January
5796,SUNLIGHT TROPICAL 1KG,PIECE,1,11000,9322,1678,11000,January
5804,SUNSEED OIL 3LTRS,PIECE,1,28000,23729,4271,28000,January
5825,SUNTOUR SOCKS,PIECE,1,6000,5085,915,6000,January
5865,SWEET PEPSI PKT 2000,PIECE,1,2000,1695,305,2000,January
5923,TABLE KNIFE PIECES 3000,PIECE,1,3000,2542,458,3000,January
5952,TATE LYLE SUGAR 500G,PIECE,1,13000,11017,1983,13000,January
5959,TEAM VESTS 4000,PIECE,1,3000,2542,458,3000,January
5962,TEEPEE BRUSH A25,PIECE,1,3500,2966,534,3500,January
5995,TERRY BOY BOXERS 3PCS,PIECE,1,18000,15254,2746,18000,January
6047,TOILET BRUSH 6000,PIECE,1,6000,5085,915,6000,January
6049,TOILET BRUSH TEEPEE10000,PIECE,1,10000,8475,1525,10000,January
6053,TOILET PUMPS,PIECE,1,7000,5932,1068,7000,January
6057,TOMDECA VESTS,PIECE,1,25000,21186,3814,25000,January
6137,TOTOS VESTLINE JELLY 100G,PIECE,1,3000,2542,458,3000,January
6143,TOWELS 20000,PIECE,1,20000,16949,3051,20000,January
6149,TOY BIKES 8000,PIECE,1,8000,6780,1220,8000,January
6167,TREE CITY SHOWER GELS 2L,PIECE,1,25000,21186,3814,25000,January
6172,TRI-CIRCLE 263,PIECE,1,7500,6356,1144,7500,January
6187,TROPICAL HEAT BLACK PEPPER 50G,PIECE,1,5500,4661,839,5500,January
6189,TROPICAL HEAT CINNAMON 100G,PIECE,1,9500,8051,1449,9500,January
6191,TROPICAL HEAT CLOVE POWDER,PIECE,1,7500,6356,1144,7500,January
6192,TROPICAL HEAT CORIANDER 50G,PIECE,1,4500,3814,686,4500,January
6199,TROPICAL HEAT GARLIC POWDER 100G,PIECE,1,7000,5932,1068,7000,January
6202,TROPICAL HEAT GINGER 45G,PIECE,1,3500,2966,534,3500,January
6215,TROPICAL HEAT TEA MASALA 100G,PIECE,1,10000,8475,1525,10000,January
6219,TROPICAL HEAT WHITE PEPPER 50G,PIECE,1,8000,6780,1220,8000,January
6295,UGACHICK GRILLER 1KG,PIECE,1,24000,20339,3661,24000,January
6298,UGACHICK STARDARD 1.2KG,PIECE,1,27000,22881,4119,27000,January
6300,UGACHICK THIGHS 500G,PIECE,1,13000,11017,1983,13000,January
6314,ULTRASONIC PEST REPELLER,PIECE,1,15000,12712,2288,15000,January
6318,UMBRELLAS 8000,PIECE,1,8000,6780,1220,8000,January
6322,UMOJA SANDALS 6000,PIECE,1,7000,5932,1068,7000,January
6371,VACUUM BOTTLE 40000,PIECE,1,40000,33898,6102,40000,January
6398,VASELINE ALOESOOTHE LOTION 400ML,PIECE,1,14500,12288,2212,14500,January
6413,VASELINE DRY SKIN REPAIR LOTION 400ML,PIECE,1,15000,12712,2288,15000,January
6437,VENUS MOROCCAN ARGAN OIL LOTION 400ML,PIECE,1,10000,8475,1525,10000,January
6452,VESTLINE GARLIC 200G,PIECE,1,4000,3390,610,4000,January
6474,VINEGAR WHITE 700MLS,PIECE,1,2500,2119,381,2500,January
6484,VOYAGE DE LA PARIS SPLASH,PIECE,1,14000,11864,2136,14000,January
6493,WALMUS MUKENE SNACKS 7500,PIECE,1,8500,7203,1297,8500,January
6496,WANDAZ PETROLEUM JELLY 250G,PIECE,1,6000,5085,915,6000,January
6535,WEETABIX 225G,PIECE,1,8500,7203,1297,8500,January
6537,WEETABIX 450G,PIECE,1,15500,13136,2364,15500,January
6539,WEETABIX 900G,PIECE,1,27000,22881,4119,27000,January
6543,WEETABIX CORNFLAKES 250G,PIECE,1,12000,10169,1831,12000,January
6564,WHISPPEX SHAVERS,PIECE,1,3000,2542,458,3000,January
6588,WIG CAP HAIR NET,PIECE,1,1500,1271,229,1500,January
6612,YAKET 1.5LTR,PIECE,1,1500,1271,229,1500,January
6618,YARRISON BOXERS 3PCS 22000,PIECE,1,22000,18644,3356,22000,January
6619,YARRISON UNDER SHIRT 30000,PIECE,1,35000,29661,5339,35000,January
6663,ZERO PIMPLE SOAP 120G,PIECE,1,4000,3390,610,4000,January
6769,SUNLIGHT TROPICAL 2KG,PIECE,1,20000,16949,3051,20000,January
6782,CHICKEN STEW 8000,PIECE,1,8000,6780,1220,8000,January
6794,KATOGO 2500,PIECE,1,3000,2542,458,3000,January
6806,KIWI DARKTAN LEATHER 100ML,PIECE,1,7000,5932,1068,7000,January
6815,PENCILS 200,PIECE,1,200,169,31,200,January
6827,ELEGANT AIRFRESHNER LOUND,PIECE,1,7000,5932,1068,7000,January
6835,PREMIUM BLADE RAZOR 6PACK,PIECE,1,11000,9322,1678,11000,January
6850,PIZZA 14'' BEEF,PIECE,1,25000,21186,3814,25000,January
6901,DEAR BODY ANGEL BITTEN 250ML,PIECE,1,18000,15254,2746,18000,January
6905,CARPET BRUSH 10000,PIECE,1,10000,8475,1525,10000,January
6938,OMO BLEACH COLOUR SAFE 5LTR,PIECE,1,48000,40678,7322,48000,January
6983,STRIKE COCONUT CHOCOLATE BAR,PIECE,1,1000,847,153,1000,January
6991,GOLDER WHITE BOARD MARKER ,PIECE,1,1500,1271,229,1500,January
6995,DOMS WAX CRAYONS ,PIECE,1,2500,2119,381,2500,January
6999,CASIO SCIENTIFIC CALCULATORS WHITE ,PIECE,1,55000,46610,8390,55000,January
7003,M&G OFFICE SCISSORS 170MM,PIECE,1,4000,3390,610,4000,January
7007,ENERGIZER AA2 MAX ,PIECE,1,6000,5085,915,6000,January
7009,VENUS VITAMIN E 200ML LOTION,PIECE,1,6000,5085,915,6000,January
7019,WELLICE SHOWERGEL MILK,PIECE,1,23000,19492,3508,23000,January
7043,CHOPPING BOARDS 20000,PIECE,1,20000,16949,3051,20000,January
7051,KELLOGGS CORN FLAKES 750G ORIGINAL,PIECE,1,34000,28814,5186,34000,January
7062,"REXONA BODY SPRAYS TROPICAL,BIORYTHM,SHOWER FRESH 200ML",PIECE,1,13000,11017,1983,13000,January
7063,"AXE ICE CHILL, GOLD, ADRENALIN",PIECE,1,13000,11017,1983,13000,January
7094,NICE$LOVELY ALOEVERA 600ML,PIECE,1,15000,12712,2288,15000,January
7115,CLAIRMEN CREAM 300ML,PIECE,1,14000,11864,2136,14000,January
7148,HUGGIES DRY COMFORT PANTS 5JUMBO,PIECE,1,54000,45763,8237,54000,January
7160,PAWPAW OIL 60ML,PIECE,1,6000,5085,915,6000,January
7161,PRETTY WHITE OIL 60ML,PIECE,1,6000,5085,915,6000,January
7270,FRIED EGGS 5000,PIECE,1,2000,1695,305,2000,January
7277,DOUGHNUTS WHOLESALE 2500,PIECE,1,2500,2119,381,2500,January
7282,Downy vanilla&cashmere musk 880ml,PIECE,1,24000,20339,3661,24000,January
7289,TRIDENT CHEWING GUM,PIECE,1,6000,5085,915,6000,January
7306,MAVAL GIRL PANTY LINERS,PIECE,1,2500,2119,381,2500,January
7312,SAPIL SECRET ROMANCE 15000,PIECE,1,15000,12712,2288,15000,January
7319,ARMAF ENCHANTED ROMANCE AIR.F,PIECE,1,8000,6780,1220,8000,January
7328,MOSQUITO REPELLENT,PIECE,1,16000,13559,2441,16000,January
7330,SUMZ GONJA CRISP 400G,PIECE,1,12000,10169,1831,12000,January
7332,SWT-P 5KG,PIECE,1,40000,33898,6102,40000,January
7373,VASELINE BLUESEAL BABY 240ML,PIECE,1,9500,8051,1449,9500,January
7383,MOVIT BABY JELLY 200G,PIECE,1,5000,4237,763,5000,January
7406,COLGATE TOOTHBRUSH 6+,PIECE,1,6000,5085,915,6000,January
7411,PAMPERS PANTS 6,PIECE,1,40000,33898,6102,40000,January
7412,AMERICAN SHOWER GEL ROSE 1000ML,PIECE,1,18000,15254,2746,18000,January
7413,AMERICAN CROWN SHOWER GEL COCONUT JOY 1000ML,PIECE,1,18000,15254,2746,18000,January
7415,SHOWER GEL ALOEVERA 2L,PIECE,1,25000,21186,3814,25000,January
7438,YARRISON KIDS VESTS18000,PIECE,1,18000,15254,2746,18000,January
7446,DOWNY VALLEY DEW 1L 22000,PIECE,1,24000,20339,3661,24000,January
7454,MOPPER 3000,PIECE,1,3000,2542,458,3000,January
7455,CANDLE NUMBER BIG 3500,PIECE,1,3500,2966,534,3500,January
7491,C.B DOUBLES BLUEBERRY ICE CREAM,PIECE,1,2500,2119,381,2500,January
7500,KABODY BABY BODY IMMUNE BOOSTER,PIECE,1,7500,6356,1144,7500,January
7522,JUST WOW 250ML,PIECE,1,15000,12712,2288,15000,January
7523,SPARKING CANDLE 7000,PIECE,1,6000,5085,915,6000,January
7538,KIDS SHADES 2000,PIECE,1,2000,1695,305,2000,January
7541,MEN SOCKS 5500,PIECE,1,5500,4661,839,5500,January
7544,DOLLS 5000,PIECE,1,5000,4237,763,5000,January
7562,PAMPERS PANTS S5,PIECE,1,40000,33898,6102,40000,January
7563,NIVEA FRESH NATURAL,PIECE,1,16000,13559,2441,16000,January
7567,RIGGS DYNAMO,PIECE,1,16000,13559,2441,16000,January
7568,RIGGS VOYAGE,PIECE,1,16000,13559,2441,16000,January
7578,PRETTY STRAWBEERY GEL,PIECE,1,18000,15254,2746,18000,January
7579,PRETTY LAVENDER,PIECE,1,18000,15254,2746,18000,January
7600,NISA CARROT OIL LOTION 200ML,PIECE,1,8000,6780,1220,8000,January
7608,KOOKSY BLUEBERRY CHEESE CAKE 125ML,PIECE,1,3000,2542,458,3000,January
7612,HB PICFARE PENCIL 2500,PIECE,1,2500,2119,381,2500,January
7633,CLERE COCOA BUTTER 400ML,PIECE,1,8000,6780,1220,8000,January
7638,COSMO OUD GEL 480ML,PIECE,1,12000,10169,1831,12000,January
7652,HOT DOGS 3000,PIECE,1,3000,2542,458,3000,January
7667,SCHOOL SOCKS WHITE 6000,PIECE,1,6000,5085,915,6000,January
7689,CONTAINER AND BOTTLE 15000,PIECE,1,15000,12712,2288,15000,January
7693,HAND BRUSH 2500,PIECE,1,2500,2119,381,2500,January
7698,QUTIE FEEDING CUP 20000,PIECE,1,20000,16949,3051,20000,January
7708,FOGG DERMATOLOGICALLY TESTED ROLL 50ML,PIECE,1,8500,7203,1297,8500,January
7710,FOGG PINE SPRAY,PIECE,1,18000,15254,2746,18000,January
7711,RIGGS ARMOUR SPRAY 250ML,PIECE,1,16000,13559,2441,16000,January
7716,DOVE RELAXING JASMINE& COCONUT MILK GEL 500ML,PIECE,1,22000,18644,3356,22000,January
7718,BERTINI OLIVE OIL 100ML,PIECE,1,18000,15254,2746,18000,January
7725,JAMIES BRONCH BREAD 500G,PIECE,1,3500,2966,534,3500,January
7738,CUP GIFT 12000,PIECE,1,12000,10169,1831,12000,January
7750,TOYS 4000,PIECE,1,4000,3390,610,4000,January
7754,DOLL 10000,PIECE,1,10000,8475,1525,10000,January
7766,JAMIES CAKE 45000,PIECE,1,45000,38136,6864,45000,January
7776,SUMZ FRUIT CHUTNEY 60G,PIECE,1,3000,2542,458,3000,January
7780,VENUS MOROCCAN ARGAN OIL 200ML,PIECE,1,6000,5085,915,6000,January
7781,DOVE RESTORING CARE LOTION 400ML,PIECE,1,20000,16949,3051,20000,January
7785,JINBO NOTEBOOK 15000,PIECE,1,15000,12712,2288,15000,January
7787,BROOKSIDE MILK BOX 28000,PIECE,1,28000,23729,4271,28000,January
7795,TROPIKAL POWDER FRESH 12000,PIECE,1,12000,10169,1831,12000,January
7797,VERSMAN TRENDY 10000,PIECE,1,9500,8051,1449,9500,January
7798,NISA PAPAYA 200ML 8000,PIECE,1,8000,6780,1220,8000,January
7804,FACE MASK COFFEE 120ML 10000,PIECE,1,10000,8475,1525,10000,January
7818,ODEON CHARCOAL&TEA TREE 300ML,PIECE,1,11000,9322,1678,11000,January
7822,DOVE REVIVING GEL 500ML,PIECE,1,22000,18644,3356,22000,January
7832,FANEST BEEF SAUSAGES 500G,PIECE,1,13000,11017,1983,13000,January
7835,HURRICANE OCEAN FRESH 500ML,PIECE,1,9000,7627,1373,9000,January
7836,HURRICANE LEMON FRESH 500ML,PIECE,1,9000,7627,1373,9000,January
7846,HOBBY ROMANTIC HAND WASH 400ML,PIECE,1,7500,6356,1144,7500,January
7847,HOBBY PEACH& MANGO 400ML,PIECE,1,7500,6356,1144,7500,January
7849,ELEGANT LEGEND AF 300ML,PIECE,1,7000,5932,1068,7000,January
7852,OLD SPICE KRAKENGARD,PIECE,1,21000,17797,3203,21000,January
7854,COSMO COCONUT CRUSH GEL 1000ML,PIECE,1,18000,15254,2746,18000,January
7869,CLEAN SPONGE 5500,PIECE,1,5500,4661,839,5500,January
7872,DOVE INTENSE CARE LOTION 400ML,PIECE,1,18999,16101,2898,18999,January
7873,DOVE INVIGORATING CARE 400ML,PIECE,1,19000,16102,2898,19000,January
7874,DOVE RESTORING CARE 400ML,PIECE,1,19000,16102,2898,19000,January
7875,DOVE PAMPERING CARE 400ML,PIECE,1,19000,16102,2898,19000,January
7879,WEETABIX VANILLA 230G,PIECE,1,9500,8051,1449,9500,January
7884,ROKI COOKING OIL 1L,PIECE,1,8000,6780,1220,8000,January
7886,PAKA MATCH BOX,PIECE,1,1000,847,153,1000,January
7887,LIFEBUOY MOISTURE PLUS 175G,PIECE,1,6000,5085,915,6000,January
7892,NISA ROSE 50ML,PIECE,1,3500,2966,534,3500,January
7901,YULU CLASSIC BOXERS 3PCS 22000,PIECE,1,22000,18644,3356,22000,January
7902,NIVEA FRESH CHERRY ROLL ON ,PIECE,1,11000,9322,1678,11000,January
7903,BLUE BAND WITH CHOCO 500G,PIECE,1,11000,9322,1678,11000,January
7907,WEETABIX CORNFLAKES CRUNCHY 250G,PIECE,1,9500,8051,1449,9500,January
7909,ONER APPLE DRINK 200ML,PIECE,1,1000,847,153,1000,January
7910,ONER MANGO 200ML,PIECE,1,1000,847,153,1000,January
7911,RIHAM X ENERGY 400ML,PIECE,1,2000,1695,305,2000,January
7912,COSMO SHOWERGELS MIX VAN.STRAW.TROPICAL 1LTR,PIECE,1,20000,16949,3051,20000,January
6874,MUSHROOM STEW,PIECE,1.82,10000,15424,2776,18200,January
6,20LTR JERRICAN,PIECE,2,10000,16949,3051,20000,January
9,500MLS DISPOSABLE GLASSES,PIECE,2,6000,10169,1831,12000,January
18,7DAYS PANT LINERS,PIECE,2,4000,6780,1220,8000,January
26,ABC BABY WIPES,PIECE,2,9000,15254,2746,18000,January
36,ACTIVE WOMAN BODY SPRAY,PIECE,2,10000,16949,3051,20000,January
60,AFROCARE BODY LOTION 400ML,PIECE,2,6000,10169,1831,12000,January
63,AFROCARE PETROLEUM JELLY,PIECE,2,4500,7627,1373,9000,January
108,AMARA FOR MEN 400ML,PIECE,2,10000,16949,3051,20000,January
215,ARIEL ORIGINAL 1KG,PIECE,2,15500,26271,4729,31000,January
219,ARMAF AIR FRESHNER SUMMER,PIECE,2,10000,16949,3051,20000,January
311,AUNT PORRIDGE 1KG,PIECE,2,14000,23729,4271,28000,January
334,AXE MUSK,PIECE,2,13000,22034,3966,26000,January
343,AXION PASTE LIME,PIECE,2,6000,10169,1831,12000,January
455,BABY NIPPLES BIG 1000,PIECE,2,1000,1695,305,2000,January
523,BALLET ACTIVE VITAMIN 120MLS,PIECE,2,5000,8475,1525,10000,January
525,BALLET ALMOMD OIL 125ML,PIECE,2,9500,16102,2898,19000,January
571,BAMBOO TOOTHPICKS,PIECE,2,2500,4237,763,5000,January
612,BECCA COUNTER BOOKS 6500,PIECE,2,6500,11017,1983,13000,January
655,BIG DADDY 300 SWEETS,PIECE,2,300,508,92,600,January
686,BIYINZIKA MIXED PORTIONS 2KG,PIECE,2,37000,62712,11288,74000,January
687,BIYINZIKA MUCHOMO 1.5KG,PIECE,2,28000,47458,8542,56000,January
691,BIYINZIKA WINGS 500G,PIECE,2,11000,18644,3356,22000,January
773,BOTTLES 4000,PIECE,2,4000,6780,1220,8000,January
786,BOWLS 3000,PIECE,2,3000,5085,915,6000,January
820,BRITANIA DIGESTIVE 1KG,PIECE,2,20000,33898,6102,40000,January
822,BRITANIA GINGER 1KG,PIECE,2,20000,33898,6102,40000,January
833,BRITANIA SHORTCAKE BISCUITS 1KG,PIECE,2,20000,33898,6102,40000,January
851,BROOMS 1000,PIECE,2,1000,1695,305,2000,January
869,BUCKETS ANGEL 6500,PIECE,2,6500,11017,1983,13000,January
902,C.B CHOCOLATE CHOCO CHIPS 200ML,PIECE,2,5000,8475,1525,10000,January
904,C.B CLASSIC VANILLA 1LTR,PIECE,2,19500,33051,5949,39000,January
994,CANDLES 2400,PIECE,2,2500,4237,763,5000,January
1037,CASHO CALC,PIECE,2,15000,25424,4576,30000,January
1044,CB BUTTERSCOTCH 1LTR,PIECE,2,24000,40678,7322,48000,January
1054,CB MAGIC STRAW 500ML,PIECE,2,10000,16949,3051,20000,January
1068,CERELAC 7MONTHS MIXEDFRUITS,PIECE,2,27000,45763,8237,54000,January
1172,CLASSIC SHORTHAND NOTEBOOK,PIECE,2,2000,3390,610,4000,January
1176,CLEAR BAG 1000,PIECE,2,1000,1695,305,2000,January
1185,CLERE ALOEVERA 250G,PIECE,2,5000,8475,1525,10000,January
1187,CLERE BABY JELLY 250G,PIECE,2,5000,8475,1525,10000,January
1194,CLERE PETROLEUM JELLY100G,PIECE,2,3000,5085,915,6000,January
1202,CLIMAX TROPICAL FRUITS 50G,PIECE,2,2500,4237,763,5000,January
1213,CLOSEUP TRIPPLE FRESH 125G,PIECE,2,5000,8475,1525,10000,January
1239,COCOPULP CREME 100ML,PIECE,2,7500,12712,2288,15000,January
1264,COLGATE NATURAL EXTRACT 75MLS,PIECE,2,9000,15254,2746,18000,January
1280,COMB WITH MIRROR 2500,PIECE,2,2500,4237,763,5000,January
1394,CUSSONS BABY PERFUMED JELLY 200ML,PIECE,2,12000,20339,3661,24000,January
1413,CUTTERS 1500,PIECE,2,1500,2542,458,3000,January
1421,D.L CHOCO NUT 70ML,PIECE,2,2500,4237,763,5000,January
1431,D.L MINI FIESTA CLASSIC 70MLS,PIECE,2,2500,4237,763,5000,January
1437,D.L VAN.STRAW 250ML,PIECE,2,5000,8475,1525,10000,January
1450,DABUR HERBAL CLOVE 150G,PIECE,2,6000,10169,1831,12000,January
1488,"DEAR BODY ROCKING,CHIC",PIECE,2,17000,28814,5186,34000,January
1511,DELLA CHOCOLATE,PIECE,2,3000,5085,915,6000,January
1540,DETTOL ACTIVE 175G,PIECE,2,6500,11017,1983,13000,January
1554,DETTOL LIQUID 500ML,PIECE,2,23000,38983,7017,46000,January
1568,DEXE BLACK HAIR SHAMPOO,PIECE,2,2000,3390,610,4000,January
1569,DIANA LOTION 30ML,PIECE,2,4000,6780,1220,8000,January
1595,DISPOSABLE FORKS 2500,PIECE,2,4000,6780,1220,8000,January
1633,DOLBY SPORT SPRAY,PIECE,2,12000,20339,3661,24000,January
1641,DOLL 25000,PIECE,2,25000,42373,7627,50000,January
1653,DOLLS 2000,PIECE,2,2000,3390,610,4000,January
1666,DOMS COLOUR PENCILS LONG,PIECE,2,7000,11864,2136,14000,January
1688,DOUBLE REFINED SALT 650G,PIECE,2,7000,11864,2136,14000,January
1731,DOVE ROLL ON MIX,PIECE,2,11000,18644,3356,22000,January
1768,DURACELL AA ORIGINAL,PIECE,2,7000,11864,2136,14000,January
1779,DURU FRESH SENSATION 4PCS,PIECE,2,16000,27119,4881,32000,January
1877,ELEGANT JASMINE A.F,PIECE,2,7000,11864,2136,14000,January
1924,EUROTOP JUMBO T.P 2000,PIECE,2,2000,3390,610,4000,January
1934,EXCEL GLUCOSE 250G,PIECE,2,6500,11017,1983,13000,January
2006,FAMEN FRESHLY FREE,PIECE,2,6500,11017,1983,13000,January
2061,FEATHERS PADS REGULAR,PIECE,2,3000,5085,915,6000,January
2118,FOGG ABSOLUTE ROLLON,PIECE,2,8500,14407,2593,17000,January
2120,FOGG BOLD ROLLON 50MLS,PIECE,2,8500,14407,2593,17000,January
2177,FORTUNE GOLD 3LTR,PIECE,2,28000,47458,8542,56000,January
2205,FRESH DIARY LONG LIFE BOX,BOX,2,23000,38983,7017,46000,January
2281,GARDEN TEA 250,PIECE,2,14000,23729,4271,28000,January
2310,GIFT BAG 1500,PIECE,2,1500,2542,458,3000,January
2311,GIFT BAG 2500,PIECE,2,2500,4237,763,5000,January
2455,GREEN RIVER POWDER 5G,PIECE,2,1000,1695,305,2000,January
2569,HOBBY LIQUID SOAP GLISERIN'KIWI,PIECE,2,7500,12712,2288,15000,January
2721,JAMIES CAKE @70k,PIECE,2,70000,118644,21356,140000,January
2730,JAMIES CROCKDILE BREAD 1KG,PIECE,2,6000,10169,1831,12000,January
2803,JESA TOFFEE 250G,PIECE,2,2500,4237,763,5000,January
2804,JESA TOFFEE YOGHURT 500G,PIECE,2,3700,6271,1129,7400,January
2829,JIK COLOURS 1LTRS,PIECE,2,16000,27119,4881,32000,January
2936,KABODY MILLET SOYA PORRIDGE,PIECE,2,6500,11017,1983,13000,January
2937,KABODY MUKENE SOYA RICE1KG,PIECE,2,6000,10169,1831,12000,January
2942,KABODY PURE MILLET 1KG,PIECE,2,6000,10169,1831,12000,January
2992,KELLOGS CORNFLAKES 500g,PIECE,2,27000,45763,8237,54000,January
3078,KIDS PATRAS 3000,PIECE,2,3000,5085,915,6000,January
3084,KIDS TOOTH BRUSH 5000,PIECE,2,5000,8475,1525,10000,January
3144,KIWI SUEDE CLEANER BLACK,PIECE,2,7000,11864,2136,14000,January
3145,KIWI SUEDE CLEANER NEUTRAL,PIECE,2,7000,11864,2136,14000,January
3160,KNIFE 4000 KM7095,PIECE,2,5000,8475,1525,10000,January
3191,KOOKSY STRAWBERRY 500ML,PIECE,2,5000,8475,1525,10000,January
3236,KYOGERO HERBAL JELLY 250G,PIECE,2,7500,12712,2288,15000,January
3244,LA BELLE BABY JELLY 55G,PIECE,2,2000,3390,610,4000,January
3317,LATO VANILLA MILK 250MLS,PIECE,2,2000,3390,610,4000,January
3411,LOTUS TOOTHBRUSH EXPERT,PIECE,2,4000,6780,1220,8000,January
3525,MACDO TOMATO SAUCE SACHETS,PIECE,2,13000,22034,3966,26000,January
3548,MAGANJO PURE MILLET 1KG,PIECE,2,6500,11017,1983,13000,January
3561,MAGIC 1KG BUCKET,PIECE,2,12500,21186,3814,25000,January
3598,MANUSCRIPT BOOK 2Q,PIECE,2,12000,20339,3661,24000,January
3612,MASKING TAPE 2500,PIECE,2,2500,4237,763,5000,January
3626,MAYONNAISE BIG 887ML,PIECE,2,30000,50847,9153,60000,January
3653,MELEX SIMSIM 170G 2000,PIECE,2,2000,3390,610,4000,January
3657,MELEX SIMSIM BALLS 500,PIECE,2,2750,4661,839,5500,January
3748,MIRROR 1500,PIECE,2,1500,2542,458,3000,January
3888,MOVIT FAMILY SOAP ALOE 120G,PIECE,2,2500,4237,763,5000,January
3903,MOVIT HAIR FOOD 70G,PIECE,2,3000,5085,915,6000,January
3904,MOVIT HAIR FOOD AVACADO OIL 200G,PIECE,2,5500,9322,1678,11000,January
3906,MOVIT HERBAL JELLY 120G,PIECE,2,3500,5932,1068,7000,January
3939,MR.ZECO SWEETS,PIECE,2,300,508,92,600,January
3982,MWANA MUGIMU JELLY 200G,PIECE,2,6000,10169,1831,12000,January
4047,NESCAFE CLASSIC SACHETS 1.6G,PIECE,2,500,847,153,1000,January
4053,NEW FASHION RUBBER BANDS,PIECE,2,1000,1695,305,2000,January
4108,NIGINA SHOES 17000,PIECE,2,17000,28814,5186,34000,January
4119,NISA HAIR REMOVAL CUCUMBER 50ML,PIECE,2,7000,11864,2136,14000,January
4170,NIVEA MEN REVITALIZING 200ML,PIECE,2,15000,25424,4576,30000,January
4196,NOTE BOOK 3000,PIECE,2,3000,5085,915,6000,January
4198,NOTE BOOK 4000,PIECE,2,4000,6780,1220,8000,January
4207,NOVICOL WOOD GLUE,PIECE,2,5000,8475,1525,10000,January
4267,NUVITA GINGER BISCUITS 75G,PIECE,2,2000,3390,610,4000,January
4274,NUVITA ORANGE CREAM BISCUITS,PIECE,2,1500,2542,458,3000,January
4326,OLIVE OIL BODY WHIP 444ML,PIECE,2,28000,47458,8542,56000,January
4328,OLIVE OIL ORS SPRAY 472ML,PIECE,2,15000,25424,4576,30000,January
4344,OMO FAST ACTION 1KG,PIECE,2,12500,21186,3814,25000,January
4350,ONER MANGO 1LTR,PIECE,2,5000,8475,1525,10000,January
4416,OX FORD SETS 11000,PIECE,2,11000,18644,3356,22000,January
4431,PADLOCK 3500,PIECE,2,3500,5932,1068,7000,January
4434,PADLOCK 6000,PIECE,2,6000,10169,1831,12000,January
4442,PAMPER 2 H.C,PIECE,2,40000,67797,12203,80000,January
4500,PASSION WOODY OUD,PIECE,2,17000,28814,5186,34000,January
4511,PEGS 5000,PIECE,2,5000,8475,1525,10000,January
4513,PEGS DM 12000,PIECE,2,12000,20339,3661,24000,January
4546,PEPTANG KETCHUP 400G,PIECE,2,7500,12712,2288,15000,January
4590,PICFARE RULED PAPER BIG,PIECE,2,20000,33898,6102,40000,January
4695,POULTRY VIENNAS 250G,PIECE,2,13000,22034,3966,26000,January
4716,PRESTIGE 1KG,PIECE,2,14000,23729,4271,28000,January
4732,PRINCESS ULTRA PADS,PIECE,2,2700,4576,824,5400,January
4743,PRINGLES ORIGINAL 40G,PIECE,2,5500,9322,1678,11000,January
4748,PRIVE BLACK OPTION BODYSPLASH,PIECE,2,15000,25424,4576,30000,January
4751,PRIVE EYE CANDY PARFUM,PIECE,2,16000,27119,4881,32000,January
4760,PRIVE SENA POUR FEMME,PIECE,2,15000,25424,4576,30000,January
4764,PROCTOR&ALLAN CORNFLAKES 250G,PIECE,2,14000,23729,4271,28000,January
4784,PUCELLE ECCENTRIC BREEZE,PIECE,2,7250,12288,2212,14500,January
4819,PVC CLING FILM 45CM,PIECE,2,18000,30508,5492,36000,January
4820,QUAKER WHITE OATS,PIECE,2,13000,22034,3966,26000,January
4841,RADIANT OLIVE OIL HAIR SPRAY 100ML,PIECE,2,6500,11017,1983,13000,January
4897,RED COCK 2KG,PIECE,2,27000,45763,8237,54000,January
4903,RELAX TP,PIECE,2,1500,2542,458,3000,January
4935,RIBBONS 7500,PIECE,2,7500,12712,2288,15000,January
4955,RIHAM DIGESTIVE TIN,PIECE,2,18000,30508,5492,36000,January
4973,RINJU HAND&BODY CREAM 118ML,PIECE,2,18000,30508,5492,36000,January
4989,ROKI 5LTRS,PIECE,2,30000,50847,9153,60000,January
5024,ROYCO CUBE CHICKEN FLAVOUR,PIECE,2,5000,8475,1525,10000,January
5072,SALT SHAKERS 4000,PIECE,2,4000,6780,1220,8000,January
5077,SAMONA HERBAL JELLY 100G,PIECE,2,4000,6780,1220,8000,January
5088,SANDALS 7000,PIECE,2,7000,11864,2136,14000,January
5147,SAVANNAH MANGO 3LTR,PIECE,2,22000,37288,6712,44000,January
5151,SAVANNAH PINEAPPLE 2LTR,PIECE,2,18000,30508,5492,36000,January
5187,SCRATCHERS 1000,PIECE,2,1000,1695,305,2000,January
5209,SECRETS PADS,PIECE,2,4000,6780,1220,8000,January
5227,SERVING SPOON 2000,PIECE,2,2000,3390,610,4000,January
5269,SHENKE MOSQUITO COIL,PIECE,2,6000,10169,1831,12000,January
5293,SHOE BRUSHES 4000,PIECE,2,4000,6780,1220,8000,January
5304,SHOWER TO SHOWER INVISIBLE DRY,PIECE,2,6000,10169,1831,12000,January
5306,SHOWER TO SHOWER SENSITIVE,PIECE,2,6000,10169,1831,12000,January
5308,SHOWER TOSHOWER FRESH MORNING,PIECE,2,6000,10169,1831,12000,January
5314,SHOWERTOSHOWER FRESH DAWN,PIECE,2,6000,10169,1831,12000,January
5315,SHOWERTOSHOWER FRESH POWDER,PIECE,2,6000,10169,1831,12000,January
5360,SIMBA MBILI 100G,PIECE,2,7000,11864,2136,14000,January
5373,SIMKA PINE-VANILLA 120ML,PIECE,2,1000,1695,305,2000,January
5484,SO SOFT FRESH 2.5L,PIECE,2,28500,48305,8695,57000,January
5506,SOFINE MILK BRIGHTEN 1LTR,PIECE,2,20000,33898,6102,40000,January
5518,SOFT BROOMS 12000,PIECE,2,12000,20339,3661,24000,January
5523,SOFT PERFUME,PIECE,2,12000,20339,3661,24000,January
5527,SOFTCARE BABY PANTS L40,PIECE,2,27000,45763,8237,54000,January
5531,SOFTCARE M42 GOLD,PIECE,2,25000,42373,7627,50000,January
5558,SOSOFT BABY 750MLS,PIECE,2,11000,18644,3356,22000,January
5559,SOSOFT FRESH 750ML,PIECE,2,11000,18644,3356,22000,January
5597,SPLASH GUAVA 1LTR,PIECE,2,8000,13559,2441,16000,January
5605,SPLASH ORANGE 250ML,PIECE,2,2000,3390,610,4000,January
5618,SPOONS 10000 6PCS,PIECE,2,10000,16949,3051,20000,January
5631,SQUEEZERS DOULBLE 10000,PIECE,2,10000,16949,3051,20000,January
5649,STAR COFFEE 250G B. CHOICE,PIECE,2,10000,16949,3051,20000,January
5656,STA-SOFT LAVENDER 750ML,PIECE,2,12000,20339,3661,24000,January
5745,SUMZ DADDIES PKT 13000,PIECE,2,13000,22034,3966,26000,January
5794,SUNLIGHT SPRING IKG,PIECE,2,11000,18644,3356,22000,January
5813,SUNSIP APPLE 3LTRS,PIECE,2,16000,27119,4881,32000,January
5814,SUNSIP APPLE 5LTR,PIECE,2,24000,40678,7322,48000,January
5815,SUNSIP BLACKCURRANT 3LTR,PIECE,2,16000,27119,4881,32000,January
5823,SUNSIP STRAWBERRY 5LTRS,PIECE,2,24000,40678,7322,48000,January
5904,SWT CHENAB 2KG,PIECE,2,28000,47458,8542,56000,January
5964,TEEPEE BRUSH A9,PIECE,2,3000,5085,915,6000,January
5993,TENNIS BALL 2500,PIECE,2,3000,5085,915,6000,January
6045,TOILET BLUE BLOCKS 4PCS,PIECE,2,7500,12712,2288,15000,January
6051,TOILET BRUSHES METTALIC,PIECE,2,8000,13559,2441,16000,January
6139,TOTO'S VESTLINE JELLY 500G,PIECE,2,10000,16949,3051,20000,January
6186,TROPICAL HEAT BLACK PEPPER 100G,PIECE,2,8500,14407,2593,17000,January
6190,TROPICAL HEAT CINNAMON 50G,PIECE,2,4500,7627,1373,9000,January
6197,TROPICAL HEAT FISH MASALA 100G,PIECE,2,5000,8475,1525,10000,January
6208,TROPICAL HEAT PAPRIKA,PIECE,2,3500,5932,1068,7000,January
6210,TROPICAL HEAT PILAU MASALA 50G,PIECE,2,6000,10169,1831,12000,January
6217,TROPICAL HEAT TURMERIC 100G,PIECE,2,7000,11864,2136,14000,January
6288,U-FRESH MANGO,PIECE,2,700,1186,214,1400,January
6304,UGANDA SAFARI TEA 100G,PIECE,2,3500,5932,1068,7000,January
6308,UGANDA TEA BAGS 100BAGS,PIECE,2,9000,15254,2746,18000,January
6412,VASELINE DRY SKIN REPAIR 200ML,PIECE,2,8000,13559,2441,16000,January
6423,VASELINE MEN COOLING LOTION 200ML,PIECE,2,8000,13559,2441,16000,January
6468,VIM LAVENDER 1KG,PIECE,2,8000,13559,2441,16000,January
6497,WANDAZ PETROLEUM JELLY 500G,PIECE,2,11500,19492,3508,23000,January
6672,ZESTA MIXED FRUIT JAM,PIECE,2,7500,12712,2288,15000,January
6673,ZESTA MIXED FRUIT JAM 500G,PIECE,2,10500,17797,3203,21000,January
6676,ZESTA TOMATO KETCHUP,PIECE,2,7000,11864,2136,14000,January
6765,BIRTHDAY CANDLE 2K,PIECE,2,2000,3390,610,4000,January
6766,BIRTHDAY CANDLE 1500,PIECE,2,1500,2542,458,3000,January
6884,SAFA TOMATO KETCHUP 340G,PIECE,2,6000,10169,1831,12000,January
6959,S CONTROL HAIR TEXTURIZER 125ML,PIECE,2,5000,8475,1525,10000,January
7077,VASELINE BLUESEAL ALOEVERA 95ML,PIECE,2,5000,8475,1525,10000,January
7132,HUGGIES PANTS DRY COMFORT S.6,PIECE,2,32000,54237,9763,64000,January
7175,JAMIES LIQUID SOAP 3LTR,PIECE,2,3000,5085,915,6000,January
7317,PRIVE CRAZY GIRL 250ML,PIECE,2,14000,23729,4271,28000,January
7339,SOFTCARE GOLD S48,PIECE,2,25000,42373,7627,50000,January
7344,COMB 1000,PIECE,2,1000,1695,305,2000,January
7363,SUMZ PUMPKIN SEEDS 100G,PIECE,2,5000,8475,1525,10000,January
7400,NUTRO DIGESTIVE LIGHT 400G,PIECE,2,13000,22034,3966,26000,January
7419,Sandals,PIECE,2,8001,13561,2441,16002,January
7429,TROPICAL HEAT PAPRIKA SPICE 100G,PIECE,2,6000,10169,1831,12000,January
7485,JAMIES HOTDOG WHOLESALE 3000,PIECE,2,3000,5085,915,6000,January
7490,BIRTHDAY CANDLES STAR 4000,PIECE,2,4000,6780,1220,8000,January
7502,ISLAND BREEZE A.F LEMON 350ML,PIECE,2,7000,11864,2136,14000,January
7598,NISA ALOEVERA LOTION 200ML,PIECE,2,8000,13559,2441,16000,January
7613,CLEAR BAG 1500,PIECE,2,1500,2542,458,3000,January
7645,SOFTCARE GOLD XL36,PIECE,2,25000,42373,7627,50000,January
7719,SECRETS PADS ULTRA DAY&NIGHT PINK,PIECE,2,5500,9322,1678,11000,January
7762,PRINGLES PAPRIKA,PIECE,2,5500,9322,1678,11000,January
7765,PRINGLES PAPRIKA 165G,PIECE,2,12000,20339,3661,24000,January
7768,SOAP DISH 5000,PIECE,2,5000,8475,1525,10000,January
7774,SUMZ TANGY LEMON 60G,PIECE,2,3000,5085,915,6000,January
7820,REXONA STRESS CONTROL 200ML,PIECE,2,13000,22034,3966,26000,January
7839,RIGGS CHIEF 250ML,PIECE,2,16000,27119,4881,32000,January
7850,ELEGANT LUXURIOUS GOLD,PIECE,2,7000,11864,2136,14000,January
7855,OLYMPUS BLOSSOM 250ML,PIECE,2,16000,27119,4881,32000,January
7880,WEETABIX STRAWBERRY 230G,PIECE,2,9500,16102,2898,19000,January
7882,ELEGANT LADY BLUE A.F 300ML,PIECE,2,6500,11017,1983,13000,January
7889,DOVE GO FRESH ROLLON 48HR,PIECE,2,11000,18644,3356,22000,January
7905,SAFEGUARD LEMON SOAP,PIECE,2,1500,2542,458,3000,January
7906,SAFEGUARD PURE WHITE ,PIECE,2,1500,2542,458,3000,January
4,180ML DISPOSABLE GLASSES,PIECE,3,3000,7627,1373,9000,January
7,300MLS DISPOSABLE GLASSES,PIECE,3,5000,12712,2288,15000,January
15,7DAYS ANTIBACTERIAL BABY WIPES,PIECE,3,8500,21610,3890,25500,January
35,ACTIVE MAN SPRAY,PIECE,3,10000,25424,4576,30000,January
84,Always dreamzz,PIECE,3,3500,8898,1602,10500,January
103,AMARA COCOA BUTTER 200ML,PIECE,3,6000,15254,2746,18000,January
105,AMARA COCOA BUTTER LOTION 400ML,PIECE,3,8500,21610,3890,25500,January
127,AMERICAN GARDEN KETCHUP 425G,PIECE,3,13500,34322,6178,40500,January
146,AMLA HAIR OIL 100ML,PIECE,3,7000,17797,3203,21000,January
186,APTAMIL 1 400G,PIECE,3,52000,132203,23797,156000,January
208,ARIEL COLOR 1KG,PIECE,3,15502,39412,7094,46506,January
235,ARMAF SHADES FOR MEN,PIECE,3,16000,40678,7322,48000,January
270,ART BOOK BIG,PIECE,3,4000,10169,1831,12000,January
276,ART PENCILS 5B,PIECE,3,1000,2542,458,3000,January
340,AXION LEMON 200G,PIECE,3,6000,15254,2746,18000,January
350,B.D BALOON CHART,PIECE,3,3667,9322,1678,11000,January
442,BABY JUNIOR JELLY 200g,PIECE,3,6000,15254,2746,18000,January
454,BABY NIPPLES 700,PIECE,3,700,1780,320,2100,January
501,BABY&ME JELLY 120ML,PIECE,3,3000,7627,1373,9000,January
505,BACKPACK GREEN,PIECE,3,12000,30508,5492,36000,January
534,BALLET BABY OIL ALMOND 240ML,PIECE,3,14000,35593,6407,42000,January
536,BALLET BABY SOAP CALENDULA,PIECE,3,4000,10169,1831,12000,January
541,BALLET POWDER 100G,PIECE,3,5000,12712,2288,15000,January
690,BIYINZIKA THIGHS 500G,PIECE,3,10000,25424,4576,30000,January
712,BLUE 4 MEN SPRAY,PIECE,3,12000,30508,5492,36000,January
714,BLUE BAND 1KG,PIECE,3,19000,48305,8695,57000,January
915,C.B RIPPLES ORANGE 200ML,PIECE,3,4000,10169,1831,12000,January
918,C.B ROYAL MANGO 200ML,PIECE,3,4500,11441,2059,13500,January
981,CAMERA NIPPLES L,PIECE,3,1500,3814,686,4500,January
1015,CAR TOYS 6000,PIECE,3,6000,15254,2746,18000,January
1063,CELOTAPE MEDIUM,PIECE,3,5000,12712,2288,15000,January
1067,CERELAC 6MONTHS,PIECE,3,27000,68644,12356,81000,January
1189,CLERE FOR MEN ICE 250G,PIECE,3,6000,15254,2746,18000,January
1191,CLERE MEN ICE 100G,PIECE,3,2000,5085,915,6000,January
1244,COLGATE 0-2YEARS,PIECE,3,4000,10169,1831,12000,January
1248,COLGATE DEEP CLEAN,PIECE,3,1500,3814,686,4500,January
1263,COLGATE MAXIMUM CAVITY 70G,PIECE,3,4500,11441,2059,13500,January
1277,COMB 1500,PIECE,3,1500,3814,686,4500,January
1278,COMB 500,PIECE,3,500,1271,229,1500,January
1338,COVERTINA MILK CHOCOLATE,PIECE,3,3500,8898,1602,10500,January
1343,COW & GATE 1 400GM,PIECE,3,44000,111864,20136,132000,January
1391,CUSSONS BABY OIL 100MLS,PIECE,3,9000,22881,4119,27000,January
1412,CUTTERS 1000,PIECE,3,1000,2542,458,3000,January
1451,DABUR HERBAL MINT&LEMON,PIECE,3,6500,16525,2975,19500,January
1486,DATES 3000,PIECE,3,3500,8898,1602,10500,January
1526,DENTAL FLOSS /PICKS,PIECE,3,2500,6356,1144,7500,January
1538,DESSERT NOTE BOOK 4000,PIECE,3,4500,11441,2059,13500,January
1539,DETTOL 125MLS,PIECE,3,9000,22881,4119,27000,January
1550,DETTOL HERBAL 105G,PIECE,3,4500,11441,2059,13500,January
1557,DETTOL ORIGINAL 100G,PIECE,3,4500,11441,2059,13500,January
1773,DURU CUCUMBER,PIECE,3,4500,11441,2059,13500,January
1784,DURU MOUNTAINAIR SOAP,PIECE,3,14000,35593,6407,42000,January
1788,DURU OCEAN BREEZE SOAP,PIECE,3,14000,35593,6407,42000,January
1804,E.A HONEY 1LTR,PIECE,3,29000,73729,13271,87000,January
1908,ENVELOPE A4,PIECE,3,500,1271,229,1500,January
1974,FA CARRIEAN LEMON,PIECE,3,6500,16525,2975,19500,January
1975,FA DRY PROTECT,PIECE,3,6500,16525,2975,19500,January
2140,FOGG ULTIMATE ROLLON,PIECE,3,8500,21610,3890,25500,January
2152,FOOD COLOUR EGG YELLOW,PIECE,3,1000,2542,458,3000,January
2153,FOOD COLOUR GREEN,PIECE,3,1000,2542,458,3000,January
2176,FORTUNE GOLD 1LTR,PIECE,3,10000,25424,4576,30000,January
2375,GLUE STICK 21G,PIECE,3,2500,6356,1144,7500,January
2413,GOOD DAY CASHEW COOKIES,PIECE,3,2600,6610,1190,7800,January
2489,HAND SCRUBBING BRUSH 2000,PIECE,3,2000,5085,915,6000,January
2518,HARPIC ORIGINAL PLUS,PIECE,3,15000,38136,6864,45000,January
2598,HOT PEPPER POWDER,PIECE,3,4000,10169,1831,12000,January
2673,INDO CAFE 50G,PIECE,3,10000,25424,4576,30000,January
2922,JUMBO WAX CRAYONS,PIECE,3,5000,12712,2288,15000,January
2924,JUNSHENG COTTON SWABS,PIECE,3,2000,5085,915,6000,January
2944,KABODY RICE FLOUR 1KG,PIECE,3,6500,16525,2975,19500,January
3133,KIWI BLACK 80G,PIECE,3,8000,20339,3661,24000,January
3140,KIWI POLISH 12G,PIECE,3,2500,6356,1144,7500,January
3203,KOOKSY VANILLA CHOCOLATE 250ML,PIECE,3,3500,8898,1602,10500,January
3260,LABELLE HAIR FOOD 150G,PIECE,3,5000,12712,2288,15000,January
3275,LANZO ANTI-BACTERIAL SOAP,PIECE,3,4500,11441,2059,13500,January
3279,LANZO VANILLA SOAP,PIECE,3,3500,8898,1602,10500,January
3367,LET'S IMAGINE SPRAY,PIECE,3,12000,30508,5492,36000,January
3457,LUXURY CAR TISSUE,PIECE,3,4000,10169,1831,12000,January
3472,M&G HELLO BEARS PEN ERASE,PIECE,3,2500,6356,1144,7500,January
3526,MACRO DENTAL FLOSS,PIECE,3,3000,7627,1373,9000,January
3533,MAGANJO BABY SOYA 1KG,PIECE,3,6500,16525,2975,19500,January
3602,MARHABA AMLA OIL 160ML,PIECE,3,12000,30508,5492,36000,January
3606,MARIKA CORN FLOUR 400G,PIECE,3,5000,12712,2288,15000,January
3655,MELEX SIMSIM BALLS 1000,PIECE,3,1000,2542,458,3000,January
3669,MEN SOCKS 3500,PIECE,3,3500,8898,1602,10500,January
3855,MOTH BALLS 4000,PIECE,3,7000,17797,3203,21000,January
3887,MOVIT FAMILY SOAP 230G,PIECE,3,4000,10169,1831,12000,January
3891,MOVIT FAMILY SOAP COCOMUT 125G,PIECE,3,2500,6356,1144,7500,January
3902,MOVIT HAIR FOOD 120G,PIECE,3,3000,7627,1373,9000,January
3909,MOVIT HERBAL JELLY 50G,PIECE,3,1500,3814,686,4500,January
3930,MOVIT SOAP LEMON 120G,PIECE,3,2500,6356,1144,7500,January
3995,NACET BLADES 2500 PKT,PIECE,3,2500,6356,1144,7500,January
4001,NANA HERBAL MOUTH 60MLS,PIECE,3,7500,19068,3432,22500,January
4122,NISA HAIR REMOVAL ROSE 50ML,PIECE,3,7000,17797,3203,21000,January
4157,NIVEA MEN DEEP BLACK CARBON,PIECE,3,11000,27966,5034,33000,January
4201,NOTE BOOK SPIRAL 10000,PIECE,3,10000,25424,4576,30000,January
4245,NUTRO STRAW CREAM WAFERS,PIECE,3,3500,8898,1602,10500,January
4339,OMO BLEACH REGULAR,PIECE,3,8000,20339,3661,24000,January
4342,OMO COMFORT 1KG,PIECE,3,13000,33051,5949,39000,January
4363,ORAL-B TOOTHBRUSH,PIECE,3,3500,8898,1602,10500,January
4365,ORCHID VALLEY APPLE 1LTR,PIECE,3,7500,19068,3432,22500,January
4372,ORCHID VALLEY TROPICAL 1LTR,PIECE,3,7500,19068,3432,22500,January
4425,P.K GREEN BIG,PIECE,3,1000,2542,458,3000,January
4450,PAMPER 4 L.C PANTS,PIECE,3,9000,22881,4119,27000,January
4517,PELIKAN RUBBERS 1000,PIECE,3,1000,2542,458,3000,January
4520,PENCIL BAG 3500,PIECE,3,3500,8898,1602,10500,January
4540,PEPSODENT CAVITY FIGHTER 150G,PIECE,3,5000,12712,2288,15000,January
4580,PICFARE 4 QUIRE 10000,PIECE,3,10000,25424,4576,30000,January
4594,PICH n PEEL TROPICAL MIX 1LTR,PIECE,3,9500,24153,4347,28500,January
4644,PLATES CLAY 3000,PIECE,3,3500,8898,1602,10500,January
4739,PRINGLES HOT&SPICY 40G,PIECE,3,6000,15254,2746,18000,January
4787,PUCELLE FOR MY HEART,PIECE,3,7500,19068,3432,22500,January
4851,RAHA DRINKING CHOCOLATE 100G,PIECE,3,7000,17797,3203,21000,January
4943,RIHAM BUTTER COOKIES BISCUIT 1KG,PIECE,3,18000,45763,8237,54000,January
4990,ROKI OIL 1LTR,PIECE,3,10000,25424,4576,30000,January
5015,ROYALE BLUE SPRAY,PIECE,3,12000,30508,5492,36000,January
5018,ROYCO BEEF 500G,PIECE,3,12000,30508,5492,36000,January
5020,ROYCO BEEF 60G,PIECE,3,1200,3051,549,3600,January
5026,ROYCO CURRY+MCHUZI,PIECE,3,6500,16525,2975,19500,January
5053,SAFARI TEA 50G,PIECE,3,1500,3814,686,4500,January
5063,SAF-LEVURE 125G,PIECE,3,8500,21610,3890,25500,January
5170,SCHOOL SOCKS RED/GREEN YELLOW,PIECE,3,4000,10169,1831,12000,January
5176,SCISSORS 1500,PIECE,3,1500,3814,686,4500,January
5236,SESAME SNACKS 100G,PIECE,3,2500,6356,1144,7500,January
5260,SHARPENERS,PIECE,3,1000,2542,458,3000,January
5290,SHOE BRUSHES 2000,PIECE,3,2000,5085,915,6000,January
5324,SHREEJI GRAPH BOOK 96,PIECE,3,3000,7627,1373,9000,January
5400,SKIN CARE 150G,PIECE,3,4500,11441,2059,13500,January
5530,SOFTCARE L40,PIECE,3,25000,63559,11441,75000,January
5569,SOY SAUCE LIGHT 500G,PIECE,3,10000,25424,4576,30000,January
5613,SPONGES 2500,PIECE,3,2500,6356,1144,7500,January
5615,SPONGES WHITE 3000,PIECE,3,3000,7627,1373,9000,January
5668,STICK NOTES 8000,PIECE,3,8000,20339,3661,24000,January
5693,STRAWBERRY PRADIP COLORED,PIECE,3,5000,12712,2288,15000,January
5773,SUN SIP PASSION 3LTR,PIECE,3,16000,40678,7322,48000,January
5777,SUNLIGHT DISH LIQUID LEMON 400MLS,PIECE,3,7000,17797,3203,21000,January
5795,SUNLIGHT SPRING SENSATIONS 500G,PIECE,3,5500,13983,2517,16500,January
5819,SUNSIP MANGO 5LTR,PIECE,3,24000,61017,10983,72000,January
5852,SUPREME BAKING FLOUR,PIECE,3,9000,22881,4119,27000,January
5977,TEMMY'S CHOCO SCOOPS 250G,PIECE,3,11000,27966,5034,33000,January
6185,TROPICAL HEAT BEEF MASALA 100G,PIECE,3,5000,12712,2288,15000,January
6188,TROPICAL HEAT CHICKEN MASALA 100G,PIECE,3,5000,12712,2288,15000,January
6201,TROPICAL HEAT GINGER 100G,PIECE,3,7000,17797,3203,21000,January
6203,TROPICAL HEAT MEAT TENDERISER50G,PIECE,3,4000,10169,1831,12000,January
6239,TRUCK TOYS 12000,PIECE,3,12000,30508,5492,36000,January
6323,UMOJA SANDALS 8000,PIECE,3,10000,25424,4576,30000,January
6407,VASELINE COCOA GLOW 200ML,PIECE,3,8000,20339,3661,24000,January
6427,VASELINE MEN JELLY FRESH 240ML,PIECE,3,9500,24153,4347,28500,January
6548,WEETABIX OATIBIX 1KG,PIECE,3,18500,47034,8466,55500,January
6606,WRAPPERS 500,PIECE,3,500,1271,229,1500,January
6650,YOUR CHOICE SAUSAGE 1KG,PIECE,3,30000,76271,13729,90000,January
6817,BALLET BABY SOAP ALOEVERA,PIECE,3,4000,10169,1831,12000,January
6847,PIZZA 14'' CHICKEN ,PIECE,3,25000,63559,11441,75000,January
6848,PIZZA 16'' CHICKEN ,PIECE,3,35000,88983,16017,105000,January
6882,SUMZ FRIED PEAS,PIECE,3,2500,6356,1144,7500,January
6892,RAHA DRINKING CHOCOLATE 10G,PIECE,3,500,1271,229,1500,January
6987,DOMS CUBOID PEN ,PIECE,3,700,1780,320,2100,January
7036,SOAP DISH 3500,PIECE,3,3500,8898,1602,10500,January
7053,TREET SHAVER 1000,PIECE,3,1000,2542,458,3000,January
7120,JAMIES DADDIES 500G 10000,PIECE,3,10000,25424,4576,30000,January
7146,JAMIES COOKIES TIN 500G 10000,PIECE,3,10000,25424,4576,30000,January
7173,D.L FIESTA WHITE 70ML,PIECE,3,3000,7627,1373,9000,January
7346,LED TOUCH,PIECE,3,4000,10169,1831,12000,January
7393,HIKMA DADDIES 2000,PIECE,3,2000,5085,915,6000,January
7488,VERSMAN ACTIVE LOTION 400ML,PIECE,3,17000,43220,7780,51000,January
7554,AFIA LEMON 500ML,PIECE,3,3000,7627,1373,9000,January
7627,NIVEA MEN FRESH OCEAN 150ML,PIECE,3,16000,40678,7322,48000,January
7637,NISA ALOEVERA HAND&BODY LOTION 3000,PIECE,3,3000,7627,1373,9000,January
7723,JAMIES BROCRH BREAD 500G,PIECE,3,3500,8898,1602,10500,January
7742,RIHAM MILK&HONEY,PIECE,3,11000,27966,5034,33000,January
7761,LOVE HEART 2000,PIECE,3,2000,5085,915,6000,January
7819,KUZA INDIAN HEMP 113G,PIECE,3,22667,57627,10373,68000,January
7853,U BEATY GEL 1.8L,PIECE,3,20000,50847,9153,60000,January
7863,ORCHID VALLEY MANGO 250ML,PIECE,3,2000,5085,915,6000,January
7868,OMO HAMPER 25000,PIECE,3,25000,63559,11441,75000,January
7888,REXONA INVISIBLE DRY FRESH ROLLON 72JAM,PIECE,3,10000,25424,4576,30000,January
7891,NISA PAPAYA OIL 50ML,PIECE,3,3500,8898,1602,10500,January
7896,NUVITA CHOCO CHIP COOKIES 100GM,PIECE,3,2500,6356,1144,7500,January
113,AMARA MEN 400ML,PIECE,4,8625,29237,5263,34500,January
114,AMARA MEN COOLING,PIECE,4,6000,20339,3661,24000,January
277,ART PENCILS 6B,PIECE,4,1000,3390,610,4000,January
527,BALLET ALOE VERA JELLY 300MLS,PIECE,4,9500,32203,5797,38000,January
533,BALLET BABY MILK SOAP,PIECE,4,4000,13559,2441,16000,January
543,BALLET SHEA BUTTER SOAP,PIECE,4,3500,11864,2136,14000,January
570,BAMBOO TOOTHPICK 2500,PIECE,4,2500,8475,1525,10000,January
673,BIRTHDAY HATS 5000,PIECE,4,5000,16949,3051,20000,January
717,BLUE BAND LOW FAT,PIECE,4,6500,22034,3966,26000,January
776,BOTTLES 7000,PIECE,4,7000,23729,4271,28000,January
781,BOUNTY CHOCOLATE,PIECE,4,4000,13559,2441,16000,January
815,BRITANIA ASSORTED 1KG,PIECE,4,20000,67797,12203,80000,January
898,C' WARM CHOCOLATE,PIECE,4,500,1695,305,2000,January
914,C.B RIPPLES MIXED 200MLS,PIECE,4,4000,13559,2441,16000,January
1058,CELOTAPE 2000,PIECE,4,2500,8475,1525,10000,January
1059,CELOTAPE BIGGER 1OOOO,PIECE,4,10000,33898,6102,40000,January
1093,CHAMPION A4 200PAGES,PIECE,4,4000,13559,2441,16000,January
1095,CHAPA BAKING POWDER,PIECE,4,1500,5085,915,6000,January
1193,CLERE PETROLEUM JELLY 250G,PIECE,4,6000,20339,3661,24000,January
1256,COLGATE KIDS 2-5YEARS,PIECE,4,5000,16949,3051,20000,January
1257,COLGATE MAX FRESH 65G,PIECE,4,3500,11864,2136,14000,January
1270,COLGATE TRIPPLE ACTION 70G,PIECE,4,3500,11864,2136,14000,January
1358,CREAMBELL STRAW-VAN 120ML,PIECE,4,2500,8475,1525,10000,January
1384,CUPS STALLION 3000,PIECE,4,3000,10169,1831,12000,January
1389,CUSSON SOAP MILD&GENTLE,PIECE,4,3500,11864,2136,14000,January
1396,CUSSONS BABY UNPERFUMED JELLY 100ML,PIECE,4,5500,18644,3356,22000,January
1401,CUSSONS PERFUMED JELLY A&R 100ML,PIECE,4,5500,18644,3356,22000,January
1510,DELIDENT MAX 70G,PIECE,4,2000,6780,1220,8000,January
1559,DETTOL SENSITIVE 175G,PIECE,4,6500,22034,3966,26000,January
1560,DETTOL SKINCARE 175G,PIECE,4,6500,22034,3966,26000,January
1668,DOMS GEOMETRY SET,PIECE,4,8500,28814,5186,34000,January
1778,DURU FRESH SENSATION 4PC,PIECE,4,16000,54237,9763,64000,January
1987,FA MYSTIC MOMENTS,PIECE,4,6500,22034,3966,26000,January
1989,FA PINK PASSION ROLLON,PIECE,4,6500,22034,3966,26000,January
1993,FA SPORT ROLLON 50 ML,PIECE,4,6500,22034,3966,26000,January
2064,FEELINGS SPRAY,PIECE,4,12000,40678,7322,48000,January
2284,GARDEN TEA BAGS 100G,PIECE,4,6500,22034,3966,26000,January
2294,GEISHA MORINGA OIL 125G,PIECE,4,4000,13559,2441,16000,January
2315,GIFT BAG 4500,PIECE,4,4500,15254,2746,18000,January
2454,GREEN POLYTHENE,PIECE,4,300,1017,183,1200,January
2520,HARPIC POWER PLUS 500ML,PIECE,4,14750,50000,9000,59000,January
2657,IMPERIAL LEATHER MEN 175G,PIECE,4,4500,15254,2746,18000,January
2676,INDOCAFE CAPPUCCINO CREAMY,PIECE,4,3000,10169,1831,12000,January
2724,JAMIES CAKES @ 40K,PIECE,4,40000,135593,24407,160000,January
2769,JEE NAIL REMOVER,PIECE,4,1500,5085,915,6000,January
2781,JESA FINO BOX,BOX,4,24000,81356,14644,96000,January
2831,JIK REGULAR 250MLS,PIECE,4,6500,22034,3966,26000,January
2939,KABODY OATS SOYA RICE 1KG,PIECE,4,6500,22034,3966,26000,January
2947,KABODY WHITE OATS WITH RICE,PIECE,4,6000,20339,3661,24000,January
2962,KANGARO STAPLES,PIECE,4,2000,6780,1220,8000,January
3081,KIDS SOCKS 1500,PIECE,4,1500,5085,915,6000,January
3158,KNICKERS 9000,PIECE,4,9000,30508,5492,36000,January
3234,KYOGERO HERBAL JELLY 100ML,PIECE,4,3500,11864,2136,14000,January
3239,KYOGERO HERBAL SOAP 120G,PIECE,4,3500,11864,2136,14000,January
3277,LANZO COCONUT SHEA SOAP,PIECE,4,3500,11864,2136,14000,January
3499,M&G WHITE BOARD MARKER,PIECE,4,1500,5085,915,6000,January
3535,MAGANJO BABY SOYA WITH MILK 500G,PIECE,4,8500,28814,5186,34000,January
3538,MAGANJO CORNFLAKES,PIECE,4,10000,33898,6102,40000,January
3539,MAGANJO ENERGY BOOSTER 1KG,PIECE,4,6500,22034,3966,26000,January
3552,MAGANJO SOYA MILLET,PIECE,4,6500,22034,3966,26000,January
3840,MORTEIN LEMON 180ML,PIECE,4,15000,50847,9153,60000,January
3869,MOVIT BABY JELLY 110G,PIECE,4,3000,10169,1831,12000,January
4199,NOTE BOOK 5500,PIECE,4,5500,18644,3356,22000,January
4202,NOTE BOOK SPIRAL 9000,PIECE,4,9000,30508,5492,36000,January
4204,NOTEBOOK 6500,PIECE,4,6500,22034,3966,26000,January
4214,NTALE 100G,PIECE,4,4500,15254,2746,18000,January
4219,NUMA BUSHERA 2KG,PIECE,4,12000,40678,7322,48000,January
4222,NUMA RICE FLOUR 1KG,PIECE,4,7500,25424,4576,30000,January
4244,NUTRO ORANGE WAFFERS 150G,PIECE,4,6500,22034,3966,26000,January
4284,OATIBIX 500G,PIECE,4,12000,40678,7322,48000,January
4335,OMO BLEACH COLOUR SAFE 700ML.,PIECE,4,9000,30508,5492,36000,January
4336,OMO BLEACH LEMON,PIECE,4,8000,27119,4881,32000,January
4364,ORANGES 2000,PIECE,4,2500,8475,1525,10000,January
4370,ORCHID VALLEY PASSION 1LTR,PIECE,4,7000,23729,4271,28000,January
4444,PAMPER 2 L.C,PIECE,4,9000,30508,5492,36000,January
4447,PAMPER 3 L.C PANTS,PIECE,4,9000,30508,5492,36000,January
4484,PAPERLINE EXERCISE BK,PIECE,4,4000,13559,2441,16000,January
4588,PICFARE PENCILS 3000,PIECE,4,3000,10169,1831,12000,January
4591,PICFARE RULED PAPER SMALL,PIECE,4,11000,37288,6712,44000,January
4597,PICK n PEEL MANGO 1LTR,PIECE,4,9500,32203,5797,38000,January
4706,PRADIP VANILLA ESSENCE,PIECE,4,5000,16949,3051,20000,January
4734,PRINGLES BARBEQUE 165G,PIECE,4,11000,37288,6712,44000,January
4742,PRINGLES ORIGINAL 165G BURSTING,PIECE,4,11000,37288,6712,44000,January
4778,PROTEX HERBAL 90G,PIECE,4,4000,13559,2441,16000,January
4963,RIHAM VANILLA CREAMYCRUNCH,PIECE,4,3000,10169,1831,12000,January
5022,ROYCO CHICKEN 500G,PIECE,4,12000,40678,7322,48000,January
5025,ROYCO CUBES BEEF,PIECE,4,4000,13559,2441,16000,January
5055,SAFETY PIN 300,PIECE,4,200,678,122,800,January
5168,SCHOOL SOCKS BLUE&WHITE ORIGINAL 7500,PIECE,4,7500,25424,4576,30000,January
5275,SHENKE REPELLANT ORDOLESS,PIECE,4,8000,27119,4881,32000,January
5282,SHIVA HONEY 400G,PIECE,4,13000,44068,7932,52000,January
5307,SHOWER TO SHOWER SPRING RAIN,PIECE,4,6000,20339,3661,24000,January
5313,SHOWERTO SHOWER MUSK ALIVE,PIECE,4,6000,20339,3661,24000,January
5508,SOFINE PURE OLIVE OIL 120ML,PIECE,4,7000,23729,4271,28000,January
5594,SPLASH BOX 42000,BOX,4,45000,152542,27458,180000,January
5658,STA-SOFT SPRING FRESH 750MLS,PIECE,4,12000,40678,7322,48000,January
5726,SULTAN COCONUT HAIL OIL,PIECE,4,5000,16949,3051,20000,January
5816,SUNSIP BLACKCURRANT 5LTR,PIECE,4,24000,81356,14644,96000,January
5822,SUNSIP STRAWBERRY 3LTR,PIECE,4,16000,54237,9763,64000,January
6041,TOCEBA AAA,PIECE,4,700,2373,427,2800,January
6042,TOCEBAL AA,PIECE,4,1000,3390,610,4000,January
6305,UGANDA SAFARI TEA 250G,PIECE,4,7000,23729,4271,28000,January
6651,YOUR CHOICE SAUSAGES 500G,PIECE,4,17000,57627,10373,68000,January
6675,ZESTA STRAWBERRY JAM 300GM,PIECE,4,7500,25424,4576,30000,January
6795,KATOGO 2000,PIECE,4,2000,6780,1220,8000,January
6993,DOMS WAX CRAYONS BIG,PIECE,4,5000,16949,3051,20000,January
7078,VASELINE BLUESEAL ALOEVERA 240ML,PIECE,4,9500,32203,5797,38000,January
7101,JAMIES DADDIES TIN 17000,PIECE,4,17000,57627,10373,68000,January
7427,COLGATE CLEAN MINT 10500,PIECE,4,10500,35593,6407,42000,January
7547,TOYS 15000,PIECE,4,11250,38136,6864,45000,January
7610,MARSHAL SET,PIECE,4,4000,13559,2441,16000,January
7648,COCKROACH KILLING BAIT 5G,PIECE,4,999,3386,610,3996,January
7722,JAMIES BRONCH BREAD 1KG,PIECE,4,6000,20339,3661,24000,January
7808,PICNIK CHOCOLATE 10G,PIECE,4,1000,3390,610,4000,January
7813,PETIT BEURRE 78G,PIECE,4,1300,4407,793,5200,January
7885,ROKI COOKING OIL 500ML,PIECE,4,4000,13559,2441,16000,January
16,7DAYS ANTIBACTERIAL WIPES,PIECE,5,5000,21186,3814,25000,January
93,ALWAYS V.P EXTRA LONG,PIECE,5,6500,27542,4958,32500,January
95,ALWAYS VALUE PACK LONG,PIECE,5,6500,27542,4958,32500,January
102,AMARA BODY MILK 400ML,PIECE,5,8500,36017,6483,42500,January
126,AMERICAN GARDEN KETCHUP 340G,PIECE,5,7500,31780,5720,37500,January
213,ARIEL DOWNY LAVENDER500G,PIECE,5,7800,33051,5949,39000,January
253,AROMAT 200G,PIECE,5,12000,50847,9153,60000,January
524,BALLET ACTIVE VITAMIN 300MLS,PIECE,5,9500,40254,7246,47500,January
577,BANNERS 7000,PIECE,5,7000,29661,5339,35000,January
613,BECCA COUNTERBOOK 5000,PIECE,5,3500,14831,2669,17500,January
627,BEIKU BABY SOOTHERS,PIECE,5,2500,10593,1907,12500,January
703,BLESSED KISUBI TEA 125G,PIECE,5,5000,21186,3814,25000,January
704,BLESSED KISUBI TEA 200G,PIECE,5,6000,25424,4576,30000,January
705,BLESSED KISUBI TEA 350G,PIECE,5,12000,50847,9153,60000,January
716,BLUE BAND 500G,PIECE,5,10000,42373,7627,50000,January
1017,CARAMBOLA BLACK SPOT,PIECE,5,6000,25424,4576,30000,January
1047,CB CLASSIC VANILLA 200MLS,PIECE,5,4000,16949,3051,20000,January
1097,CHAPA NYOTA BROWN 600G,PIECE,5,4000,16949,3051,20000,January
1131,CHINA GREEN TEA 50G,PIECE,5,5000,21186,3814,25000,January
1212,CLOSEUP TRIPLEFRESH 60G,PIECE,5,3000,12712,2288,15000,January
1269,COLGATE TRIPLE ACTION 140G,PIECE,5,6500,27542,4958,32500,January
1274,COLORES NEW ELITE COLOURS BIG,PIECE,5,2000,8475,1525,10000,January
1288,COMPACT NAPKINS,PIECE,5,3000,12712,2288,15000,January
1357,CREAMBELL STRAWBERRY VAN 500ML,PIECE,5,10000,42373,7627,50000,January
1444,D.L VANILLA CREAM 120MLS,PIECE,5,2000,8475,1525,10000,January
1448,DABUR CLOVE VALUE PACK,PIECE,5,11000,46610,8390,55000,January
1552,DETTOL JUNIORS GLYCERINE SOAP 100G,PIECE,5,4500,19068,3432,22500,January
1602,DISPOSABLE PLATES 9 ROUND,PIECE,5,6500,27542,4958,32500,January
1603,DISPOSABLE SPOON 4000,PIECE,5,4000,16949,3051,20000,January
1662,DOLPHIN MONDI PAPERS,PIECE,5,27000,114407,20593,135000,January
1814,EARBUDS 2500,PIECE,5,2500,10593,1907,12500,January
1823,ECLAIRS,PIECE,5,200,847,153,1000,January
1887,ELEGANT STRAWBERRY 300ML,PIECE,5,7000,29661,5339,35000,January
2150,FOOD COLOUR BLUE,PIECE,5,1000,4237,763,5000,January
2209,FRESH UP TOOTHPASTE,PIECE,5,2000,8475,1525,10000,January
2235,FRUITVILLE MANGO 500ML,PIECE,5,3500,14831,2669,17500,January
2295,GEISHA MORINGA OIL 225G,PIECE,5,5500,23305,4195,27500,January
2389,GOLDEN ALUMINIUM FOIL,PIECE,5,34000,144068,25932,170000,January
2477,HABARI SALT SMALL,PIECE,5,700,2966,534,3500,January
2538,HERMELA GUEST SOAP,PIECE,5,3500,14831,2669,17500,January
2706,JAGO 100MLS,PIECE,5,3500,14831,2669,17500,January
2714,JAGO SCRUB 250G,PIECE,5,7500,31780,5720,37500,January
2830,JIK COLOURS 250MLS,PIECE,5,7000,29661,5339,35000,January
2989,KAZIRE RED TONIC 350MLS,PIECE,5,2000,8475,1525,10000,January
3115,KIRUNGI MULONDO EXTRA 280ML,PIECE,5,1000,4237,763,5000,January
3150,KNICKERS 2000,PIECE,5,2000,8475,1525,10000,January
3290,LATO FLAVOURED BOX 23000,BOX,5,23000,97458,17542,115000,January
3295,LATO MILK 900G,PIECE,5,47000,199153,35847,235000,January
3376,LIFEBUOY TOTAL10 175G,PIECE,5,6000,25424,4576,30000,January
3493,M&G STICK GLUE 1500,PIECE,5,1500,6356,1144,7500,January
3575,MAKE UP FACIAL WIPES,PIECE,5,3500,14831,2669,17500,January
3586,MANAGEMENT FILE 2000,PIECE,5,2000,8475,1525,10000,January
3682,MESSAGE CARDS 500,PIECE,5,500,2119,381,2500,January
3750,MIRRORS 2500,PIECE,5,2500,10593,1907,12500,January
3809,MOPPER 7000,PIECE,5,7000,29661,5339,35000,January
3841,MORTEIN LEMON 300ML,PIECE,5,22000,93220,16780,110000,January
3954,MUKWANO OIL 1LTR JERRYCAN,PIECE,5,9800,41525,7475,49000,January
3964,MUSA'S COOKIES 180G,PIECE,5,3000,12712,2288,15000,January
3965,MUSA'S COOKIES 90G,PIECE,5,1500,6356,1144,7500,January
4026,NATARAJ RULER,PIECE,5,1500,6356,1144,7500,January
4223,NUMA SOYA RICE 1KG,PIECE,5,7000,29661,5339,35000,January
4263,NUVITA CHOCO BISCUITS,PIECE,5,2000,8475,1525,10000,January
4295,OFFICE GLUE 90G,PIECE,5,2000,8475,1525,10000,January
4368,ORCHID VALLEY MANGO 1LTR6161101061483,PIECE,5,7500,31780,5720,37500,January
4430,PADLOCK 3000,PIECE,5,3000,12712,2288,15000,January
4470,PANCHAVATI,PIECE,5,3200,13559,2441,16000,January
4516,PELIKAN RUBBER,PIECE,5,1000,4237,763,5000,January
4523,PENCIL BAGS 7000,PIECE,5,7000,29661,5339,35000,January
4766,PROTEX CLASSIC 100G,PIECE,5,3500,14831,2669,17500,January
4813,PURE GLUCOSE BOX,PIECE,5,1000,4237,763,5000,January
5021,ROYCO CHICKEN 200G,PIECE,5,6000,25424,4576,30000,January
5049,SAFA TOMATO PASTE 400G,PIECE,5,6000,25424,4576,30000,January
5171,SCHOOL SOCKS WHITE 7000,PIECE,5,7500,31780,5720,37500,January
5174,SCHOOL STOCKINGS WHITE,PIECE,5,4300,18220,3280,21500,January
5250,SHADES 6000,PIECE,5,6000,25424,4576,30000,January
5270,SHENKE MOSQUITO COIL LOW SMOKE,PIECE,5,6000,25424,4576,30000,January
5287,SHOE BRUSH 5000,PIECE,5,5000,21186,3814,25000,January
5724,SULFO GLYCERINE COLORLESS,PIECE,5,2000,8475,1525,10000,January
5725,SULFO GLYCERINE PINK,PIECE,5,2000,8475,1525,10000,January
5764,SUMZ SALT&VINEGAR 30G,PIECE,5,1500,6356,1144,7500,January
5767,SUMZS CRISPS 500G,PIECE,5,12000,50847,9153,60000,January
5786,SUNLIGHT LAVENDER 500G,PIECE,5,5500,23305,4195,27500,January
5803,SUNSEED OIL 2LTRS,PIECE,5,21000,88983,16017,105000,January
6103,TOP UP CHILL 260G,PIECE,5,2000,8475,1525,10000,January
6406,VASELINE BLUESEAL ORIGINAL 250ML,PIECE,5,9500,40254,7246,47500,January
6411,VASELINE COCOAGLOW LOTION 400G radiant,PIECE,5,14500,61441,11059,72500,January
6422,VASELINE MEN COOLING JELLY 240ML,PIECE,5,9500,40254,7246,47500,January
6424,VASELINE MEN EXTRA HYDRATION,PIECE,5,14500,61441,11059,72500,January
6568,WHITE CHALK 5000,PIECE,5,5000,21186,3814,25000,January
6666,ZESTA 500G,PIECE,5,10500,44492,8008,52500,January
6677,ZESTA TOMATO KETCHUP 700G,PIECE,5,12000,50847,9153,60000,January
6709,VASELINE BLUESEAL JELLY ORIGINAL 95ML,PIECE,5,5000,21186,3814,25000,January
6996,NATARAJ WAX CRAYONS 2500,PIECE,5,2500,10593,1907,12500,January
7163,SPIDERMAN SWEETS 700,PIECE,5,700,2966,534,3500,January
7174,JAMIES LIQUID SOAP 5LTR 10000,PIECE,5,10000,42373,7627,50000,January
7349,BODY SCRUBBER GLOVE,PIECE,5,2500,10593,1907,12500,January
7395,HIKMA HARD CORNS 2500,PIECE,5,2000,8475,1525,10000,January
7552,TOYS 5000,PIECE,5,5400,22881,4119,27000,January
7588,SUMZ CASHEW NUTS 75G,PIECE,5,7500,31780,5720,37500,January
7619,NICE BISCUITS ,PIECE,5,1500,6356,1144,7500,January
7687,NOTE BOOK 6500,PIECE,5,6500,27542,4958,32500,January
7705,JAMIES CAKE SLICE@8000,PIECE,5,7000,29661,5339,35000,January
7724,JAMIES DOUGHNUTS SMALL 6PCS,PIECE,5,3000,12712,2288,15000,January
7811,FLAMINGO ROSE& HONEY 200G,PIECE,5,3500,14831,2669,17500,January
7812,FLAMINGO LEMON&HONEY 200G,PIECE,5,3500,14831,2669,17500,January
7833,FANEST BEEF SAUSAGES 1KG,PIECE,5,20000,84746,15254,100000,January
7838,AMERICAN APPLE CIDER VINEGAR 473ML,PIECE,5,10000,42373,7627,50000,January
7862,ORCHID VALLEY GUAVA 250ML,PIECE,5,2000,8475,1525,10000,January
7864,ORCHID VALLEY APPLE 250ML,PIECE,5,2000,8475,1525,10000,January
7865,SWEETS 700,PIECE,5,698,2958,533,3491,January
7894,NUVITA CHOCOLATE COOKIES 100GM,PIECE,5,2500,10593,1907,12500,January
537,BALLET BUTTER BLEND 120MLS,PIECE,6,4500,22881,4119,27000,January
538,BALLET BUTTER BLEND 300ML,PIECE,6,9500,48305,8695,57000,January
672,BIRTHDAY HATS 3500,PIECE,6,3500,17797,3203,21000,January
692,BIYINZINKA LIVER 500G,PIECE,6,6000,30508,5492,36000,January
890,BUSHENYI HONEY 250G,PIECE,6,6000,30508,5492,36000,January
949,CADBURY RUM&RAISIN 80G,PIECE,6,8000,40678,7322,48000,January
1066,CERELAC 12MONTHS 400G,PIECE,6,27000,137288,24712,162000,January
1111,CHERRY COTTON BUDS,PIECE,6,2500,12712,2288,15000,January
1261,COLGATE MAXIMUM CAVITY 140G,PIECE,6,7500,38136,6864,45000,January
1428,D.L MAXIMO VAN-CHOCO FLAKES 175ML,PIECE,6,4000,20339,3661,24000,January
1453,DABUR NEEM TOOTHPASTE 150G,PIECE,6,6000,30508,5492,36000,January
1472,DAITY DARK'N'DARK ICE CREAM,PIECE,6,5000,25424,4576,30000,January
1547,DETTOL FRESH 175G,PIECE,6,6500,33051,5949,39000,January
1819,EAST AFRICAN ORGANIC HONEY 250G,PIECE,6,8000,40678,7322,48000,January
1940,F.D MANGO 250G,PIECE,6,2500,12712,2288,15000,January
1971,F.D YOGHURT MIXED BERRIES 450G,PIECE,6,3700,18814,3386,22200,January
2115,FOCUS GLASS CLEANER JASMINE,PIECE,6,7000,35593,6407,42000,January
2233,FRUITVILLE APPLE DRINK,PIECE,6,3500,17797,3203,21000,January
2283,GARDEN TEA 50G,PIECE,6,2500,12712,2288,15000,January
2765,JAMIES TWISTED BREAD 1KG,PIECE,6,6000,30508,5492,36000,January
3110,KIRINGI KAZI BOOSTER 280ML,PIECE,6,1000,5085,915,6000,January
3116,KIRUNGI PINEAPPLE 250MLS,PIECE,6,1000,5085,915,6000,January
3143,KIWI SHOE POLISH 32G,PIECE,6,5000,25424,4576,30000,January
3156,KNICKERS 7000,PIECE,6,7000,35593,6407,42000,January
3157,KNICKERS 8000,PIECE,6,8000,40678,7322,48000,January
3576,MAKE UP WIPES,PIECE,6,3500,17797,3203,21000,January
3609,MARS CHOCOLATE,PIECE,6,3500,17797,3203,21000,January
3678,MENTOS RAINBOW,PIECE,6,2000,10169,1831,12000,January
3894,MOVIT FAMILY SOAP ROSE 125G,PIECE,6,2500,12712,2288,15000,January
3913,MOVIT JELLY 200G,PIECE,6,5000,25424,4576,30000,January
3994,NACET 500 PCS,PIECE,6,500,2542,458,3000,January
4021,NATARAJ COLOR PENCILS,PIECE,6,7500,38136,6864,45000,January
4027,NATARAJ SETS,PIECE,6,10000,50847,9153,60000,January
4191,NOMI BUCKET 1KG,PIECE,6,12500,63559,11441,75000,January
4192,NOMI BUCKET 500G,PIECE,6,6500,33051,5949,39000,January
4239,NUTRO CREAM WAFERS 3,PIECE,6,6500,33051,5949,39000,January
4252,NUTRO WAFERS VANILLA,PIECE,6,3500,17797,3203,21000,January
4264,NUVITA CHOCOLATE CREAM,PIECE,6,1500,7627,1373,9000,January
4337,OMO BLEACH MULTI -PURPOSE,PIECE,6,4000,20339,3661,24000,January
4340,OMO BLEACH REGULAR 250ML,PIECE,6,3500,17797,3203,21000,January
4454,PAMPER 5 L.C PANTS,PIECE,6,9000,45763,8237,54000,January
4539,PEPSODENT CAVITY 65G,PIECE,6,2500,12712,2288,15000,January
4595,PICK n PEEL APPLE 1LTR,PIECE,6,9500,48305,8695,57000,January
4705,PRADIP VANILLA CLEAR FLAVOURING,PIECE,6,5000,25424,4576,30000,January
4898,RED COCK BASMATI 1KG,PIECE,6,14000,71186,12814,84000,January
4947,RIHAM COLA 320MLS,PIECE,6,1000,5085,915,6000,January
4958,RIHAM GINGER TIN,PIECE,6,18000,91525,16475,108000,January
4964,RIHAM WATER 1.5LTRS,PIECE,6,2000,10169,1831,12000,January
5222,SENSODYNE MULTI CARE 75MLS,PIECE,6,14000,71186,12814,84000,January
5265,SHENKE FLOWER REPELLENT,PIECE,6,8000,40678,7322,48000,January
5267,SHENKE LEMON SCENT,PIECE,6,8000,40678,7322,48000,January
5268,SHENKE LOTUS SCENT,PIECE,6,8000,40678,7322,48000,January
5272,SHENKE MOSQUITO REPELLANT,PIECE,6,16000,81356,14644,96000,January
5355,SILVER PLATE 300,PIECE,6,300,1525,275,1800,January
5381,SIMKA VANILLA 300MLS,PIECE,6,3500,17797,3203,21000,January
5567,SOY SAUCE DARK 500G,PIECE,6,10000,50847,9153,60000,January
5614,SPONGES 4500,PIECE,6,4500,22881,4119,27000,January
5766,SUMZ TANGY LEMON CRISPS 30G,PIECE,6,1500,7627,1373,9000,January
5798,SUNLIGHT TROPICAL 500G,PIECE,6,5500,27966,5034,33000,January
5802,SUNSEED OIL 1LTRS,PIECE,6,12000,61017,10983,72000,January
6470,VIM LEMON 1KG,PIECE,6,8000,40678,7322,48000,January
6471,VIM LEMON FRESH 500G,PIECE,6,5000,25424,4576,30000,January
6544,WEETABIX CORNFLAKES 500G,PIECE,6,21000,106780,19220,126000,January
6707,VASELINE BLUESEAL MEN COOLING 95ML,PIECE,6,5000,25424,4576,30000,January
6885,JAGO SCRUB 110G,PIECE,6,4000,20339,3661,24000,January
6935,SHREEJI 96 PAGES A4 ,PIECE,6,2000,10169,1831,12000,January
7025,FACE TOWELS 6000,PIECE,6,6000,30508,5492,36000,January
7137,JAMIES COOKIES 2000,PIECE,6,2000,10169,1831,12000,January
7147,JAMIES COOKIES 800G TIN 17000,PIECE,6,17000,86441,15559,102000,January
7308,COTTON EAR SWABS 4000,PIECE,6,4000,20339,3661,24000,January
7499,JAMIES SWEET CAKE WHOLESALE 500G,PIECE,6,2499,12705,2287,14992,January
7611,SUMZ ROASTED SESAME 80G,PIECE,6,2500,12712,2288,15000,January
7643,KAXUE KIDS TOOTHBRUSH,PIECE,6,2500,12712,2288,15000,January
7703,TOYS 1000,PIECE,6,1000,5085,915,6000,January
7720,SECRETS PADS ULTRA OVER NIGHT BLUE,PIECE,6,5500,27966,5034,33000,January
7860,WASH -Q KIDS TOOTH BRUSH ,PIECE,6,1000,5085,915,6000,January
354,B.D CANDLES 1500,PIECE,7,1500,8898,1602,10500,January
528,BALLET BABY JELLY 120MLS,PIECE,7,5000,29661,5339,35000,January
636,BESSA MILLET DRINK 500MLS,PIECE,7,4500,26695,4805,31500,January
689,BIYINZIKA SUPA 1KG,PIECE,7,20000,118644,21356,140000,January
729,BLUE TOILET BLOCKS DOUBLE,PIECE,7,5000,29661,5339,35000,January
891,BUSHENYI HONEY 5OOG,PIECE,7,9000,53390,9610,63000,January
892,BUSHENYI HONEY 90G,PIECE,7,3500,20763,3737,24500,January
966,CAKE WRAPPER 1000,PIECE,7,1000,5932,1068,7000,January
1045,CB CHOC-VANILLA 120MLS,PIECE,7,2500,14831,2669,17500,January
1048,CB CLASSIC VANILLA 500ML,PIECE,7,10000,59322,10678,70000,January
1427,D.L MAXIMO CARAMEL NUTS,PIECE,7,3500,20763,3737,24500,January
1527,DENTEX TOOTHBRUSH SOFT,PIECE,7,3500,20763,3737,24500,January
1558,DETTOL ORIGINAL 175G,PIECE,7,6500,38559,6941,45500,January
1775,DURU ENERGIZING HONEY,PIECE,7,4500,26695,4805,31500,January
1856,EGGS TRAY,PIECE,7,14000,83051,14949,98000,January
1936,F.D CHOCOLATE MILK 250MLS,PIECE,7,2000,11864,2136,14000,January
2154,FOOD COLOUR ORANGE,PIECE,7,1000,5932,1068,7000,January
2414,GOOD DAY CHOCO CHIP,PIECE,7,5000,29661,5339,35000,January
2479,HACO RULER,PIECE,7,2000,11864,2136,14000,January
2530,HEINZ KETCHUP 300G,PIECE,7,8000,47458,8542,56000,January
2651,IMPERIAL LEATHER 4*175,PIECE,7,13000,77119,13881,91000,January
2726,JAMIES CAKES @60K,PIECE,7,60000,355932,64068,420000,January
2987,KAZIRE ORANGE,PIECE,7,2000,11864,2136,14000,January
3131,KIWI 20G,PIECE,7,3000,17797,3203,21000,January
3224,KUAKUA TOILET BLOCKS 6PCS,PIECE,7,10000,59322,10678,70000,January
3293,LATO MILK 250G,PIECE,7,12000,71186,12814,84000,January
3494,M&G STICK GLUE 3000,PIECE,7,3000,17797,3203,21000,January
3610,MARSHMALLOW DELICIOUS ASSORTED 15G,PIECE,7,2000,11864,2136,14000,January
3625,MAYONNAISE 237ML,PIECE,7,19000,112712,20288,133000,January
3684,MIA GONJA 1000,PIECE,7,1000,5932,1068,7000,January
4036,NEEK YOGHURT 500G 3500,PIECE,7,3500,20763,3737,24500,January
4043,NESCAFE CLASSIC 100G,PIECE,7,17000,100847,18153,119000,January
4081,NICE CLEAR PENS,PIECE,7,500,2966,534,3500,January
4270,NUVITA GLUCOSE 75G,PIECE,7,1500,8898,1602,10500,January
4275,NUVITA STRAWBERRY CREAMS 75G,PIECE,7,1500,8898,1602,10500,January
4343,OMO COMFORT 500G,PIECE,7,7500,44492,8008,52500,January
4465,PANASONIC AAA,PIECE,7,2000,11864,2136,14000,January
4541,PEPSODENT HERBAL 65G,PIECE,7,2500,14831,2669,17500,January
4593,PICFARE SQUARE BKS 96PGS,PIECE,7,1500,8898,1602,10500,January
4777,PROTEX HERBAL 150G,PIECE,7,6500,38559,6941,45500,January
4950,RIHAM CREAMY CRUNCH CHOCOLATE,PIECE,7,3000,17797,3203,21000,January
5023,ROYCO CHICKEN 60G,PIECE,7,1200,7119,1281,8400,January
5189,SCRUBBING BRUSH LONG 5000,PIECE,7,6000,35593,6407,42000,January
5332,SHUYA 280MM,PIECE,7,6000,35593,6407,42000,January
5566,SOY SAUCE DARK 150G,PIECE,7,5000,29661,5339,35000,January
5660,STEEPO CHOCOLATE,PIECE,7,2000,11864,2136,14000,January
5731,SUMZ COCONUT COOKIES,PIECE,7,4000,23729,4271,28000,January
5979,TEMMY'S CORNFLAKES 250G,PIECE,7,9000,53390,9610,63000,January
6216,TROPICAL HEAT TEA MASALA 45G,PIECE,7,5000,29661,5339,35000,January
6401,VASELINE BLUESEAL COCOA BUTTER250ML,PIECE,7,9500,56356,10144,66500,January
6665,ZESTA 300 G,PIECE,7,7500,44492,8008,52500,January
7102,JAMIES DADDIES TIN 20000,PIECE,7,20000,118644,21356,140000,January
7387,HB PENCILS,PIECE,7,1500,8898,1602,10500,January
7558,HISS,PIECE,7,2500,14831,2669,17500,January
7748,BAKEMATE LOVE 1500,PIECE,7,1500,8898,1602,10500,January
7830,PICK n PEEL ORANGE JUICE 1LITRE,PIECE,7,9500,56356,10144,66500,January
7858,MOOISTE COCOA,PIECE,7,2500,14831,2669,17500,January
7861,ROYAL SHAVERS,PIECE,7,3500,20763,3737,24500,January
71,ALLIANCE LIVEN COFFEE,PIECE,8,3500,23729,4271,28000,January
254,AROMAT 75G,PIECE,8,5500,37288,6712,44000,January
313,AUNT PORRIDGE 6MONTHS,PIECE,8,14000,94915,17085,112000,January
344,AZAM BAKING FLOUR 2KG,PIECE,8,8500,57627,10373,68000,January
731,BLUEBAND LOW FAT 100G,PIECE,8,2000,13559,2441,16000,January
916,C.B RIPPLES STRAWBERRY 200ML,PIECE,8,4000,27119,4881,32000,January
946,CADBURY FRUIT & NUT 80G,PIECE,8,8000,54237,9763,64000,January
1064,CELOTAPE SMALL 1000,PIECE,8,1000,6780,1220,8000,January
1164,CLASSIC 96 PAGES,PIECE,8,2000,13559,2441,16000,January
1224,COCACOLA CAN 330ML,PIECE,8,2700,18305,3295,21600,January
1259,COLGATE MAX-FRESH 130G,PIECE,8,6500,44068,7932,52000,January
1262,COLGATE MAXIMUM CAVITY 35G,PIECE,8,2500,16949,3051,20000,January
1464,DAIRY TOP YOGHURT STRAWBERRY 250G,PIECE,8,1000,6780,1220,8000,January
1525,DENTAL FLOSS,PIECE,8,2500,16949,3051,20000,January
1718,DOVE ORIGINAL SOAP 135G,PIECE,8,5500,37288,6712,44000,January
1911,ENVELOPES 300,PIECE,8,300,2034,366,2400,January
1959,F.D STRAWBERRY MILK 500MLS,PIECE,8,4000,27119,4881,32000,January
2178,FORTUNE GOLD 500ML,PIECE,8,5000,33898,6102,40000,January
2180,FORTUNE SPAGHETTI 250G,PIECE,8,2000,13559,2441,16000,January
3171,KOFA MATHEMATICAL SET,PIECE,8,4000,27119,4881,32000,January
3584,MAMIS PEANUT PASTE 1KG,PIECE,8,15000,101695,18305,120000,January
3945,MUKISA MANDAZI,PIECE,8,3000,20339,3661,24000,January
4195,NOTE BOOK 2000,PIECE,8,2000,13559,2441,16000,January
4235,NUTRO CHOC CREAM WAFERS,PIECE,8,6500,44068,7932,52000,January
4346,OMO FAST ACTION 500G,PIECE,8,7500,50847,9153,60000,January
4581,PICFARE 48PGS,PIECE,8,500,3390,610,4000,January
4598,PICK N PEEL MANGO 250ML,PIECE,8,2500,16949,3051,20000,January
4948,RIHAM CREAM CHOCOLATE,PIECE,8,1200,8136,1464,9600,January
5095,SANTA LUCIA LUMACA,PIECE,8,5000,33898,6102,40000,January
5274,SHENKE ORANGE,PIECE,8,8000,54237,9763,64000,January
5321,SHREEJI BOOK 200PGS,PIECE,8,4000,27119,4881,32000,January
5333,SHUYA 330MM,PIECE,8,6000,40678,7322,48000,January
5760,SUMZ PUMPKIN SEEDS 70G,PIECE,8,3000,20339,3661,24000,January
5844,SUPER GLUE,PIECE,8,1000,6780,1220,8000,January
5877,SWEETS 1500 ICECREAMM LOLLIPOP,PIECE,8,1500,10169,1831,12000,January
6268,U.S.A BEAUTY SOAP BLACK,PIECE,8,6500,44068,7932,52000,January
6469,VIM LAVENDER 500G,PIECE,8,5000,33898,6102,40000,January
6598,WISDOM SMOKERS TOOTHBRUSH,PIECE,8,2688,18220,3280,21500,January
6710,VASELINE BLUESEAL COCOA BUTTER 95ML,PIECE,8,5000,33898,6102,40000,January
6936,JESA MIXED BERRY YOGHURT 500G,PIECE,8,3700,25085,4515,29600,January
6953,STRIKE NUTS CHOCOLATE BAR,PIECE,8,1500,10169,1831,12000,January
6997,PELIKAN HB PENCILS 12PCS,PIECE,8,6000,40678,7322,48000,January
7389,HIKMA YELLOW BAGIYA 2000,PIECE,8,1500,10169,1831,12000,January
7392,HIKMA DADDIES 5000,PIECE,8,4750,32203,5797,38000,January
7426,JAMIES SWEET CAKE BREAD WHOLESALE 5000,PIECE,8,5000,33898,6102,40000,January
7432,FRESCO BODY OIL 100ML 4000,PIECE,8,4000,27119,4881,32000,January
529,BALLET BABY JELLY 300MLS,PIECE,9,9500,72458,13042,85500,January
639,BEST RULER 1000,PIECE,9,1000,7627,1373,9000,January
649,BI-CARBONATE SODA,PIECE,9,1000,7627,1373,9000,January
913,C.B RIPPLES CHOCOLATE 200ML,PIECE,9,4000,30508,5492,36000,January
1247,COLGATE CHILDREN 50MLS,PIECE,9,4500,34322,6178,40500,January
1406,CUSSONS SOAP SOFT&SMOOTH,PIECE,9,3500,26695,4805,31500,January
1423,D.L FIESTA CLASSIC 100MLS,PIECE,9,3500,26695,4805,31500,January
1429,D.L MEGA CONE VANILLA,PIECE,9,3500,26695,4805,31500,January
1462,DAIRY MILK TOP DECK 80G,PIECE,9,8000,61017,10983,72000,January
1487,DATES 5000,PIECE,9,5500,41949,7551,49500,January
1687,DOUBLE A REAM,PIECE,9,29000,221186,39814,261000,January
1723,DOVE PINK ROSA SOAP 135G,PIECE,9,6000,45763,8237,54000,January
1818,EAST AFRICAN ORGANIC HONEY 100G,PIECE,9,3500,26695,4805,31500,January
2183,FOUNTAIN PEN,PIECE,9,8000,61017,10983,72000,January
2286,GEISHA ALOE VERA&HONEY,PIECE,9,4000,30508,5492,36000,January
2288,GEISHA ALOEVERA &HONEY 125G,PIECE,9,2500,19068,3432,22500,January
2302,GEISHA TRADITIONAL BLACK SOAP,PIECE,9,5500,41949,7551,49500,January
2595,HOT FRESH 20ML,PIECE,9,2500,19068,3432,22500,January
2603,HP FACIAL WIPES,PIECE,9,3500,26695,4805,31500,January
2663,IMPERIAL LEATHER SOAP RED 175G,PIECE,9,4000,30508,5492,36000,January
2916,JUMBO BLUE SWIRL 175ML,PIECE,9,4000,30508,5492,36000,January
2921,JUMBO STRAWBERRY RIPPLE 175ML,PIECE,9,4000,30508,5492,36000,January
3318,LATO VANILLA YOGHURT 250ML,PIECE,9,2500,19068,3432,22500,January
3563,MAGIC 500G BUCKET,PIECE,9,6500,49576,8924,58500,January
3608,MARLOS CHOCOLATE,PIECE,9,2000,15254,2746,18000,January
3668,MEN SOCKS,PIECE,9,3000,22881,4119,27000,January
3760,MOCACINE SOCKS 2000,PIECE,9,2000,15254,2746,18000,January
3946,MUKISA MANDAZI 1000,PIECE,9,1500,11441,2059,13500,January
3972,MUSAWO SOAP 120G,PIECE,9,1500,11441,2059,13500,January
4029,NATURAL NAPKINS,PIECE,9,2500,19068,3432,22500,January
4046,NESCAFE CLASSIC 50G,PIECE,9,12000,91525,16475,108000,January
4051,NESTLE KITKAT,PIECE,9,3500,26695,4805,31500,January
4218,NUMA BUSHERA 1KG,PIECE,9,6500,49576,8924,58500,January
4271,NUVITA GO COOKIES,PIECE,9,2000,15254,2746,18000,January
4276,NUVITA VITAMILK BISCUITS,PIECE,9,1500,11441,2059,13500,January
4589,PICFARE PENCILS PIECES 300,PIECE,9,300,2288,412,2700,January
4653,PLUTO ADVANCED AA,PIECE,9,6000,45763,8237,54000,January
4711,PREDATOR ENERGY DRINK,PIECE,9,2000,15254,2746,18000,January
5016,ROYCO BEEF 200G,PIECE,9,6000,45763,8237,54000,January
5223,SENSODYNE MULTICARE 40MLS,PIECE,9,7000,53390,9610,63000,January
5235,SESAME SNACKS,PIECE,9,5000,38136,6864,45000,January
5382,SIMKA VANILLA 500MLS,PIECE,9,4500,34322,6178,40500,January
5483,SNOWMAN MAKERS,PIECE,9,1000,7627,1373,9000,January
5609,SPONGE 2000,PIECE,9,2000,15254,2746,18000,January
5734,SUMZ CORN CRAX CHILLI80G,PIECE,9,1500,11441,2059,13500,January
5741,SUMZ CRISPS FRUIT CHUTNEY,PIECE,9,1500,11441,2059,13500,January
6068,TOOTHPICK 1000,PIECE,9,1000,7627,1373,9000,January
6307,UGANDA TEA BAGS,PIECE,9,5500,41949,7551,49500,January
6404,VASELINE BLUESEAL MEN FRESH 100ML,PIECE,9,5000,38136,6864,45000,January
6458,VICTAN SINGLE VEST,PIECE,9,5000,38136,6864,45000,January
6661,ZAR MACRON 400G,PIECE,9,4500,34322,6178,40500,January
6678,ZESTA TOMATO SAUCE 400G,PIECE,9,5000,38136,6864,45000,January
6787,VEGETABLE RICE 3500,PIECE,9,3833,29237,5263,34500,January
6960,NAN GUEST BATHING SOAP,PIECE,9,4000,30508,5492,36000,January
7295,PLASTIC SWINGING CANDLE 2500,PIECE,9,2500,19068,3432,22500,January
7361,SUMZ DADDIES 300G,PIECE,9,5000,38136,6864,45000,January
7620,SPRITE CAN 330ML,PIECE,9,2700,20593,3707,24300,January
7707,JAMIES COOKIES@20000,PIECE,9,20000,152542,27458,180000,January
7746,SWEETS 1500,PIECE,9,1500,11441,2059,13500,January
7824,BANANA JUICE 5000,PIECE,9,5000,38136,6864,45000,January
7857,MOOISTE CHOCOLATE,PIECE,9,2500,19068,3432,22500,January
7867,ROCK BOOM 500ML,PIECE,9,2944,22458,4042,26500,January
81,ALWAYS COTTON EXTRA LONG,PIECE,10,3000,25424,4576,30000,January
92,ALWAYS ULTRA V.P,PIECE,10,6500,55085,9915,65000,January
271,ART BOOK SMALL,PIECE,10,2000,16949,3051,20000,January
1290,COMPO PENS,PIECE,10,3000,25424,4576,30000,January
1356,CREAMBELL MAGIC STRAW120ML,PIECE,10,2500,21186,3814,25000,January
1785,DURU NATURAL CARE,PIECE,10,4500,38136,6864,45000,January
1932,EVERVESS 500ML,PIECE,10,1500,12712,2288,15000,January
1939,F.D MANGO 100G,PIECE,10,1000,8475,1525,10000,January
2072,FIDODIDO CHOCO-VAN 220ML,PIECE,10,2500,21186,3814,25000,January
2299,GEISHA SHEA AND ALMOND BUTTER SOAP 225G,PIECE,10,5500,46610,8390,55000,January
2303,GEISHA TRADITIONAL BLACK SOAP 125G,PIECE,10,4000,33898,6102,40000,January
2813,JESA VANILLA YOGHURT 500G,PIECE,10,3700,31356,5644,37000,January
2833,JIK REGULAR 750MLS,PIECE,10,14000,118644,21356,140000,January
2990,KAZIRE VIT FRUIT,PIECE,10,2000,16949,3051,20000,January
3152,KNICKERS 3500,PIECE,10,3500,29661,5339,35000,January
3198,KOOKSY VANILLA 220ML,PIECE,10,2000,16949,3051,20000,January
3202,KOOKSY VANILLA CHOCOLATE 220ML,PIECE,10,2000,16949,3051,20000,January
3737,MIRINDA APPLE 2LTR,PIECE,10,4500,38136,6864,45000,January
3761,MOCACINE SOCKS 2500,PIECE,10,2500,21186,3814,25000,January
4215,NTALE 25G,PIECE,10,2500,21186,3814,25000,January
4247,NUTRO TEA BISCUIT,PIECE,10,3500,29661,5339,35000,January
4341,OMO BLEACH REGULAR 70ML,PIECE,10,1200,10169,1831,12000,January
4583,PICFARE 96PGS,PIECE,10,1000,8475,1525,10000,January
5167,SCHOOL SOCKS BLUE&WHITE 4000,PIECE,10,4000,33898,6102,40000,January
5259,SHARPENER SMALL,PIECE,10,500,4237,763,5000,January
5482,SNOW SPRAYS 4500,PIECE,10,5000,42373,7627,50000,January
7475,MENTOS FRUIT 29G,PIECE,10,2000,16949,3051,20000,January
7878,BLUE BAND WITH CHOCO 250G,PIECE,10,6200,52542,9458,62000,January
7893,NUVITA SHORT CAKE 1500,PIECE,10,1500,12712,2288,15000,January
718,BLUE BAND LOW SPREAD 250G,PIECE,11,4000,37288,6712,44000,January
1227,COCACOLA ZERO 350ML,PIECE,11,1000,9322,1678,11000,January
1359,CREAMY EFFECT WIPES,PIECE,11,6000,55932,10068,66000,January
1424,D.L FIESTA SALTED CARAMEL,PIECE,11,4000,37288,6712,44000,January
1473,DAITY ICEPRESSO COFFE,PIECE,11,2500,23305,4195,27500,January
2174,FORTUNE BUTTO 1LTR,PIECE,11,8500,79237,14263,93500,January
2290,GEISHA COCONUTMILK 125G,PIECE,11,2500,23305,4195,27500,January
2317,GIFT BAG FLORAL LARGE,PIECE,11,6000,55932,10068,66000,January
2802,JESA STRAWBERRY YOGHURT 500G,PIECE,11,3700,34492,6208,40700,January
2952,KAKIRA SUGAR 2KG,PIECE,11,12000,111864,20136,132000,January
2966,KANGAROO BLACK SHOE CREAM,PIECE,11,2000,18644,3356,22000,January
2988,KAZIRE POWER TONIC,PIECE,11,2000,18644,3356,22000,January
3469,M&G GLUE STICK 15G,PIECE,11,2000,18644,3356,22000,January
3607,MARIKA ICING SUGAR 500G,PIECE,11,4000,37288,6712,44000,January
3663,MEN BOXERS 10000,PIECE,11,10000,93220,16780,110000,January
3672,MENTHOXYL,PIECE,11,500,4661,839,5500,January
3963,MUSA'S BAKERY COOKIES 360G,PIECE,11,5500,51271,9229,60500,January
4020,NATARAJ COLOR PENCIL SHORT,PIECE,11,3500,32627,5873,38500,January
4035,NEEK YOGHURT 300G 2000,PIECE,11,2500,23305,4195,27500,January
4082,NICE TOOTHBRUSH,PIECE,11,600,5593,1007,6600,January
4333,OMO 40G FRESH,PIECE,11,500,4661,839,5500,January
4965,RIHAM WATER 600ML,PIECE,11,1000,9322,1678,11000,January
5090,SANTA LUCIA 250G,PIECE,11,2500,23305,4195,27500,January
5181,SCOURING PADS 500,PIECE,11,500,4661,839,5500,January
5610,SPONGE 3000,PIECE,11,3000,27966,5034,33000,January
5630,SQUEEZERS 5000,PIECE,11,5000,46610,8390,55000,January
5750,SUMZ GONJA CRISPS 160G,PIECE,11,5500,51271,9229,60500,January
6573,WHITE VINEGAR,PIECE,11,2500,23305,4195,27500,January
7388,HIKMA YELLOW BAGIYA 4000,PIECE,11,4500,41949,7551,49500,January
7405,SUMZ FRIED SOYA BEANS 100G,PIECE,11,2500,23305,4195,27500,January
7476,MENTOS MINT 29G,PIECE,11,2500,23305,4195,27500,January
7494,FRUIT VILLE TROPICAL,PIECE,11,3500,32627,5873,38500,January
7895,NUVITA BUTTER COOKIES 100GM,PIECE,11,2500,23305,4195,27500,January
349,AZAM MALT 500MLS,PIECE,12,3000,30508,5492,36000,January
353,B.D CANDLE NUMBERS,PIECE,12,1500,15254,2746,18000,January
637,BESSA MILLET MALT DRINK 330ML,PIECE,12,3000,30508,5492,36000,January
823,BRITANIA GLUCOSE BISCUIT,PIECE,12,500,5085,915,6000,January
824,BRITANIA MILK BISCUIT,PIECE,12,500,5085,915,6000,January
1910,ENVELOPES 200,PIECE,12,200,2034,366,2400,January
1937,F.D FLAVOURED CHOCOLATE,PIECE,12,4000,40678,7322,48000,January
2636,IBON ELVAN SWEETS,PIECE,12,200,2034,366,2400,January
2725,JAMIES CAKES @50k,PIECE,12,50000,508475,91525,600000,January
2986,KAZIRE LEMON TEA,PIECE,12,2000,20339,3661,24000,January
3210,KOOKSY VAN-STRAW 120MLS,PIECE,12,1000,10169,1831,12000,January
3294,LATO MILK 400G,PIECE,12,19000,193220,34780,228000,January
3435,LUCOZADE 250MLS,PIECE,12,3000,30508,5492,36000,January
3553,MAGANJO SOYA RICE 1KGS,PIECE,12,7500,76271,13729,90000,January
3566,MAGIC SACHET 45G,PIECE,12,500,5085,915,6000,January
3997,NAIL CUTTER 2500,PIECE,12,2500,25424,4576,30000,January
4240,NUTRO DIGESTIVE,PIECE,12,6500,66102,11898,78000,January
4542,PEPSODENT HERBAL TRIPPLE140G,PIECE,12,5000,50847,9153,60000,January
4587,PICFARE HANDWRITING BOOKS,PIECE,12,2000,20339,3661,24000,January
4951,RIHAM CREAMY CRUNCH STRAWBERRY,PIECE,12,3000,30508,5492,36000,January
4992,ROKI OIL 500ML,PIECE,12,5000,50847,9153,60000,January
5611,SPONGE 4000,PIECE,12,4000,40678,7322,48000,January
5730,SUMZ COATED PEANUT 50G,PIECE,12,1200,12203,2197,14400,January
5746,SUMZ GINGER COOKIES,PIECE,12,4000,40678,7322,48000,January
5759,SUMZ PUMPKIN SEEDS 50G,PIECE,12,2500,25424,4576,30000,January
6101,TOP UP 400G,PIECE,12,2000,20339,3661,24000,January
6534,WEETABIX 112G,PIECE,12,4500,45763,8237,54000,January
7553,TOYS 3000,PIECE,12,3000,30508,5492,36000,January
7592,COLGATE CHARCOAL 210G 10000,PIECE,12,10000,101695,18305,120000,January
7701,CLEAR BAGS 1500,PIECE,12,1500,15254,2746,18000,January
7745,CHOCOLATE 800,PIECE,12,800,8136,1464,9600,January
7783,MENTOS PEACH ORANGE,PIECE,12,2500,25424,4576,30000,January
671,BIRTHDAY HATS 2500,PIECE,13,2500,27542,4958,32500,January
845,BROOKSIDE PEAR CARAMEL,PIECE,13,5000,55085,9915,65000,January
846,BROOKSIDE PEAR CARAMEL 250G,PIECE,13,3000,33051,5949,39000,January
917,C.B ROYAL MANGO 120ML,PIECE,13,2500,27542,4958,32500,January
1266,COLGATE TOOTHBRUSH 1500,PIECE,13,1500,16525,2975,19500,January
1461,DAIRY MILK PLAIN 80G,PIECE,13,8000,88136,15864,104000,January
1758,DREAM PANT LINERS,PIECE,13,2500,27542,4958,32500,January
2030,FANTA 330ML CAN,PIECE,13,2700,29746,5354,35100,January
2720,JAMIES BROWN SALT BREAD 500G,PIECE,13,3000,33051,5949,39000,January
3214,KOPIKO BROWN COFFEE,PIECE,13,1500,16525,2975,19500,January
3560,MAGIC 1KG SACHET,PIECE,13,8500,93644,16856,110500,January
3585,MAMIS PEANUT PASTE 500G,PIECE,13,8000,88136,15864,104000,January
3588,MANILA PAPERS 1000,PIECE,13,1000,11017,1983,13000,January
3674,MENTOS GRAPE,PIECE,13,2500,27542,4958,32500,January
4190,NOMI 250G BUCKET,PIECE,13,4000,44068,7932,52000,January
4585,PICFARE GRAPH BOOK 48PGS,PIECE,13,2000,22034,3966,26000,January
4952,RIHAM CREAMY ORANGE,PIECE,13,1200,13220,2380,15600,January
5334,SHUYA PANT LINERS,PIECE,13,6000,66102,11898,78000,January
5376,SIMKA STRAW-VAN 300MLS,PIECE,13,3500,38559,6941,45500,January
5765,SUMZ SIMSIM BALLS 100G,PIECE,13,2500,27542,4958,32500,January
6607,WRAPPING PAPER 1000,PIECE,13,1000,11017,1983,13000,January
6988,ELITE BALL PENS 500,PIECE,13,500,5508,992,6500,January
7065,BRITANIA SWEET MEAL BISCUITS,PIECE,13,2500,27542,4958,32500,January
51,AFIA MANGO 500MLS,PIECE,14,3000,35593,6407,42000,January
842,BROOKSIDE LEMON 250G,PIECE,14,3000,35593,6407,42000,January
1950,F.D PLAIN YOGHURT 450G,PIECE,14,3700,43898,7902,51800,January
1999,FACE TOWEL 1000,PIECE,14,1000,11864,2136,14000,January
2070,FIDODIDO CHOCOLATE 120ML,PIECE,14,1200,14237,2563,16800,January
2175,FORTUNE BUTTO 500ML,PIECE,14,4500,53390,9610,63000,January
2480,HACO RULER ORIGINAL,PIECE,14,2000,23729,4271,28000,January
3335,LAVITA PINEAPPLE 320MLS,PIECE,14,1000,11864,2136,14000,January
3378,LIGHTERS,PIECE,14,1000,11864,2136,14000,January
3381,LIMOUSINE CHOCOLATE,PIECE,14,1500,17797,3203,21000,January
3998,NAIL CUTTERS 1500,PIECE,14,1500,17797,3203,21000,January
4131,NIVANA WATER 1.5L,PIECE,14,1500,17797,3203,21000,January
4552,PERMANENT MAKER,PIECE,14,1000,11864,2136,14000,January
4896,RED BULL 250MLS,PIECE,14,7000,83051,14949,98000,January
5214,SENSITIVE BABY WIPES,PIECE,14,7000,83051,14949,98000,January
5289,SHOE BRUSHES 1500,PIECE,14,1500,17797,3203,21000,January
5345,SILKEE DESIGNER SERVIETTES,PIECE,14,2500,29661,5339,35000,January
5380,SIMKA VANILLA 230MLS,PIECE,14,2000,23729,4271,28000,January
6464,VIGOS HAZELNUT CHOCOLATE 800,PIECE,14,800,9492,1708,11200,January
6643,YOJUS MANGO 150ML,PIECE,14,1000,11864,2136,14000,January
7284,SUMZ SALT& VIEGAR,PIECE,14,600,7119,1281,8400,January
7379,SUMZ COATED PEANUTS PLAINMASALA 150G,PIECE,14,3000,35593,6407,42000,January
7524,TOYS 2000,PIECE,14,2000,23729,4271,28000,January
1046,CB CLASSIC VANILLA 120MLS,PIECE,15,2500,31780,5720,37500,January
1607,DIVINE 300MLS,PIECE,15,2500,31780,5720,37500,January
2298,GEISHA ROSE&HONEY 225G,PIECE,15,4000,50847,9153,60000,January
2450,GRAPES 12000,PIECE,15,12000,152542,27458,180000,January
3944,MUKISA CAKE 2500,PIECE,15,2500,31780,5720,37500,January
4034,NEEK YOGHURT 1LTR,PIECE,15,7000,88983,16017,105000,January
4579,PICFARE 288PAGES 8500,PIECE,15,8000,101695,18305,120000,January
5593,SPLASH APPLES 150ML,PIECE,15,1500,19068,3432,22500,January
5733,SUMZ CHOCOLATE COOKIES 200G,PIECE,15,4000,50847,9153,60000,January
5743,SUMZ CRUNCHY DADDIES 150G,PIECE,15,3000,38136,6864,45000,January
5761,SUMZ ROASTED NUTS 120G,PIECE,15,3000,38136,6864,45000,January
5763,SUMZ ROASTED NUTS 60G,PIECE,15,1500,19068,3432,22500,January
7073,SUMZ TANGY LEMON CRISPS 12G,PIECE,15,600,7627,1373,9000,January
7593,COLGATE CHARCOAL 35G 2500,PIECE,15,2500,31780,5720,37500,January
7656,JAMIES MANDAZ 1000,PIECE,15,1000,12712,2288,15000,January
273,ART PENCILS 2B,PIECE,16,1000,13559,2441,16000,January
346,AZAM EMBE MANGO,PIECE,16,1500,20339,3661,24000,January
843,BROOKSIDE LEMON BISCUITS 450G,PIECE,16,5500,74576,13424,88000,January
2028,FANSICKERS COCOA CREAM,PIECE,16,2500,33898,6102,40000,January
2292,GEISHA LEMON&HONEY 125G,PIECE,16,2500,33898,6102,40000,January
3212,KOPIKO 3 IN 1 COFFEE,PIECE,16,2000,27119,4881,32000,January
3215,KOPIKO CAPPUCCINO CHOCO,PIECE,16,1500,20339,3661,24000,January
3562,MAGIC 250G BUCKET,PIECE,16,4000,54237,9763,64000,January
4717,PRESTIGE 250G,PIECE,16,4500,61017,10983,72000,January
5667,GOLDER STICK NOTES,PIECE,16,2000,27119,4881,32000,January
7168,SPLASH TROPICAL FRUIT PUNCH 1LTR,PIECE,16,8000,108475,19525,128000,January
7296,BANANA JUICE 3000,PIECE,16,3000,40678,7322,48000,January
7364,SUMZ BAGGIA 100G,PIECE,16,3000,40678,7322,48000,January
901,C.B CHOCOLATE CHOCO CHIP 120ML,PIECE,17,2500,36017,6483,42500,January
1096,CHAPA NYOTA BLUE 600G,PIECE,17,4000,57627,10373,68000,January
1249,COLGATE DOUBLE ACTION,PIECE,17,4000,57627,10373,68000,January
1252,COLGATE HERBAL 140G,PIECE,17,7500,108051,19449,127500,January
1253,COLGATE HERBAL 230G,PIECE,17,9500,136864,24636,161500,January
1468,DAITY AMIRALDOUBLE CHOCOLATE,PIECE,17,4500,64831,11669,76500,January
1914,ERASER RUBBER,PIECE,17,500,7203,1297,8500,January
2181,FORTUNE SPAGHETTI 450,PIECE,17,3500,50424,9076,59500,January
2289,GEISHA COCONUT MILK 200G,PIECE,17,4000,57627,10373,68000,January
4464,PANASONIC AA,PIECE,17,2000,28814,5186,34000,January
4582,PICFARE 96 PGS 11000,PIECE,17,10588,152542,27458,180000,January
5371,SIMKA CHOC-VANILLA 500ML,PIECE,17,4500,64831,11669,76500,January
5481,SNICKERS CHOCOLATE,PIECE,17,3500,50424,9076,59500,January
7859,TOFFEE 500,PIECE,17,500,7203,1297,8500,January
348,AZAM MALT 300MLS,PIECE,18,1500,22881,4119,27000,January
939,CADBURY DAIRY MILK MINT CRISP 80G,PIECE,18,8000,122034,21966,144000,January
1953,F.D STRAWBERRY 150G,PIECE,18,1800,27458,4942,32400,January
2291,GEISHA LEMON&HONEY,PIECE,18,4000,61017,10983,72000,January
2719,JAMIES BROWN SALT BREAD 1KG,PIECE,18,5500,83898,15102,99000,January
3564,MAGIC 500G SACHET,PIECE,18,4500,68644,12356,81000,January
4953,RIHAM CREAMY STRAWBERRY,PIECE,18,1200,18305,3295,21600,January
5366,SIMKA CHOC- VAN 300ML,PIECE,18,3500,53390,9610,63000,January
5536,SOFTCARE PAMPERS S15,PIECE,18,7500,114407,20593,135000,January
5591,SPLASH APPLE 1LTR,PIECE,18,8000,122034,21966,144000,January
1245,COLGATE CHARCOAL GENTLE CLEAN,PIECE,19,7500,120763,21737,142500,January
2296,GEISHA ROSE&HONEY,PIECE,19,2500,40254,7246,47500,January
3204,KOOKSY VANILLA MANGO 220ML,PIECE,19,2000,32203,5797,38000,January
3323,LATO YOG STRAWBERRY 250G,PIECE,19,2500,40254,7246,47500,January
5882,SWEETS 700 BIG FIVE,PIECE,19,700,11271,2029,13300,January
7365,SUMZ BAGGIA 50G,PIECE,19,1500,24153,4347,28500,January
7486,APPLES PACKED 11000,PIECE,19,11000,177119,31881,209000,January
832,BRITANIA SHORTCAKE BISCUITS,PIECE,20,2000,33898,6102,40000,January
1485,DATES 2000,PIECE,20,2000,33898,6102,40000,January
2089,FIDODIDO STRWABERRY 220ML,PIECE,20,2500,42373,7627,50000,January
3207,KOOKSY VANILLA STRAWBERRY 220ML,PIECE,20,2000,33898,6102,40000,January
3742,MIRINDA ORANGE 2LTRS,PIECE,20,4500,76271,13729,90000,January
4718,PRESTIGE 500G,PIECE,20,7500,127119,22881,150000,January
4936,RIBENA 1LTR,PIECE,20,10000,169492,30508,200000,January
5377,SIMKA STRAW-VAN 500MLS,PIECE,20,4500,76271,13729,90000,January
5753,SUMZ POTATO CRISP BBQ 30G,PIECE,20,1500,25424,4576,30000,January
5876,SWEETS 1000,PIECE,20,1000,16949,3051,20000,January
6272,UBISCO CREAMS VANILLA,PIECE,20,1000,16949,3051,20000,January
7164,NUTRO ORANGE BISCUIT 1200,PIECE,20,1200,20339,3661,24000,January
713,BLUE BAND 100G,PIECE,21,2500,44492,8008,52500,January
943,CADBURY DREAM WHITE CREAMY 80G,PIECE,21,8000,142373,25627,168000,January
2801,JESA STRAWBERRY MILK 200MLS,PIECE,21,1500,26695,4805,31500,January
2825,JIB WATER 20LTRS REFILL,PIECE,21,8000,142373,25627,168000,January
2985,KAZIRE ALOEVERA,PIECE,21,1500,26695,4805,31500,January
3744,MIRINDA ORANGE 500ML,PIECE,21,1500,26695,4805,31500,January
6280,UBISCO KREAMY CREAMS STRAWBERRY,PIECE,21,1000,17797,3203,21000,January
6976,SUMZ POTATO CRIPS TASTY TOMATO 30G,PIECE,21,1500,31500,0,31500,January
1254,COLGATE HERBAL 35G,PIECE,22,2500,46610,8390,55000,January
3433,LUCOZADE 1LTR,PIECE,22,10000,186441,33559,220000,January
7425,JAMIES QUEEN CAKES WHOLESALE 2500,PIECE,22,2500,46610,8390,55000,January
1753,DOWNY VALLEY DEW 20ML,PIECE,23,700,13644,2456,16100,January
1915,ERASER RUBBER BIG,PIECE,23,1000,19492,3508,23000,January
2728,JAMIES COCONUT BREAD 500G,PIECE,23,3000,58475,10525,69000,January
3188,KOOKSY STRAWBERRY 120ML,PIECE,23,1000,19492,3508,23000,January
3690,MIKOSHI GREEN TEA,PIECE,23,6000,116949,21051,138000,January
4700,POWERPLAY 400MLS,PIECE,23,2000,38983,7017,46000,January
5436,SKYVIEW 320MLS,PIECE,23,1000,19492,3508,23000,January
5521,SOFT CARE BABY WIPES,PIECE,23,7000,136441,24559,161000,January
5604,SPLASH MANGO JUICE 1LTR,PIECE,23,8000,155932,28068,184000,January
5864,SWEET PEPSI,PIECE,23,100,1949,351,2300,January
7385,RIHAM X-ENERGY 320ML,PIECE,23,1500,29237,5263,34500,January
7621,MINTORE X PLUS 500,PIECE,23,500,9746,1754,11500,January
49,AFIA APPLE 500ML,PIECE,24,3000,61017,10983,72000,January
1750,DOWNY FEEL LUX 20ML,PIECE,24,700,14237,2563,16800,January
1931,EVERVESS,PIECE,24,1000,20339,3661,24000,January
2780,JESA CHOCOLATE FLAVOURED MILK 200ML,PIECE,24,1500,30508,5492,36000,January
5435,SKY VIEW ORANGE 320ML,PIECE,24,1000,20339,3661,24000,January
7239,BEEF PILAU 20000,PIECE,24,5150,104746,18854,123600,January
7789,JAMIES DANISH BREAD@3500,PIECE,24,3500,71186,12814,84000,January
1255,COLGATE HERBAL 70G,PIECE,25,4500,95339,17161,112500,January
1267,COLGATE TOOTHBRUSH CHARCOAL,PIECE,25,2500,52966,9534,62500,January
1935,EXOTIC 320MLS,PIECE,25,1000,21186,3814,25000,January
1942,F.D MANGO 450G,PIECE,25,3700,78390,14110,92500,January
5810,SUNSHINE PLAIN FLAVOR,PIECE,25,500,10593,1907,12500,January
6642,YOJUS APPLE DRINK,PIECE,25,1000,21186,3814,25000,January
7378,SUMZ COATED PEANUTS CHILLI MASALA 150G,PIECE,25,3000,63559,11441,75000,January
7870,BALEMATE LOVE CHOCO 55G 2500,PIECE,25,2500,52966,9534,62500,January
6876,"GREENS (NAKATI,DODO ETC)",PIECE,25.7,5842,127203,22897,150100,January
86,ALWAYS EXTRA LONG,PIECE,26,3500,77119,13881,91000,January
1246,COLGATE CHARCOAL TWIN TOOTHBRUSH,PIECE,26,4000,88136,15864,104000,January
2716,JAMAA WHITE WASHING BAR,PIECE,26,6000,132203,23797,156000,January
5356,SILVER PLATE 500,PIECE,26,500,11017,1983,13000,January
5735,SUMZ CORN CRAX 160G,PIECE,26,2596,57203,10297,67500,January
5808,SUNSHINE CHICKEN FLAVOR,PIECE,26,500,11017,1983,13000,January
6271,UBISCO CREAMS CHOCOLATE,PIECE,26,1000,22034,3966,26000,January
1484,DATES 1000,PIECE,27,1000,22881,4119,27000,January
1958,F.D STRAWBERRY FLAVOURED 250ML,PIECE,27,2000,45763,8237,54000,January
3221,KRYSTAL WATER 500ML,PIECE,27,1000,22881,4119,27000,January
3306,LATO PLAIN YOGHURT 500G,PIECE,27,3700,84661,15239,99900,January
3311,LATO STRAWBERRY YOGHURT 500G,PIECE,27,3700,84661,15239,99900,January
6798,CADBURY DAIRY MILK 35G,PIECE,27,4000,91525,16475,108000,January
2799,JESA STRAW YOGHURT 400G,PIECE,28,2500,59322,10678,70000,January
4945,RIHAM COFFEE MALT,PIECE,28,1500,35593,6407,42000,January
5367,SIMKA CHOCO BAR 100MLS,PIECE,28,2500,59322,10678,70000,January
5625,SPRITE 2LTR,PIECE,28,5000,118644,21356,140000,January
5739,SUMZ CRISPS CHILLI 60G,PIECE,28,2500,59322,10678,70000,January
844,BROOKSIDE MILK 500ML,PIECE,29,2300,56525,10175,66700,January
1265,COLGATE TOOTBRUSH,PIECE,29,2500,61441,11059,72500,January
2234,FRUITVILLE GUAVA 500ML,PIECE,29,3500,86017,15483,101500,January
3302,LATO MIXED BERRIES 250G,PIECE,29,3000,73729,13271,87000,January
3304,LATO PEACH&CARAMEL 250G,PIECE,29,3000,73729,13271,87000,January
3322,LATO YOG STRAWBERRY 100G,PIECE,29,1200,29492,5308,34800,January
1134,CHOCOLATE 500,PIECE,30,500,12712,2288,15000,January
1949,F.D PLAIN YOGHURT 400G,PIECE,30,2500,63559,11441,75000,January
2085,FIDODIDO STRAW-VAN 120MLS,PIECE,30,1200,30508,5492,36000,January
4023,NATARAJ PENCILS 6000,PIECE,30,6000,152542,27458,180000,January
1943,F.D MIXED BERRIES 100G,PIECE,31,1200,31525,5675,37200,January
6871,POSHO KG,PIECE,31.47,5443,145169,26131,171300,January
3194,KOOKSY VAN-CHOC 120MLS,PIECE,32,1000,27119,4881,32000,January
3217,KREST 500MLS,PIECE,32,1500,40678,7322,48000,January
1608,DIVINE 500MLS,PIECE,33,4000,111864,20136,132000,January
1946,F.D MIXED BERRIES 400G,PIECE,33,2500,69915,12585,82500,January
1961,F.D UHT MILK 2000,PIECE,33,2000,55932,10068,66000,January
3196,KOOKSY VANILLA 120MLS,PIECE,33,1000,27966,5034,33000,January
3315,LATO VANILLA 100G,PIECE,33,1200,33559,6041,39600,January
5050,SAFA TOMATO PASTE 70GM,PIECE,33,1500,41949,7551,49500,January
5673,STONEY 350MLS,PIECE,33,1000,27966,5034,33000,January
1291,COMSOFT FACIAL WIPES 1000,PIECE,34,1000,28814,5186,34000,January
3319,LATO VANILLA YOGHURT 500G,PIECE,34,3700,106610,19190,125800,January
5674,STONEY 500MLS,PIECE,34,1500,43220,7780,51000,January
6943,SUMZ POTATO CRISPS FRUIT CHUTNEY 12G,PIECE,34,600,17288,3112,20400,January
7165,ONER APPLE DRINK 1LTR,PIECE,34,5000,144068,25932,170000,January
52,AFIA MIXED FRUIT 500MLS,PIECE,35,3000,88983,16017,105000,January
1969,F.D VANILLA FLAVOURED 250ML,PIECE,35,2000,59322,10678,70000,January
2682,INDOMIE BEEF NOODLES 120G,PIECE,35,2000,59322,10678,70000,January
4534,PEPSI,PIECE,35,1500,44492,8008,52500,January
5091,SANTA LUCIA 450G,PIECE,35,5000,148305,26695,175000,January
7647,SKY VIEW APPLE 320ML,PIECE,35,1000,29661,5339,35000,January
2476,HABARI SALT BIG,PIECE,36,1000,30508,5492,36000,January
5634,SQUISHY FRUIT DRINK 200ML,PIECE,36,2000,61017,10983,72000,January
6816,BLUE BAND 250G,PIECE,36,5000,152542,27458,180000,January
1169,CLASSIC G.B.K WHOLE MILK 500ML,PIECE,37,2200,68983,12417,81400,January
1960,F.D UHT 200ML MILK,PIECE,37,1000,31356,5644,37000,January
5433,SKY VIEW FRUITII 320ML,PIECE,37,1000,31356,5644,37000,January
5633,SQUISHY BLUE RASBERRY 200ML,PIECE,37,2000,62712,11288,74000,January
6894,SQUISHY JUICE APPLE,PIECE,37,2000,62712,11288,74000,January
849,BROOKSIDE STRAWBERRIES 250G,PIECE,38,3000,96610,17390,114000,January
1941,F.D MANGO 400G,PIECE,38,2500,80508,14492,95000,January
2342,GILLETTE BLUE2 PLUS,PIECE,38,2500,80508,14492,95000,January
2727,JAMIES COCONUT BREAD 1KG,PIECE,38,5500,177119,31881,209000,January
4616,PK CHEWING GUM BIG,PIECE,38,1000,32203,5797,38000,January
5758,SUMZ POTATO CRISPS TASTY TOMATO12G,PIECE,38,600,19322,3478,22800,January
6861,CASSAVA BOILED 4PCS,PIECE,38,500,16102,2898,19000,January
7876,GRILLED GOATS MEAT 8000,PIECE,38,8000,257627,46373,304000,January
4236,NUTRO CHOCOLATE BISCUITS,PIECE,39,1200,39661,7139,46800,January
4537,PEPSI MAX,PIECE,39,1000,33051,5949,39000,January
4937,RIBENA 250MLS,PIECE,39,3000,99153,17847,117000,January
7587,ONER TAMARIND 300ML,PIECE,39,1500,49576,8924,58500,January
7877,BOILED CASSAVA 1000,PIECE,39,1000,33051,5949,39000,January
347,AZAM ENERGY DRINK 300MLS,PIECE,40,1500,50847,9153,60000,January
2498,HANKIES 3000,PIECE,40,3000,101695,18305,120000,January
3458,LUXURY TOILET PAPER,PIECE,40,600,20339,3661,24000,January
7279,JUICE 4000 500ml,PIECE,40,4000,135593,24407,160000,January
55,AFIA WHITE GUAVA,PIECE,41,3000,104237,18763,123000,January
648,BIC SHEVARS,PIECE,41,1000,34746,6254,41000,January
3361,LEMON CAKES 1000,PIECE,41,1200,41695,7505,49200,January
4956,RIHAM EXOTIC TAMARIND,PIECE,41,1000,34746,6254,41000,January
5859,SWEET IVORY PCS,PIECE,41,100,3475,625,4100,January
7770,PREDATOR ENERGY 350ML,PIECE,41,2000,69492,12508,82000,January
5354,SILVER PLATE 1000,PIECE,42,1000,35593,6407,42000,January
1923,EURO SILK 2200 ORIGINAL,PIECE,43,2200,80169,14431,94600,January
5736,SUMZ CORN CRAX 80G,PIECE,43,1500,54661,9839,64500,January
3739,MIRINDA FRUITY,PIECE,44,1500,55932,10068,66000,January
5180,SCOURER 1000,PIECE,44,1000,37288,6712,44000,January
1029,CARROT CAKE,PIECE,45,5000,190678,34322,225000,January
2812,JESA VANILLA YOGHURT 400G,PIECE,45,2500,95339,17161,112500,January
4888,REBEX RICH MILK STICK BISCUITS,PIECE,45,1200,45763,8237,54000,January
5635,SQUISHY FRUIT DRINK MANGO 200ML,PIECE,45,2000,76271,13729,90000,January
5671,STING,PIECE,45,2000,76271,13729,90000,January
5672,STING RED RUSH,PIECE,45,2000,76271,13729,90000,January
836,BROOKSIDE FRUIT STRAWBERRIES,PIECE,46,5500,214407,38593,253000,January
5602,SPLASH MANGO 150ML,PIECE,46,1500,58475,10525,69000,January
3862,MOUNTAIN DEW,PIECE,47,1500,59746,10754,70500,January
5754,SUMZ POTATO CRISPS 180G,PIECE,47,5000,199153,35847,235000,January
2809,JESA VANILLA FLAVOURED 200ML,PIECE,48,1500,61017,10983,72000,January
3299,LATO MILK PWDER STRAWBERRY 15G,PIECE,48,500,20339,3661,24000,January
3736,MIRINDA APPLE,PIECE,48,1500,61017,10983,72000,January
4209,NOVIDA 500MLS,PIECE,48,1500,61017,10983,72000,January
5539,SOFTCARE SANITARY PADS,PIECE,48,3000,122034,21966,144000,January
2755,JAMIES SWEET CAKE BREAD 500G,PIECE,49,3000,124576,22424,147000,January
7815,7UP 330ML,PIECE,49,1000,41525,7475,49000,January
2684,INDOMIE NOODLES CHICKEN 120G,PIECE,50,2000,84746,15254,100000,January
5879,SWEETS 300,PIECE,50,300,12712,2288,15000,January
7706,JAMIES MILK BREAD 500G,PIECE,50,3500,148305,26695,175000,January
2032,FANTA 500MLS,PIECE,51,1500,64831,11669,76500,January
2729,JAMIE'S COOKIE SCONES,PIECE,51,2000,86441,15559,102000,January
5592,SPLASH APPLE 250MLS,PIECE,51,2000,86441,15559,102000,January
7139,SUMZ BBQ CRISPS 12G,PIECE,51,600,25932,4668,30600,January
5809,SUNSHINE ONION FLAVOR,PIECE,53,500,22458,4042,26500,January
7423,JAMIES COOKIES WHOLESALE 700,PIECE,53,700,31441,5659,37100,January
4535,PEPSI 2LTR,PIECE,54,4500,205932,37068,243000,January
5744,SUMZ DADDIES 75G 1000,PIECE,54,1500,68644,12356,81000,January
2739,JAMIES HOT DOG BUNS 6PCS,PIECE,55,4000,186441,33559,220000,January
5369,SIMKA CHOC-VAN 230MLS,PIECE,55,2000,93220,16780,110000,January
4208,NOVIDA 350MLS,PIECE,56,1000,47458,8542,56000,January
2060,FAY TP,PIECE,57,2000,96610,17390,114000,January
2736,JAMIES COOKIES 4000,PIECE,58,4000,196610,35390,232000,January
4248,NUTRO VANILLA 30G,PIECE,58,1200,58983,10617,69600,January
5717,SUGAR 1KG,PIECE,58,5500,270339,48661,319000,January
3723,MINUTE MAID BERRY BLAST 400MLS,PIECE,59,2500,125000,22500,147500,January
3863,MOUNTAIN DEW 2LTR,PIECE,59,4500,225000,40500,265500,January
1968,F.D VANILLA 450G,PIECE,60,3700,188136,33864,222000,January
3285,LATO CHOCOLATE MILK 250MLS,PIECE,60,2000,101695,18305,120000,January
4045,NESCAFE CLASSIC 2G,PIECE,60,500,25424,4576,30000,January
1289,COMPACT T.P,PIECE,61,1000,51695,9305,61000,January
3310,LATO STRAWBERRY MILK 250MLS,PIECE,61,2000,103390,18610,122000,January
3740,MIRINDA FRUITY 2LTR,PIECE,62,4500,236441,42559,279000,January
5627,SPRITE 500MLS,PIECE,62,1500,78814,14186,93000,January
7826,JAMIES CINNAMON BREAD 500G,PIECE,63,3500,186864,33636,220500,January
3729,MINUTEMAID BERRY BLAST 1LTR,PIECE,66,5000,279661,50339,330000,January
7278,JUICE 2000 300ML,PIECE,66,2000,111864,20136,132000,January
1966,F.D VANILLA 250G,PIECE,67,2500,141949,25551,167500,January
2029,FANTA 2LTRS ORANGE,PIECE,68,5000,288136,51864,340000,January
6695,JAMIES CAKE SLICE @6k,PIECE,68,6044,348305,62695,411000,January
5636,SQUISHY STRAWBERRY 200ML,PIECE,69,2000,116949,21051,138000,January
3326,LATO YOGHURT STRAWBERRY 400G,PIECE,70,2500,148305,26695,175000,January
5811,SUNSHINE TOMATO FLAVOR,PIECE,70,500,29661,5339,35000,January
6310,UKWAJU,PIECE,71,1500,90254,16246,106500,January
5749,SUMZ GONJA 90G CRISPS,PIECE,72,3000,183051,32949,216000,January
7144,JAMIES DOUGHNUT BIG CHOCOLATE 2500,PIECE,72,2500,152542,27458,180000,January
7410,ONER TAMARIND 500ML,PIECE,73,2500,154661,27839,182500,January
826,BRITANIA MUNCHIES BISCUITS,PIECE,75,500,31780,5720,37500,January
1334,COVERTINA CHOCOLATE 500,PIECE,77,500,32627,5873,38500,January
3743,MIRINDA ORANGE 330ML,PIECE,78,1000,66102,11898,78000,January
1221,COCACOLA 2LTRS,PIECE,79,5000,334746,60254,395000,January
2033,FANTA FRUIT BLAST 350ML,PIECE,79,1000,66949,12051,79000,January
2203,FRESH DAIRY MILK UHT 500ML,PIECE,80,2000,135593,24407,160000,January
3721,MINUTE MAID 1LTRS,PIECE,80,5000,338983,61017,400000,January
4615,PK CHEWING GUM 500,PIECE,80,500,33898,6102,40000,January
1957,F.D STRAWBERRY 450G,PIECE,81,3700,253983,45717,299700,January
3747,MIRINDA PINEAPPLE 330ML,PIECE,81,1000,68644,12356,81000,January
5748,SUMZ GONJA 40G,PIECE,81,1500,102966,18534,121500,January
7398,JAMIES SWEET BROWN 500G WHOLE SALE 2500,PIECE,81,2500,171610,30890,202500,January
1955,F.D STRAWBERRY 250G,PIECE,82,2500,173729,31271,205000,January
7397,JAMIES SWEET YELLOW 500G WHOLE SALE 2500,PIECE,82,2500,173729,31271,205000,January
3324,LATO YOGHURT 400G VANILLA,PIECE,85,2500,180085,32415,212500,January
3284,LATO CHOCO PWDER MILK 15G,PIECE,87,500,36864,6636,43500,January
2514,HARMONY POT WATER 1LTR,PIECE,88,2000,149153,26847,176000,January
3296,LATO MILK CHOCOLATE 125ML FLAVOURED,PIECE,88,1000,74576,13424,88000,January
5878,SWEETS 200,PIECE,88,200,14915,2685,17600,January
2431,GORILLO'S CHILLI TOMATO 24G,PIECE,90,500,38136,6864,45000,January
4984,ROCK BOOM 320MLS,PIECE,90,2000,152542,27458,180000,January
6572,WHITE STAR SOAP 1KG,PIECE,91,6500,501271,90229,591500,January
6799,SPRING ROLLS VEGETABLE 1000,PIECE,91,1000,77119,13881,91000,January
2950,KAKIRA SUGAR 1KG,PIECE,92,6000,467797,84203,552000,January
4536,PEPSI 330ML,PIECE,92,1000,77966,14034,92000,January
3316,LATO VANILLA 125ML MILK,PIECE,93,1000,78814,14186,93000,January
4961,RIHAM ONER MANGO 300ml,PIECE,96,1500,122034,21966,144000,January
2758,JAMIES SWEET WHITE BUNS 12PCS,PIECE,97,3500,287712,51788,339500,January
5626,SPRITE 350MLS,PIECE,98,1000,83051,14949,98000,January
1223,COCACOLA 500MLS,PIECE,99,1500,125847,22653,148500,January
1963,F.D VANILLA 100G,PIECE,99,1200,100678,18122,118800,January
3298,LATO MILK POWDER 15G,PIECE,100,500,42373,7627,50000,January
5477,SMILE PENS WAVE 500,PIECE,100,500,42373,7627,50000,January
5603,SPLASH MANGO 250MLS,PIECE,100,2000,169492,30508,200000,January
7130,JAMIES MUFFINS 2000,PIECE,100,2000,169492,30508,200000,January
2740,JAMIES MANDAZ 8PCS,PIECE,101,3000,256780,46220,303000,January
7431,JAMIES MARBLE CAKE 10000,PIECE,101,10000,855932,154068,1010000,January
7396,JAMIES SWEET WHITE WHOLESALE 500G 2500,PIECE,102,2500,216102,38898,255000,January
5757,SUMZ POTATO CRISPS 90G,PIECE,103,3000,261864,47136,309000,January
5375,SIMKA STRAW-VAN 230MLS,PIECE,104,2000,176271,31729,208000,January
2681,INDOMIE BEEF 70G,PIECE,105,1200,106780,19220,126000,January
6776,KEBAB 3000,PIECE,105,3000,266949,48051,315000,January
1855,EGGS PIECES,PIECE,106,500,44915,8085,53000,January
4575,PIAO PIAO TP ORIGINAL,PIECE,107,2000,181356,32644,214000,January
2752,JAMIES SWEET BROWN BREAD 500G,PIECE,109,3000,277119,49881,327000,January
3738,MIRINDA APPLE 330ML,PIECE,109,1000,92373,16627,109000,January
1967,F.D VANILLA 400G,PIECE,110,2500,233051,41949,275000,January
4349,ONER BERRIES JUICE DRINK,PIECE,110,2500,233051,41949,275000,January
6859,ROLEX NORMAL 2EGGS,PIECE,110,2500,233051,41949,275000,January
7374,JAMIES WHOLE SALE SWEET YELLOW 5000,PIECE,110,5000,466102,83898,550000,January
4348,ONER BERRIES 300ML,PIECE,112,1500,142373,25627,168000,January
1956,F.D STRAWBERRY 400G,PIECE,113,2500,239407,43093,282500,January
4960,RIHAM ONER APPLE 300ML,PIECE,117,1500,148729,26771,175500,January
7112,PUMPKIN SLICE 1000,PIECE,117,1000,99153,17847,117000,January
2754,JAMIES SWEET CAKE BREAD 1KG,PIECE,119,5500,554661,99839,654500,January
3864,MOUNTAIN DEW 300MLS,PIECE,120,1000,101695,18305,120000,January
1952,F.D STRAWBERRY 100G,PIECE,121,1200,123051,22149,145200,January
3309,LATO STRAWBERRY MILK 125MLS,PIECE,123,1000,104237,18763,123000,January
5807,SUNSHINE BEEF FLAVOR,PIECE,123,500,52119,9381,61500,January
3327,LATO YOGHURT VANILLA 200G,PIECE,124,1000,105085,18915,124000,January
2031,FANTA 330MLS,PIECE,125,1000,105932,19068,125000,January
3725,Minute maid mango,PIECE,125,2500,264831,47669,312500,January
2763,JAMIES SWEET YELLOW BUNS 6PCS,PIECE,128,3500,379661,68339,448000,January
5368,SIMKA CHOC-VAN 120MLS,PIECE,128,1000,108475,19525,128000,January
1222,COCACOLA 350MLS,PIECE,130,1000,110169,19831,130000,January
7370,JAMIES SCONES WHOLESALE 1000,PIECE,130,1000,110169,19831,130000,January
3741,MIRINDA FRUITY 330MLS,PIECE,131,1000,111017,19983,131000,January
2792,JESA MILK 1LTR,PIECE,132,3600,402712,72488,475200,January
4351,ONER MANGO 500MLS,PIECE,133,2500,281780,50720,332500,January
4024,NATARAJ PENS,PIECE,134,700,79492,14308,93800,January
2683,INDOMIE NOODLES 70G,PIECE,135,1200,137288,24712,162000,January
2748,JAMIES QUEEN CAKES 6PCS 3000,PIECE,136,3500,403390,72610,476000,January
2761,JAMIES SWEET YELLOW BREAD 500G,PIECE,137,3000,348305,62695,411000,January
647,BIC PENS,PIECE,141,700,83644,15056,98700,January
7375,JAMIES WHOLE SALE SWEET BROWN 5000,PIECE,142,5000,601695,108305,710000,January
6784,LIVER STEW 8000,PIECE,143.73,7420,903814,162686,1066500,January
6613,YAKET 550ML,PIECE,147,500,62288,11212,73500,January
6841,PIZZA CHICKEN SLICE BIG ,PIECE,147,6000,747458,134542,882000,January
6813,GRILLED CHICKEN 7000,PIECE,150,7000,889831,160169,1050000,January
2513,HARMONY POT WATER,PIECE,151,1000,127966,23034,151000,January
3325,LATO YOGHURT SRAWBERRY 200G,PIECE,152,1000,128814,23186,152000,January
4347,ONER APPLE JUICE DRINK,PIECE,153,2500,324153,58347,382500,January
7790,JAMIES CINNAMON BREAD,PIECE,153,6000,777966,140034,918000,January
2734,JAMIES DOUGH NUTS HUGE,PIECE,158,2000,267797,48203,316000,January
7829,KICK PRINCESS CHICKEN FLAVOUR ,PIECE,159,500,67373,12127,79500,January
7704,JAMIES MILK BREAD 5500,PIECE,161,6000,818644,147356,966000,January
2427,GORILLO'S BBQ BEEF 24G,PIECE,163,500,69068,12432,81500,January
7142,JAMIES MARBLE CAKE 3000,PIECE,164,3000,416949,75051,492000,January
3060,KICK SNACKS CHICKEN,PIECE,166,500,70339,12661,83000,January
2718,JAMIES BROWN BUNS 6PCS,PIECE,170,3500,504237,90763,595000,January
7650,JAMIES SWEET WHITE BUNS @4000,PIECE,172,4000,583051,104949,688000,January
2757,JAMIES SWEET WHITE BREAD 500,PIECE,179,3000,455085,81915,537000,January
2805,JESA UHT FINO,PIECE,189,2000,320339,57661,378000,January
5036,RWENZORI 1.5LTRS,PIECE,194,2000,328814,59186,388000,January
5043,RWENZORI WATER 500ML,PIECE,199,1000,168644,30356,199000,January
2759,JAMIES SWEET WHITE BUNS 6PCS,PIECE,205,3500,608051,109449,717500,January
563,BALOON 300,PIECE,213,300,54153,9747,63900,January
5756,SUMZ POTATO CRISPS 40G,PIECE,216,1500,274576,49424,324000,January
2429,GORILLO'S CHICKEN 24G,PIECE,219,500,92797,16703,109500,January
6773,VEGETABLE SAMOSA 1000,PIECE,227,1000,192373,34627,227000,January
7143,GRAVY SOUP 1000,PIECE,227.27,1003,193135,34764,227899,January
5347,SILKEE JUMBO TP,PIECE,234,2000,396610,71390,468000,January
7376,JAMIES WHOLE SALE SWEET WHITE 5000,PIECE,237,5000,1004237,180763,1185000,January
5374,SIMKA STRAW-VAN 120MLS,PIECE,245,1000,207627,37373,245000,January
6840,GONJA FRIED 1000,PIECE,247,1000,209322,37678,247000,January
182,APPLES GREEN,PIECE,253,1500,321610,57890,379500,January
6775,CHAPS 3000,PIECE,259,3000,658475,118525,777000,January
6971,SWEET POTATOES BOILED 1000,PIECE,260,1000,220339,39661,260000,January
4128,NIVANA 500MLS,PIECE,276,500,116949,21051,138000,January
6808,CRACKERS 1500,PIECE,281,2000,476271,85729,562000,January
5755,SUMZ POTATO CRISPS 20G,PIECE,285,600,144915,26085,171000,January
6779,PILAO PLAIN 10000,PIECE,286.88,10000,2431186,437614,2868800,January
6781,VEGETABLE RICE 7000,PIECE,292.95,6891,1710720,307930,2018650,January
1286,COMFORT T.P 1000,PIECE,294,1000,249153,44847,294000,January
6790,KATOGO 4000,PIECE,295.34,3999,1000822,180148,1180970,January
6970,YAM SLICE 1000,PIECE,298,1000,252542,45458,298000,January
6868,SPAGHETI 2500,PIECE,304.28,2493,642881,115719,758600,January
2751,JAMIES SWEET BROWN BREAD1KG,PIECE,314,5500,1463559,263441,1727000,January
5881,SWEETS 500,PIECE,316,500,133898,24102,158000,January
6820,BEEF SAMOSA 1500,PIECE,319,1500,405508,72992,478500,January
6807,BEAN STEW 2000,PIECE,321.36,1994,542960,97733,640693,January
7430,JAMIES SWEET YELLOW BUNS WHOLESALE 2500,PIECE,349,2500,739407,133093,872500,January
7026,CHICKEN STEW 4000,PIECE,364,4000,1233898,222102,1456000,January
7497,JAMIES SWEET BUNS BROWN 6PCS WHOLESALE,PIECE,373,2500,790254,142246,932500,January
6792,CHIPS 2500,PIECE,446.14,2519,952203,171397,1123600,January
2744,JAMIES MUFFINS,PIECE,455,1500,578390,104110,682500,January
2760,JAMIES SWEET YELLOW BREAD 1KG,PIECE,475,5500,2213983,398517,2612500,January
7727,JAMIES SWEET WHITE BUNS WHOLESALE,PIECE,479,2500,1197500,0,1197500,January
5875,SWEETS 100,PIECE,501,100,42458,7642,50100,January
6889,EGGS BOILED 500,PIECE,523,500,221610,39890,261500,January
183,APPLES RED,PIECE,532,1500,676271,121729,798000,January
6805,PANCAKES 500,PIECE,577,500,244492,44008,288500,January
2735,JAMIES DOUGH NUTS SMALL 4000,PIECE,648,3000,1647458,296542,1944000,January
6812,BEEF STEW 6000,PIECE,648,2000,1098305,197695,1296000,January
2756,JAMIES SWEET WHITE BREAD 1KG,PIECE,659,5500,3071610,552890,3624500,January
2793,JESA MILK 500ML,PIECE,1104,1800,1684068,303132,1987200,January
6788,BEEF SAUSAGES 1000,PIECE,1484,1000,1257627,226373,1484000,January
6821,CHAPATI 1000,PIECE,2910,1000,2466102,443898,2910000,January
5995,TERRY BOY BOXERS 3PCS,PIECE,0,15254,0,0,0,February
10,5LTR JERRICAN 3000,PIECE,1,4000,3390,610,4000,February
14,7 DAYS WIPES,PIECE,1,5000,4237,763,5000,February
36,ACTIVE WOMAN BODY SPRAY,PIECE,1,10000,8475,1525,10000,February
56,AFRICANA TEA BAGS 100,PIECE,1,8500,7203,1297,8500,February
59,AFROCARE BODY CREAMS 200G,PIECE,1,3500,2966,534,3500,February
63,AFROCARE PETROLEUM JELLY,PIECE,1,4500,3814,686,4500,February
92,ALWAYS ULTRA V.P,PIECE,1,6500,5508,992,6500,February
115,AMARA RAW SHEA 200ML,PIECE,1,5500,4661,839,5500,February
129,AMERICAN GARDEN KETCHUP 680G,PIECE,1,18000,15254,2746,18000,February
146,AMLA HAIR OIL 100ML,PIECE,1,7000,5932,1068,7000,February
170,ANKIT SHORT BISCUITS,PIECE,1,6500,5508,992,6500,February
208,ARIEL COLOR 1KG,PIECE,1,15500,13136,2364,15500,February
209,Ariel color and style,PIECE,1,8000,6780,1220,8000,February
212,ARIEL DOWNY 500G,PIECE,1,8000,6780,1220,8000,February
216,ARIEL ORIGINAL 500G,PIECE,1,8000,6780,1220,8000,February
225,ARMAF ENCHANTED FOLIAGE A.F,PIECE,1,8000,6780,1220,8000,February
273,ART PENCILS 2B,PIECE,1,1000,847,153,1000,February
311,AUNT PORRIDGE 1KG,PIECE,1,14000,11864,2136,14000,February
312,AUNT PORRIDGE 2KG,PIECE,1,28000,23729,4271,28000,February
325,AXE APOLLO BODY SPRAY,PIECE,1,13000,11017,1983,13000,February
343,AXION PASTE LIME,PIECE,1,6000,5085,915,6000,February
350,B.D BALOON CHART,PIECE,1,4000,3390,610,4000,February
353,B.D CANDLE NUMBERS,PIECE,1,1500,1271,229,1500,February
384,BABY BOTTLE 7000,PIECE,1,7000,5932,1068,7000,February
407,BABY CUP LAXSON 8000,PIECE,1,8000,6780,1220,8000,February
426,BABY FEEDING BOTTLE 5000,PIECE,1,5000,4237,763,5000,February
431,BABY FEEDING CUPS 7000,PIECE,1,7000,5932,1068,7000,February
443,BABY JUNIOR JELLY 24ML,PIECE,1,700,593,107,700,February
452,BABY MILK BOTTLES 7000,PIECE,1,7000,5932,1068,7000,February
455,BABY NIPPLES BIG 1000,PIECE,1,1000,847,153,1000,February
480,BABY SPOONS 10000,PIECE,1,10000,8475,1525,10000,February
486,BABY TENDER WIPES,PIECE,1,6000,5085,915,6000,February
500,BABY&ME BABY OIL,PIECE,1,3000,2542,458,3000,February
546,BALLOONS 1500,PIECE,1,1500,1271,229,1500,February
550,BALLS 10000N HALLET,PIECE,1,10000,8475,1525,10000,February
551,BALLS 12000,PIECE,1,12000,10169,1831,12000,February
556,BALLS AND DOLLS LIGHTING 7000,PIECE,1,7000,5932,1068,7000,February
562,BALLS SOFT 1000,PIECE,1,2000,1695,305,2000,February
582,BASIN ANGEL 7000,PIECE,1,7000,5932,1068,7000,February
649,BI-CARBONATE SODA,PIECE,1,1000,847,153,1000,February
665,BIRTHDAY CANDLES 4000,PIECE,1,3500,2966,534,3500,February
674,BIRTHDAY LETTERS 5000,PIECE,1,5000,4237,763,5000,February
688,BIYINZIKA STANDARD1.2KG,PIECE,1,25000,21186,3814,25000,February
690,BIYINZIKA THIGHS 500G,PIECE,1,10000,8475,1525,10000,February
705,BLESSED KISUBI TEA 350G,PIECE,1,12000,10169,1831,12000,February
732,BLUEBAND PEANUT BUTTER,PIECE,1,8000,6780,1220,8000,February
733,BLUEBAND PEANUT BUTTER 400G,PIECE,1,14000,11864,2136,14000,February
737,BODY LUXE 200G ALOEVERA,PIECE,1,4000,3390,610,4000,February
743,BODY TALK LOTION 250ML,PIECE,1,9000,7627,1373,9000,February
744,BODYLUXE JELLY 100G,PIECE,1,3000,2542,458,3000,February
745,BODYLUXE JELLY 500G,PIECE,1,10000,8475,1525,10000,February
763,BOTTLE WASHER 10000,PIECE,1,10000,8475,1525,10000,February
773,BOTTLES 4000,PIECE,1,4000,3390,610,4000,February
774,BOTTLES 5000,PIECE,1,5000,4237,763,5000,February
797,BRAS 6000,PIECE,1,6000,5085,915,6000,February
815,BRITANIA ASSORTED 1KG,PIECE,1,20000,16949,3051,20000,February
817,BRITANIA BUTTER 1KG,PIECE,1,20000,16949,3051,20000,February
820,BRITANIA DIGESTIVE 1KG,PIECE,1,20000,16949,3051,20000,February
822,BRITANIA GINGER 1KG,PIECE,1,20000,16949,3051,20000,February
875,BUCKETS ELITE 6000,PIECE,1,6000,5085,915,6000,February
904,C.B CLASSIC VANILLA 1LTR,PIECE,1,19500,16525,2975,19500,February
940,CADBURY DAIRY MINT 150G,PIECE,1,13000,11017,1983,13000,February
945,CADBURY DRINKING CHOCOLATE 450G,PIECE,1,22000,18644,3356,22000,February
955,CAKE BOARD 3000,PIECE,1,3000,2542,458,3000,February
965,CAKE TOPPER 5000,PIECE,1,5000,4237,763,5000,February
1003,CAR 10000 4WD,PIECE,1,10000,8475,1525,10000,February
1009,CAR TOYS 8000,PIECE,1,8000,6780,1220,8000,February
1022,CARO LIGHT OIL 50ML,PIECE,1,4500,3814,686,4500,February
1023,CAROLIGHT CREME 120ML;,PIECE,1,6500,5508,992,6500,February
1038,CASIO 401/991MS CALCULATOR,PIECE,1,45000,38136,6864,45000,February
1067,CERELAC 6MONTHS,PIECE,1,27000,22881,4119,27000,February
1122,CHICKSTAX SILVER FISH POWDER,PIECE,1,7000,5932,1068,7000,February
1128,CHILDREN'S UNDERWEAR 20000,PIECE,1,20000,16949,3051,20000,February
1163,CLAIRMEN CREAM 120ML,PIECE,1,7000,5932,1068,7000,February
1171,CLASSIC MILK BOX 23000,BOX,1,24000,20339,3661,24000,February
1186,CLERE BABY JELLY 100G,PIECE,1,3000,2542,458,3000,February
1193,CLERE PETROLEUM JELLY 250G,PIECE,1,6000,5085,915,6000,February
1198,CLIMAX CITRUS FRUITS 50G,PIECE,1,2500,2119,381,2500,February
1213,CLOSEUP TRIPPLE FRESH 125G,PIECE,1,5000,4237,763,5000,February
1220,COBWEB 9000,PIECE,1,9000,7627,1373,9000,February
1274,COLORES NEW ELITE COLOURS BIG,PIECE,1,2000,1695,305,2000,February
1280,COMB WITH MIRROR 2500,PIECE,1,2500,2119,381,2500,February
1297,CONTAINER S1155 13000,PIECE,1,13000,11017,1983,13000,February
1330,COTTON BUDS WOODEN,PIECE,1,3000,2542,458,3000,February
1363,CROWN PERFUME LOVELY,PIECE,1,12000,10169,1831,12000,February
1372,CUP GIFT 17000,PIECE,1,17000,14407,2593,17000,February
1377,CUPS 5000,PIECE,1,5000,4237,763,5000,February
1396,CUSSONS BABY UNPERFUMED JELLY 100ML,PIECE,1,5500,4661,839,5500,February
1397,CUSSONS BABY UNPERFUMED JELLY 200ML,PIECE,1,12000,10169,1831,12000,February
1425,D.L MANGO 250ML,PIECE,1,5000,4237,763,5000,February
1441,D.L VANILLA 1LTR,PIECE,1,18000,15254,2746,18000,February
1446,D.L VAN-STRAW 1LTR,PIECE,1,18000,15254,2746,18000,February
1492,DEAR BODY KISSING MIGGLE BODY MIST,PIECE,1,16000,13559,2441,16000,February
1503,DEAR BODY WEDNESDAY BODY MIST,PIECE,1,16000,13559,2441,16000,February
1539,DETTOL 125MLS,PIECE,1,9000,7627,1373,9000,February
1542,DETTOL COOL 105G,PIECE,1,4500,3814,686,4500,February
1543,DETTOL COOL 175G,PIECE,1,6500,5508,992,6500,February
1548,DETTOL FRESH 90G,PIECE,1,4500,3814,686,4500,February
1585,DIEHARD MAN SPRAY,PIECE,1,12000,10169,1831,12000,February
1603,DISPOSABLE SPOON 4000,PIECE,1,4000,3390,610,4000,February
1640,DOLL 20000,PIECE,1,20000,16949,3051,20000,February
1642,DOLL 3000,PIECE,1,3000,2542,458,3000,February
1649,DOLL BAY 15000,PIECE,1,15000,12712,2288,15000,February
1659,DOLLS MOTHER 6000,PIECE,1,6000,5085,915,6000,February
1667,DOMS COLOUR PENCILS SHORT,PIECE,1,4000,3390,610,4000,February
1698,DOVE DEEPLY NOURISHING SHOWER GEL 500ML,PIECE,1,22000,18644,3356,22000,February
1702,DOVE GLOWING RITUAL SHOWER GEL,PIECE,1,21000,17797,3203,21000,February
1731,DOVE ROLL ON MIX,PIECE,1,11000,9322,1678,11000,February
1734,DOVE ROLLON GRAPEFRUIT,PIECE,1,11000,9322,1678,11000,February
1759,DRINKING CHOCOLATE 225G,PIECE,1,13000,11017,1983,13000,February
1768,DURACELL AA ORIGINAL,PIECE,1,7000,5932,1068,7000,February
1772,DURU CARING MILK,PIECE,1,4500,3814,686,4500,February
1776,DURU FLORAL INFUSION,PIECE,1,14000,11864,2136,14000,February
1779,DURU FRESH SENSATION 4PCS,PIECE,1,16000,13559,2441,16000,February
1784,DURU MOUNTAINAIR SOAP,PIECE,1,14000,11864,2136,14000,February
1786,DURU NATURAL OLIVE 720G,PIECE,1,18000,15254,2746,18000,February
1788,DURU OCEAN BREEZE SOAP,PIECE,1,14000,11864,2136,14000,February
1790,DURU REFRESHING LEMON,PIECE,1,14000,11864,2136,14000,February
1791,DURU SHOWERGEL JASMIN AMBER,PIECE,1,14000,11864,2136,14000,February
1796,DUST PAN 7000,PIECE,1,7000,5932,1068,7000,February
1819,EAST AFRICAN ORGANIC HONEY 250G,PIECE,1,8000,6780,1220,8000,February
1828,ED BACK PACK RED SPRAY,PIECE,1,12000,10169,1831,12000,February
1833,ED PINK PEA SPLASH,PIECE,1,16000,13559,2441,16000,February
1836,EDEN APRICOT SCRUB 227G,PIECE,1,15000,12712,2288,15000,February
1840,EDEN BODY MILK 500ML,PIECE,1,25000,21186,3814,25000,February
1848,EGG TRAYS 4000,PIECE,1,3000,2542,458,3000,February
1861,ELEGANCE COCOA BUTTER,PIECE,1,6000,5085,915,6000,February
1878,ELEGANT LAVENDER AR.F,PIECE,1,7000,5932,1068,7000,February
1887,ELEGANT STRAWBERRY 300ML,PIECE,1,7000,5932,1068,7000,February
1890,ELGON BLEND 250G,PIECE,1,14000,11864,2136,14000,February
1891,ELGON BLEND COFFEE 100G,PIECE,1,7000,5932,1068,7000,February
1913,EPIDERM CREME 15G,PIECE,1,2500,2119,381,2500,February
1934,EXCEL GLUCOSE 250G,PIECE,1,6500,5508,992,6500,February
1938,F.D FLAVOURED MILK BOX46000,BOX,1,45000,38136,6864,45000,February
1987,FA MYSTIC MOMENTS,PIECE,1,6500,5508,992,6500,February
1989,FA PINK PASSION ROLLON,PIECE,1,6500,5508,992,6500,February
2001,FACE TOWEL 2500,PIECE,1,2500,2119,381,2500,February
2003,FACE TOWELS 3500,PIECE,1,3500,2966,534,3500,February
2039,FAX ALOE&HONEY 225G,PIECE,1,5000,4237,763,5000,February
2052,FAX SUNSHINEAPPLES SOAP,PIECE,1,8000,6780,1220,8000,February
2097,FLAIR FOUNTAIN PEN,PIECE,1,12000,10169,1831,12000,February
2110,FLOSS TOOTHPLCKS,PIECE,1,2500,2119,381,2500,February
2114,FLYMEEGO VESTS 25000,PIECE,1,25000,21186,3814,25000,February
2120,FOGG BOLD ROLLON 50MLS,PIECE,1,8500,7203,1297,8500,February
2141,FOGG VICTOR BODY SPRAY,PIECE,1,18000,15254,2746,18000,February
2150,FOOD COLOUR BLUE,PIECE,1,1000,847,153,1000,February
2152,FOOD COLOUR EGG YELLOW,PIECE,1,1000,847,153,1000,February
2164,FOOD STORAGE 30000,PIECE,1,30000,25424,4576,30000,February
2184,FOUNTAIN PENS 2000,PIECE,1,2000,1695,305,2000,February
2268,GALAXY DISPOSABLE PLATES,PIECE,1,11000,9322,1678,11000,February
2276,GARDEN FRESH 50G,PIECE,1,2000,1695,305,2000,February
2316,GIFT BAG BIG 4500,PIECE,1,4500,3814,686,4500,February
2336,GILLETTE 2 1500,PIECE,1,1200,1017,183,1200,February
2344,GIRL BIKE 8000,PIECE,1,8000,6780,1220,8000,February
2345,GIRL FRIEND FANTASY LOTION 500ML,PIECE,1,7000,5932,1068,7000,February
2384,GODFREY G.NUTS 80gm,PIECE,1,2000,1695,305,2000,February
2466,GUN TOYS 13000,PIECE,1,13000,11017,1983,13000,February
2483,HAIR BANS RIBBON,PIECE,1,1500,1271,229,1500,February
2501,HANYAN EAR BUDS,PIECE,1,2000,1695,305,2000,February
2520,HARPIC POWER PLUS 500ML,PIECE,1,14000,11864,2136,14000,February
2522,"HARPIC TOILET BLOCKS PINE, AQUAMARINE",PIECE,1,21000,17797,3203,21000,February
2539,HERO FOUNTAIN PEN 2000,PIECE,1,2000,1695,305,2000,February
2625,HUGGIES S.6 PANTS,PIECE,1,58000,49153,8847,58000,February
2628,HUGGIES WIPES NATURAL CARE,PIECE,1,9000,7627,1373,9000,February
2631,HY COOL BOTTLE 20000,PIECE,1,20000,16949,3051,20000,February
2658,IMPERIAL LEATHER MEN COOL 400L LOTION,PIECE,1,13000,11017,1983,13000,February
2666,IMPERIAL LEATHER SPORT 175G,PIECE,1,4500,3814,686,4500,February
2674,INDOCAFE 100G,PIECE,1,17000,14407,2593,17000,February
2706,JAGO 100MLS,PIECE,1,3500,2966,534,3500,February
2710,JAGO AFTERSHAVE 300MLS,PIECE,1,7500,6356,1144,7500,February
2721,JAMIES CAKE @70k,PIECE,1,70000,59322,10678,70000,February
2723,JAMIES CAKES @30k,PIECE,1,35000,29661,5339,35000,February
2768,JCJ HAND WRITING BOOK 2000,PIECE,1,2000,1695,305,2000,February
2783,JESA FLAVOURED MILK BOX,BOX,1,30000,25424,4576,30000,February
2784,JESA FLAVOURED STRAW 500ML,PIECE,1,4000,3390,610,4000,February
2866,JOHNSON EXTRA GENTLE CARE SOAP,PIECE,1,7500,6356,1144,7500,February
2922,JUMBO WAX CRAYONS,PIECE,1,5000,4237,763,5000,February
2933,KABODY COCONUT MILK 1KG,PIECE,1,6500,5508,992,6500,February
2937,KABODY MUKENE SOYA RICE1KG,PIECE,1,6500,5508,992,6500,February
2939,KABODY OATS SOYA RICE 1KG,PIECE,1,6500,5508,992,6500,February
2940,KABODY PUMPKIN PORRIDGE 1KG,PIECE,1,6000,5085,915,6000,February
2945,KABODY SOYA PORRIDGE,PIECE,1,6500,5508,992,6500,February
2946,KABODY SOYA RICE 1KG,PIECE,1,6500,5508,992,6500,February
2954,KAKIRA SUGAR 5KG,PIECE,1,32700,27712,4988,32700,February
2990,KAZIRE VIT FRUIT,PIECE,1,2000,1695,305,2000,February
3084,KIDS TOOTH BRUSH 5000,PIECE,1,5000,4237,763,5000,February
3090,KIDS VESTS CLEVER GOLD 20K,PIECE,1,20000,16949,3051,20000,February
3094,KIDS WATCHES 7000,PIECE,1,7000,5932,1068,7000,February
3100,KIMBO 500G,PIECE,1,7500,6356,1144,7500,February
3103,KINGTAT 800,PIECE,1,1000,847,153,1000,February
3128,KITCHEN TOWELS,PIECE,1,4000,3390,610,4000,February
3138,KIWI NEUTRAL CREME 100G,PIECE,1,4000,3390,610,4000,February
3144,KIWI SUEDE CLEANER BLACK,PIECE,1,7000,5932,1068,7000,February
3161,KNOCK PIANO 18000,PIECE,1,18000,15254,2746,18000,February
3180,KOOKSY CHOCO BAR 75ML,PIECE,1,3000,2542,458,3000,February
3193,KOOKSY TUTTI FRUITY 125ML,PIECE,1,3000,2542,458,3000,February
3196,KOOKSY VANILLA 120MLS,PIECE,1,1000,847,153,1000,February
3228,KUZA INDIAN HEMP,PIECE,1,16000,13559,2441,16000,February
3236,KYOGERO HERBAL JELLY 250G,PIECE,1,7500,6356,1144,7500,February
3419,LOVE CHOCOLATE,PIECE,1,3000,2542,458,3000,February
3449,LUSHANJIU DIET TEA,PIECE,1,16000,13559,2441,16000,February
3459,M&G PUSH PINS,PIECE,1,2000,1695,305,2000,February
3474,M&G HIGHLIGHTER PINK,PIECE,1,1500,1271,229,1500,February
3487,M&G SCIENTIC CALCULATOR,PIECE,1,30000,25424,4576,30000,February
3499,M&G WHITE BOARD MARKER,PIECE,1,1500,1271,229,1500,February
3524,MACDO TOMATO SAUCE 5LTR,PIECE,1,10000,8475,1525,10000,February
3561,MAGIC 1KG BUCKET,PIECE,1,12500,10593,1907,12500,February
3588,MANILA PAPERS 1000,PIECE,1,1000,847,153,1000,February
3597,MANUSCRIPT 3Q BOOK,PIECE,1,16000,13559,2441,16000,February
3598,MANUSCRIPT BOOK 2Q,PIECE,1,12000,10169,1831,12000,February
3612,MASKING TAPE 2500,PIECE,1,2500,2119,381,2500,February
3621,MATHEMATICAL SET 3500 KYLIAN,PIECE,1,4000,3390,610,4000,February
3626,MAYONNAISE BIG 887ML,PIECE,1,30000,25424,4576,30000,February
3640,MELEX DADDIES 250G 6500,PIECE,1,5000,4237,763,5000,February
3668,MEN SOCKS,PIECE,1,3000,2542,458,3000,February
3669,MEN SOCKS 3500,PIECE,1,3500,2966,534,3500,February
3683,METALIC MOPPER 18000,PIECE,1,18000,15254,2746,18000,February
3709,MILO 100G,PIECE,1,11000,9322,1678,11000,February
3748,MIRROR 1500,PIECE,1,1500,1271,229,1500,February
3750,MIRRORS 2500,PIECE,1,2500,2119,381,2500,February
3787,MONACO SPRAY,PIECE,1,11000,9322,1678,11000,February
3809,MOPPER 7000,PIECE,1,7000,5932,1068,7000,February
3814,MOPPERS 17000,PIECE,1,17000,14407,2593,17000,February
3837,MORTEIN DOOM LEMON 400ML,PIECE,1,28000,23729,4271,28000,February
3841,MORTEIN LEMON 300ML,PIECE,1,22000,18644,3356,22000,February
3846,MORTEIN ODOURLESS 600ML,PIECE,1,32000,27119,4881,32000,February
3848,MOSQUITO NETS 15000,PIECE,1,15000,12712,2288,15000,February
3887,MOVIT FAMILY SOAP 230G,PIECE,1,4000,3390,610,4000,February
3891,MOVIT FAMILY SOAP COCOMUT 125G,PIECE,1,2500,2119,381,2500,February
3898,MOVIT GLYCERINE,PIECE,1,2000,1695,305,2000,February
3910,MOVIT HERBAL JELLY 550G,PIECE,1,12000,10169,1831,12000,February
3915,MOVIT JELLY 50G,PIECE,1,1500,1271,229,1500,February
3917,MOVIT JELLY 85ML,PIECE,1,2000,1695,305,2000,February
3931,MOVIT STYLING GEL 150G,PIECE,1,4500,3814,686,4500,February
3937,MR GREEN SCOURING PADS,PIECE,1,6000,5085,915,6000,February
3980,MWANA MUGIMU 100G,PIECE,1,4000,3390,610,4000,February
3985,MYSTIC AIRFRESHENER BEWITCHING ROSE,PIECE,1,7500,6356,1144,7500,February
4000,NAN OPTIPRO 1 400G,PIECE,1,48000,40678,7322,48000,February
4030,NATURAL SPONGE 2000,PIECE,1,2000,1695,305,2000,February
4044,NESCAFE CLASSIC 200G,PIECE,1,26000,22034,3966,26000,February
4052,NEVIA PEARL&BEAUTY ROLLON,PIECE,1,11000,9322,1678,11000,February
4083,NICE& LOVELY ALOE 48HRS 400ML,PIECE,1,10000,8475,1525,10000,February
4084,NICE&LOVELY 200ML PINK,PIECE,1,6000,5085,915,6000,February
4101,NIGINA 14000,PIECE,1,14000,11864,2136,14000,February
4116,NISA CAMEL SOAP SHEABUTTER,PIECE,1,5000,4237,763,5000,February
4117,NISA CUCUMBER HAIR REMOVAL 20ML,PIECE,1,2000,1695,305,2000,February
4118,NISA HAIR REMOVAL CUCUMBER 100ML,PIECE,1,10000,8475,1525,10000,February
4121,NISA HAIR REMOVAL ROSE 100ML,PIECE,1,10000,8475,1525,10000,February
4122,NISA HAIR REMOVAL ROSE 50ML,PIECE,1,7000,5932,1068,7000,February
4137,NIVEA BLACK&WHITE ROLLON,PIECE,1,11000,9322,1678,11000,February
4166,NIVEA MEN MAXIMUM HYDRATION 200ML,PIECE,1,15000,12712,2288,15000,February
4167,NIVEA MEN MAXIMUM HYDRATION 400ML,PIECE,1,19000,16102,2898,19000,February
4168,NIVEA MEN REVITALIZING,PIECE,1,19000,16102,2898,19000,February
4178,NIVEA REPAIR& CARE 72H 400ML,PIECE,1,19000,16102,2898,19000,February
4199,NOTE BOOK 5500,PIECE,1,5500,4661,839,5500,February
4202,NOTE BOOK SPIRAL 9000,PIECE,1,9000,7627,1373,9000,February
4204,NOTEBOOK 6500,PIECE,1,6500,5508,992,6500,February
4207,NOVICOL WOOD GLUE,PIECE,1,5000,4237,763,5000,February
4220,NUMA KARO 1KG,PIECE,1,6500,5508,992,6500,February
4226,NUMA SUPER RICE 1KG,PIECE,1,8500,7203,1297,8500,February
4233,NUTRO ORANGE WAFERS,PIECE,1,3500,2966,534,3500,February
4241,NUTRO DIGESTIVE LIGHT,PIECE,1,6500,5508,992,6500,February
4249,NUTRO VANILLA FLAVOURED,PIECE,1,6500,5508,992,6500,February
4274,NUVITA ORANGE CREAM BISCUITS,PIECE,1,1500,1271,229,1500,February
4287,ODEON SCRUB HONEY&OLIVE,PIECE,1,11000,9322,1678,11000,February
4293,ODONIL DISINFECTANT,PIECE,1,7000,5932,1068,7000,February
4322,OLITALIA OLIVE OIL POMACE 250ML,PIECE,1,27000,22881,4119,27000,February
4334,OMO AUTO WASHING POWDER 1KG,PIECE,1,21000,17797,3203,21000,February
4344,OMO FAST ACTION 1KG,PIECE,1,12500,10593,1907,12500,February
4345,OMO FAST ACTION 3.5KG,PIECE,1,40000,33898,6102,40000,February
4418,OXFORD PRIMARY DICTIONARY,PIECE,1,40000,33898,6102,40000,February
4443,PAMPER 2 JUMBO,PIECE,1,75000,63559,11441,75000,February
4451,PAMPER 4 PANTS H.C,PIECE,1,40000,33898,6102,40000,February
4463,PAMPERS WIPES COMPLETE CLEAN,PIECE,1,13500,11441,2059,13500,February
4467,PANASONIC C,PIECE,1,3500,2966,534,3500,February
4477,PANT PEG QIYUSHI 22000,PIECE,1,25000,21186,3814,25000,February
4499,PASSION STRAWBERRY,PIECE,1,16000,13559,2441,16000,February
4508,PEGS 3000,PIECE,1,3000,2542,458,3000,February
4521,PENCIL BAG 5000,PIECE,1,4000,3390,610,4000,February
4522,PENCIL BAGS 3500 205,PIECE,1,3500,2966,534,3500,February
4527,PENGUIN BROWN SHOECREAM,PIECE,1,1500,1271,229,1500,February
4555,PETTI COT 5000,PIECE,1,5000,4237,763,5000,February
4562,PHONE TOY WITH WATCH 8000,PIECE,1,8000,6780,1220,8000,February
4586,PICFARE GRAPH BOOK 96PGS,PIECE,1,3000,2542,458,3000,February
4591,PICFARE RULED PAPER SMALL,PIECE,1,11000,9322,1678,11000,February
4593,PICFARE SQUARE BKS 96PGS,PIECE,1,1500,1271,229,1500,February
4602,PICK-UP POLICE CAR 13000,PIECE,1,13000,11017,1983,13000,February
4603,PICK-UP TOY CAR,PIECE,1,10000,8475,1525,10000,February
4607,PILLOW 10000,PIECE,1,10000,8475,1525,10000,February
4622,PLASTIC FOOD WRAP,PIECE,1,6500,5508,992,6500,February
4628,PLASTIC HANGERS 20000,PIECE,1,20000,16949,3051,20000,February
4635,PLASTIC PLATES 2000,PIECE,1,2000,1695,305,2000,February
4650,PLEDGE ORANGE,PIECE,1,13000,11017,1983,13000,February
4659,POLICE FAMOUS CAR,PIECE,1,15000,12712,2288,15000,February
4661,POLICE RACING CAR 20000,PIECE,1,20000,16949,3051,20000,February
4713,PRESSOL HAIR GEL 125G,PIECE,1,5500,4661,839,5500,February
4720,PRICETAGS 1000,PIECE,1,1000,847,153,1000,February
4721,PRIDE DISH WASHING PASTE LEMON 400G,PIECE,1,10000,8475,1525,10000,February
4732,PRINCESS ULTRA PADS,PIECE,1,2700,2288,412,2700,February
4734,PRINGLES BARBEQUE 165G,PIECE,1,10000,8475,1525,10000,February
4737,PRINGLES CHEESY CHEESE 165G,PIECE,1,12000,10169,1831,12000,February
4748,PRIVE BLACK OPTION BODYSPLASH,PIECE,1,15000,12712,2288,15000,February
4759,PRIVE PANORAMA POUR FEMME,PIECE,1,14000,11864,2136,14000,February
4799,PUCELLE WAVY OCEAN 150MLS,PIECE,1,7500,6356,1144,7500,February
4802,PUFF HOLDERS 1500,PIECE,1,1500,1271,229,1500,February
4803,PUFF HOLDERS 2000,PIECE,1,2000,1695,305,2000,February
4826,QUILL PEN INK BIG,PIECE,1,3500,2966,534,3500,February
4840,RADIANT HAIR VITALIZER 100G,PIECE,1,5000,4237,763,5000,February
4851,RAHA DRINKING CHOCOLATE 100G,PIECE,1,7000,5932,1068,7000,February
4852,RAHA DRINKING CHOCOLATE 200G,PIECE,1,10000,8475,1525,10000,February
4859,RAKES 9000,PIECE,1,9000,7627,1373,9000,February
4871,RASPBERRY MIST PASSION,PIECE,1,16000,13559,2441,16000,February
4880,RAZAC HAND&BODY LOTION 474ML,PIECE,1,17000,14407,2593,17000,February
4891,RECEIT BOOK 1500,PIECE,1,1500,1271,229,1500,February
4903,RELAX TP,PIECE,1,1500,1271,229,1500,February
4910,RENA HERBAL MOUTH WASH,PIECE,1,7000,5932,1068,7000,February
4911,RETYPE WHITE WASH,PIECE,1,3000,2542,458,3000,February
4931,RIBBON 3000,PIECE,1,3000,2542,458,3000,February
4947,RIHAM COLA 320MLS,PIECE,1,1000,847,153,1000,February
4955,RIHAM DIGESTIVE TIN,PIECE,1,18000,15254,2746,18000,February
4973,RINJU HAND&BODY CREAM 118ML,PIECE,1,18000,15254,2746,18000,February
5013,ROYAL POUR HOMME BLACK,PIECE,1,12000,10169,1831,12000,February
5015,ROYALE BLUE SPRAY,PIECE,1,12000,10169,1831,12000,February
5045,SAACHI FLAT IRON NL-IR-1172,PIECE,1,55000,46610,8390,55000,February
5058,SAFINA TALCUM POWDER,PIECE,1,8000,6780,1220,8000,February
5077,SAMONA HERBAL JELLY 100G,PIECE,1,4000,3390,610,4000,February
5078,SAMONA HERBAL JELLY 150G,PIECE,1,5000,4237,763,5000,February
5086,SANDALS 5000,PIECE,1,5000,4237,763,5000,February
5088,SANDALS 7000,PIECE,1,7000,5932,1068,7000,February
5098,SANTA LUCIA SPIRALI 500G,PIECE,1,6000,5085,915,6000,February
5140,SAVANAH ORANGE 3LTR,PIECE,1,22000,18644,3356,22000,February
5142,SAVANNAH COCOPINE 2LTR,PIECE,1,18000,15254,2746,18000,February
5155,SAVANNAH STRAWBERRY 3LTRS,PIECE,1,22000,18644,3356,22000,February
5169,SCHOOL SOCKS RED,PIECE,1,3000,2542,458,3000,February
5174,SCHOOL STOCKINGS WHITE,PIECE,1,4500,3814,686,4500,February
5175,SCISSORS 4000,PIECE,1,4000,3390,610,4000,February
5198,SCRUBING HAND BRUSH 3000,PIECE,1,3000,2542,458,3000,February
5202,SECONDARY ATLAS FOR UG,PIECE,1,40000,33898,6102,40000,February
5209,SECRETS PADS,PIECE,1,4000,3390,610,4000,February
5267,SHENKE LEMON SCENT,PIECE,1,8000,6780,1220,8000,February
5270,SHENKE MOSQUITO COIL LOW SMOKE,PIECE,1,6000,5085,915,6000,February
5271,SHENKE MOSQUITO REPELANT HEATER,PIECE,1,25000,21186,3814,25000,February
5281,SHIVA HONEY 250G,PIECE,1,8000,6780,1220,8000,February
5286,SHOE BRUSH 3000,PIECE,1,3000,2542,458,3000,February
5288,SHOE BRUSHES 1000,PIECE,1,1000,847,153,1000,February
5321,SHREEJI BOOK 200PGS,PIECE,1,4000,3390,610,4000,February
5322,SHREEJI BOOKS 192PGS 6000,PIECE,1,6000,5085,915,6000,February
5326,SHREEJI GRAPHBOOK 48 PAGES,PIECE,1,1500,1271,229,1500,February
5360,SIMBA MBILI 100G,PIECE,1,7000,5932,1068,7000,February
5361,SIMBA MBILI 200G,PIECE,1,9500,8051,1449,9500,February
5362,SIMBA MBILI 500G,PIECE,1,18000,15254,2746,18000,February
5390,SKALA CARROT LOTION 400ML,PIECE,1,6000,5085,915,6000,February
5393,SKALA MEN CREME,PIECE,1,4000,3390,610,4000,February
5399,SKIN CARE 100G,PIECE,1,3000,2542,458,3000,February
5483,SNOWMAN MAKERS,PIECE,1,1000,847,153,1000,February
5511,SOFRIFREE HAIR SPRAY,PIECE,1,11000,9322,1678,11000,February
5518,SOFT BROOMS 12000,PIECE,1,12000,10169,1831,12000,February
5545,SOFTY CARROT 200ML,PIECE,1,5500,4661,839,5500,February
5575,SPARKLING CANDLES 9000,PIECE,1,8000,6780,1220,8000,February
5614,SPONGES 4500,PIECE,1,4500,3814,686,4500,February
5618,SPOONS 10000 6PCS,PIECE,1,10000,8475,1525,10000,February
5619,SPOONS 5000,PIECE,1,5000,4237,763,5000,February
5631,SQUEEZERS DOULBLE 10000,PIECE,1,10000,8475,1525,10000,February
5649,STAR COFFEE 250G B. CHOICE,PIECE,1,10000,8475,1525,10000,February
5655,STA-SOF-FRO CURL HAIR SPRAY,PIECE,1,11000,9322,1678,11000,February
5656,STA-SOFT LAVENDER 750ML,PIECE,1,12000,10169,1831,12000,February
5708,SUCCESS CARD 2500,PIECE,1,2500,2119,381,2500,February
5726,SULTAN COCONUT HAIL OIL,PIECE,1,5000,4237,763,5000,February
5737,SUMZ CORN CRAX PKT 13000,PIECE,1,13000,11017,1983,13000,February
5767,SUMZS CRISPS 500G,PIECE,1,12000,10169,1831,12000,February
5780,SUNLIGHT DISHWASHING PASTE,PIECE,1,9000,7627,1373,9000,February
5797,SUNLIGHT TROPICAL 3.5KGS,PIECE,1,34000,28814,5186,34000,February
5803,SUNSEED OIL 2LTRS,PIECE,1,21000,17797,3203,21000,February
5813,SUNSIP APPLE 3LTRS,PIECE,1,16000,13559,2441,16000,February
5815,SUNSIP BLACKCURRANT 3LTR,PIECE,1,16000,13559,2441,16000,February
5817,SUN-SIP COCOPINE 3LTR,PIECE,1,16000,13559,2441,16000,February
5819,SUNSIP MANGO 5LTR,PIECE,1,24000,20339,3661,24000,February
5821,SUN-SIP STRAWBERRY 2LTR,PIECE,1,11000,9322,1678,11000,February
5844,SUPER GLUE,PIECE,1,1000,847,153,1000,February
5845,SUPER MAX SHAVER&BLADES,PIECE,1,7000,5932,1068,7000,February
5850,SUPERMAX SWIFT 3 BLADE STICK,PIECE,1,7000,5932,1068,7000,February
5868,SWEET.O LAVENDER SHOWER GEL,PIECE,1,18000,15254,2746,18000,February
5891,SWEETY FITPANTZ LC L8,PIECE,1,9000,7627,1373,9000,February
5907,SWT-1 GREEN 2KG,PIECE,1,14000,11864,2136,14000,February
5910,SWT-P RICE 1KG YELLOW,PIECE,1,8000,6780,1220,8000,February
5961,TEDDY BEAR 27000,PIECE,1,25000,21186,3814,25000,February
5994,TENNIS BALLS 3PCS,PIECE,1,10000,8475,1525,10000,February
6011,TIGER HEAD AA,PIECE,1,1000,847,153,1000,February
6047,TOILET BRUSH 6000,PIECE,1,6000,5085,915,6000,February
6050,TOILET BRUSHES 12000,PIECE,1,12000,10169,1831,12000,February
6059,TONGS 5000,PIECE,1,5000,4237,763,5000,February
6114,TORCH 1000,PIECE,1,1000,847,153,1000,February
6143,TOWELS 20000,PIECE,1,20000,16949,3051,20000,February
6149,TOY BIKES 8000,PIECE,1,8000,6780,1220,8000,February
6153,TOY MODEL REMOTE CAR 55000,PIECE,1,55000,46610,8390,55000,February
6196,TROPICAL HEAT CURRY POWDER 100G,PIECE,1,6000,5085,915,6000,February
6197,TROPICAL HEAT FISH MASALA 100G,PIECE,1,5000,4237,763,5000,February
6209,TROPICAL HEAT PILAU MASALA 100G,PIECE,1,11000,9322,1678,11000,February
6219,TROPICAL HEAT WHITE PEPPER 50G,PIECE,1,8000,6780,1220,8000,February
6233,TRUCK CAR 15000,PIECE,1,15000,12712,2288,15000,February
6240,TRUCK TOYS 20000,PIECE,1,20000,16949,3051,20000,February
6293,UGACHICK GIZZARDS 500G,PIECE,1,13000,11017,1983,13000,February
6295,UGACHICK GRILLER 1KG,PIECE,1,24000,20339,3661,24000,February
6300,UGACHICK THIGHS 500G,PIECE,1,13000,11017,1983,13000,February
6301,UGACHICK WINGS 500G,PIECE,1,13000,11017,1983,13000,February
6305,UGANDA SAFARI TEA 250G,PIECE,1,7000,5932,1068,7000,February
6308,UGANDA TEA BAGS 100BAGS,PIECE,1,9000,7627,1373,9000,February
6366,V.L EXTRA HYDRATION LOTION 200ML,PIECE,1,8000,6780,1220,8000,February
6413,VASELINE DRY SKIN REPAIR LOTION 400ML,PIECE,1,15000,12712,2288,15000,February
6421,VASELINE MEN COOLING 400MLS,PIECE,1,14500,12288,2212,14500,February
6423,VASELINE MEN COOLING LOTION 200ML,PIECE,1,8000,6780,1220,8000,February
6449,VERSMAN SPORTY LOTION 400ML,PIECE,1,15000,12712,2288,15000,February
6452,VESTLINE GARLIC 200G,PIECE,1,4000,3390,610,4000,February
6496,WANDAZ PETROLEUM JELLY 250G,PIECE,1,6000,5085,915,6000,February
6557,WELLICE SHOWER GEL OLIVE OIL 1LTR,PIECE,1,23000,19492,3508,23000,February
6558,WELLICE SHOWER GEL PAPAYAV,PIECE,1,23000,19492,3508,23000,February
6573,WHITE VINEGAR,PIECE,1,2500,2119,381,2500,February
6596,WINE GLASSES 30000,PIECE,1,30000,25424,4576,30000,February
6614,YANAH COFFEE 5OG,PIECE,1,6000,5085,915,6000,February
6618,YARRISON BOXERS 3PCS 22000,PIECE,1,22000,18644,3356,22000,February
6620,YARRISON VESTS 3PCS 27000,PIECE,1,27000,22881,4119,27000,February
6662,ZERO PIMPLE 60G,PIECE,1,4000,3390,610,4000,February
6666,ZESTA 500G,PIECE,1,10500,8898,1602,10500,February
6672,ZESTA MIXED FRUIT JAM,PIECE,1,7500,6356,1144,7500,February
6673,ZESTA MIXED FRUIT JAM 500G,PIECE,1,10500,8898,1602,10500,February
6677,ZESTA TOMATO KETCHUP 700G,PIECE,1,12000,10169,1831,12000,February
6685,ZIKUSOOKA NATURAL CREME 100G,PIECE,1,7500,6356,1144,7500,February
6691,ZORRIK 2 BLADES,PIECE,1,3000,2542,458,3000,February
6704,BERTINI SPANISH OIL 250ML,PIECE,1,18000,15254,2746,18000,February
6731,JAMIES BREND CRUMBS,PIECE,1,7000,5932,1068,7000,February
6752,SMART COLLECTION NO. 467 200ML,PIECE,1,10000,8475,1525,10000,February
6765,BIRTHDAY CANDLE 2K,PIECE,1,2000,1695,305,2000,February
6794,KATOGO 2500,PIECE,1,2700,2288,412,2700,February
6795,KATOGO 2000,PIECE,1,2000,1695,305,2000,February
6817,BALLET BABY SOAP ALOEVERA,PIECE,1,4000,3390,610,4000,February
6886,RWENZORI GREEN TEA 25BAGS,PIECE,1,8000,6780,1220,8000,February
6930,JINYI EAR BUDS 1000,PIECE,1,1000,847,153,1000,February
6978,PUCELLE ELECTRIC SUNRISE 75ML,PIECE,1,5000,4237,763,5000,February
6991,GOLDER WHITE BOARD MARKER ,PIECE,1,1500,1271,229,1500,February
7003,M&G OFFICE SCISSORS 170MM,PIECE,1,4000,3390,610,4000,February
7009,VENUS VITAMIN E 200ML LOTION,PIECE,1,6000,5085,915,6000,February
7017,PRIVE EYE CANDY SPRAY,PIECE,1,11000,9322,1678,11000,February
7037,POTTIES 15000,PIECE,1,15000,12712,2288,15000,February
7043,CHOPPING BOARDS 20000,PIECE,1,20000,16949,3051,20000,February
7063,"AXE ICE CHILL, GOLD, ADRENALIN",PIECE,1,13000,11017,1983,13000,February
7069,QUENCHER FIZTO 300ML,PIECE,1,2000,1695,305,2000,February
7108,RASASI YOYALE BLUE SPRAY ,PIECE,1,12000,10169,1831,12000,February
7118,LEMON CLEAR CREME 250ML,PIECE,1,11000,9322,1678,11000,February
7132,HUGGIES PANTS DRY COMFORT S.6,PIECE,1,32000,27119,4881,32000,February
7145,AMARA RAW SHEA BUTTER JELLY 200G,PIECE,1,7500,6356,1144,7500,February
7172,HIGHLAND TEA 50G,PIECE,1,2500,2119,381,2500,February
7176,JAMIES LIQUID SOAP 20LTR,PIECE,1,30000,25424,4576,30000,February
7208,SPAGHETTI BOLOGNANE 20000,PIECE,1,900,763,137,900,February
7282,Downy vanilla&cashmere musk 880ml,PIECE,1,24000,20339,3661,24000,February
7289,TRIDENT CHEWING GUM,PIECE,1,6000,5085,915,6000,February
7297,CLERE PETROLEUM JELLY 50G,PIECE,1,2000,1695,305,2000,February
7300,AMERICAN CROWN JASMINE AIR.F 300ML,PIECE,1,5500,4661,839,5500,February
7313,SAPIL PINK LACE 15000,PIECE,1,15000,12712,2288,15000,February
7317,PRIVE CRAZY GIRL 250ML,PIECE,1,14000,11864,2136,14000,February
7325,TRIDENT CINNAMON,PIECE,1,6000,5085,915,6000,February
7330,SUMZ GONJA CRISP 400G,PIECE,1,12000,10169,1831,12000,February
7367,D.L SOY NON-DAIRY ICECREAM VANILLA 500ML,PIECE,1,10000,8475,1525,10000,February
7373,VASELINE BLUESEAL BABY 240ML,PIECE,1,9500,8051,1449,9500,February
7393,HIKMA DADDIES 2000,PIECE,1,2000,1695,305,2000,February
7408,DURU LUX SHOWER GEL ORCHID 450ML,PIECE,1,14000,11864,2136,14000,February
7413,AMERICAN CROWN SHOWER GEL COCONUT JOY 1000ML,PIECE,1,18000,15254,2746,18000,February
7419,Sandals,PIECE,1,8002,6781,1221,8002,February
7424,UPSTART MINCED MEAT 1KG,PIECE,1,22000,18644,3356,22000,February
7435,SAVANNAH PUNCH 2LTR 18000,PIECE,1,18000,15254,2746,18000,February
7438,YARRISON KIDS VESTS18000,PIECE,1,18000,15254,2746,18000,February
7466,C.B CARAMEL CRUNCH 500ML,PIECE,1,23000,19492,3508,23000,February
7473,ARTIN MASSAGE OIL OLIVE OIL 1LTR,PIECE,1,13000,11017,1983,13000,February
7485,JAMIES HOTDOG WHOLESALE 3000,PIECE,1,3000,2542,458,3000,February
7488,VERSMAN ACTIVE LOTION 400ML,PIECE,1,17000,14407,2593,17000,February
7492,CS MUKENESNACK 100G 3500,PIECE,1,3500,2966,534,3500,February
7503,ISLAND BREEZE A.F JASMINE 350ML,PIECE,1,7000,5932,1068,7000,February
7506,ISLAND BREEZE A.F SANDALWOOD 350ML,PIECE,1,7000,5932,1068,7000,February
7508,ELEGANT SHOWTIME ANGEL 300ML,PIECE,1,7000,5932,1068,7000,February
7519,VERSMAN MILLIONAIRE MEN 200ML,PIECE,1,9500,8051,1449,9500,February
7527,BALLS 2000,PIECE,1,2000,1695,305,2000,February
7528,BALLS 4000,PIECE,1,4000,3390,610,4000,February
7531,WRITTING BOARD 15000,PIECE,1,15000,12712,2288,15000,February
7532,WRITTING BOARD 20000,PIECE,1,20000,16949,3051,20000,February
7537,TOY GITA 10000,PIECE,1,10000,8475,1525,10000,February
7540,NUMA KARO 2KG 12000,PIECE,1,12000,10169,1831,12000,February
7541,MEN SOCKS 5500,PIECE,1,5500,4661,839,5500,February
7542,TOY 2000,PIECE,1,2000,1695,305,2000,February
7544,DOLLS 5000,PIECE,1,5000,4237,763,5000,February
7548,TOYS 35000,PIECE,1,35000,29661,5339,35000,February
7556,PREMIUM QUALITY,PIECE,1,4000,3390,610,4000,February
7560,SCOURING PAD 2000,PIECE,1,2000,1695,305,2000,February
7567,RIGGS DYNAMO,PIECE,1,16000,13559,2441,16000,February
7574,GULF ORCHID FALLING FLAME,PIECE,1,16000,13559,2441,16000,February
7578,PRETTY STRAWBEERY GEL,PIECE,1,18000,15254,2746,18000,February
7580,COSMO ALOEVERA 100%,PIECE,1,13000,11017,1983,13000,February
7590,WEETABIX SUPER SAVER 850G,PIECE,1,27000,22881,4119,27000,February
7594,DOVE DEEPLY NOURISHING 750ML GEL,PIECE,1,27000,22881,4119,27000,February
7603,DOVE MINERAL TOUCH ROLL 50ML,PIECE,1,11000,9322,1678,11000,February
7625,COSMO GEL BEAUTE ROMANCE 1000ML,PIECE,1,18000,15254,2746,18000,February
7637,NISA ALOEVERA HAND&BODY LOTION 3000,PIECE,1,3000,2542,458,3000,February
7641,COSMO FRENCH LAVNDER GEL 480ML,PIECE,1,12000,10169,1831,12000,February
7652,HOT DOGS 3000,PIECE,1,3000,2542,458,3000,February
7700,JAMIES CAKE@30K,PIECE,1,30000,25424,4576,30000,February
7708,FOGG DERMATOLOGICALLY TESTED ROLL 50ML,PIECE,1,8500,7203,1297,8500,February
7711,RIGGS ARMOUR SPRAY 250ML,PIECE,1,16000,13559,2441,16000,February
7713,REXONA INVISIBLE DRY BLACK+ WHITE 50ML,PIECE,1,10000,8475,1525,10000,February
7716,DOVE RELAXING JASMINE& COCONUT MILK GEL 500ML,PIECE,1,22000,18644,3356,22000,February
7717,DOVE RENEWING GLOW 500ML,PIECE,1,22000,18644,3356,22000,February
7721,SECRETS PANT LINERS PURPLE,PIECE,1,5500,4661,839,5500,February
7724,JAMIES DOUGHNUTS SMALL 6PCS,PIECE,1,3000,2542,458,3000,February
7728,HUGGIES DRY COMFORT PANTS SZ6 48,PIECE,1,60000,50847,9153,60000,February
7738,CUP GIFT 12000,PIECE,1,12000,10169,1831,12000,February
7744,TOY CAR 18000,PIECE,1,18000,15254,2746,18000,February
7747,AI LISHA CHOCOLATE 25000,PIECE,1,25000,21186,3814,25000,February
7756,DOLL 1000,PIECE,1,1000,847,153,1000,February
7762,PRINGLES PAPRIKA,PIECE,1,5500,4661,839,5500,February
7765,PRINGLES PAPRIKA 165G,PIECE,1,12000,10169,1831,12000,February
7780,VENUS MOROCCAN ARGAN OIL 200ML,PIECE,1,6000,5085,915,6000,February
7785,JINBO NOTEBOOK 15000,PIECE,1,15000,12712,2288,15000,February
16,7DAYS ANTIBACTERIAL WIPES,PIECE,2,5000,8475,1525,10000,February
83,ALWAYS COTTON MAXITHICK,PIECE,2,3250,5508,992,6500,February
95,ALWAYS VALUE PACK LONG,PIECE,2,6500,11017,1983,13000,February
101,AMARA BODY MILK 200ML,PIECE,2,6000,10169,1831,12000,February
102,AMARA BODY MILK 400ML,PIECE,2,8500,14407,2593,17000,February
112,AMARA MEN 200ML,PIECE,2,6000,10169,1831,12000,February
123,AMERICAN GARDEN BBQ SAUCE 510G,PIECE,2,17000,28814,5186,34000,February
131,AMERICAN GARDEN MUSTARD 14OZ,PIECE,2,13000,22034,3966,26000,February
222,ARMAF CLUB DE NUIT WOMEN MIST,PIECE,2,16000,27119,4881,32000,February
275,ART PENCILS 4B,PIECE,2,1000,1695,305,2000,February
276,ART PENCILS 5B,PIECE,2,1000,1695,305,2000,February
331,AXE DARK TEMPTATION,PIECE,2,12000,20339,3661,24000,February
494,BABY WIPES NO 4,PIECE,2,6000,10169,1831,12000,February
526,BALLET ALOE VERA 120MLS,PIECE,2,5000,8475,1525,10000,February
528,BALLET BABY JELLY 120MLS,PIECE,2,5000,8475,1525,10000,February
532,BALLET BABY LOTION 240ML,PIECE,2,12000,20339,3661,24000,February
543,BALLET SHEA BUTTER SOAP,PIECE,2,3500,5932,1068,7000,February
615,BED SHEET 15000,PIECE,2,15000,25424,4576,30000,February
717,BLUE BAND LOW FAT,PIECE,2,6500,11017,1983,13000,February
725,BLUE LAGOON PASSION SPLASH,PIECE,2,17000,28814,5186,34000,February
767,BOTTLES 10000,PIECE,2,10000,16949,3051,20000,February
833,BRITANIA SHORTCAKE BISCUITS 1KG,PIECE,2,20000,33898,6102,40000,February
867,BUCKET 8000,PIECE,2,8000,13559,2441,16000,February
886,BUILDING BLOCKS 25000 GOOD PARTNER,PIECE,2,25000,42373,7627,50000,February
889,BUL STAR SOAP 600G,PIECE,2,4000,6780,1220,8000,February
895,C A PURE RED BODY SPRAY,PIECE,2,10000,16949,3051,20000,February
907,C.B DOULBLES CHOCOLATE,PIECE,2,3000,5085,915,6000,February
917,C.B ROYAL MANGO 120ML,PIECE,2,2500,4237,763,5000,February
932,CADBURY COCOA 200G,PIECE,2,15000,25424,4576,30000,February
933,CADBURY COCOA 90G,PIECE,2,9000,15254,2746,18000,February
937,CADBURY DAIRY MILK FRUIT&NUT 150G,PIECE,2,13000,22034,3966,26000,February
949,CADBURY RUM&RAISIN 80G,PIECE,2,8000,13559,2441,16000,February
950,CADBURY TOP DECK 150G,PIECE,2,13000,22034,3966,26000,February
983,CAMERA TOYS 2000,PIECE,2,2000,3390,610,4000,February
1012,CAR TOYS 4000,PIECE,2,4000,6780,1220,8000,February
1017,CARAMBOLA BLACK SPOT,PIECE,2,6000,10169,1831,12000,February
1050,CB LICKS MANGO,PIECE,2,2000,3390,610,4000,February
1052,CB LICKS ORANGE,PIECE,2,2000,3390,610,4000,February
1112,CHERRY COTTON BUDS 150,PIECE,2,3000,5085,915,6000,February
1164,CLASSIC 96 PAGES,PIECE,2,2000,3390,610,4000,February
1170,CLASSIC LEADER BOOKS 200PGS,PIECE,2,2000,3390,610,4000,February
1185,CLERE ALOEVERA 250G,PIECE,2,5000,8475,1525,10000,February
1187,CLERE BABY JELLY 250G,PIECE,2,5000,8475,1525,10000,February
1191,CLERE MEN ICE 100G,PIECE,2,2000,3390,610,4000,February
1202,CLIMAX TROPICAL FRUITS 50G,PIECE,2,2500,4237,763,5000,February
1264,COLGATE NATURAL EXTRACT 75MLS,PIECE,2,9000,15254,2746,18000,February
1271,COLLAGEN MAKE-UP WIPES,PIECE,2,3500,5932,1068,7000,February
1279,COMB WITH MIRROR 1500,PIECE,2,1500,2542,458,3000,February
1290,COMPO PENS,PIECE,2,3000,5085,915,6000,February
1291,COMSOFT FACIAL WIPES 1000,PIECE,2,1000,1695,305,2000,February
1343,COW & GATE 1 400GM,PIECE,2,44000,74576,13424,88000,February
1348,COW&GATE 3 NUTRIJUNIOR,PIECE,2,44000,74576,13424,88000,February
1349,COWBOY 500G,PIECE,2,7500,12712,2288,15000,February
1373,CUPS 1000,PIECE,2,1000,1695,305,2000,February
1393,CUSSONS BABY OIL PINK 200MLS,PIECE,2,16000,27119,4881,32000,February
1413,CUTTERS 1500,PIECE,2,1500,2542,458,3000,February
1487,DATES 5000,PIECE,2,5500,9322,1678,11000,February
1540,DETTOL ACTIVE 175G,PIECE,2,6500,11017,1983,13000,February
1553,DETTOL LIQUID 250 MLS,PIECE,2,15000,25424,4576,30000,February
1569,DIANA LOTION 30ML,PIECE,2,4000,6780,1220,8000,February
1595,DISPOSABLE FORKS 2500,PIECE,2,4000,6780,1220,8000,February
1643,DOLL 4000,PIECE,2,4000,6780,1220,8000,February
1703,DOVE GLOWINGRITUAL 750ML,PIECE,2,27000,45763,8237,54000,February
1752,DOWNY FEEL RELAXED 280ML,PIECE,2,11000,18644,3356,22000,February
1754,DOWNY VALLEY DEW 300ML,PIECE,2,11000,18644,3356,22000,February
1770,DURACELL AAA,PIECE,2,7000,11864,2136,14000,February
1771,DURACELL AAA PLUS,PIECE,2,8000,13559,2441,16000,February
1774,DURU DOLCE ALMOND,PIECE,2,4500,7627,1373,9000,February
1780,DURU GLYCERINE,PIECE,2,5000,8475,1525,10000,February
1813,EAGLE DISPOSABLE FORKS AND SPOONS,PIECE,2,4000,6780,1220,8000,February
1820,EAST AFRICAN ORGANIC HONEY 450G,PIECE,2,12000,20339,3661,24000,February
1874,ELEGANT FLORAL LEMON A.F,PIECE,2,7000,11864,2136,14000,February
1908,ENVELOPE A4,PIECE,2,500,847,153,1000,February
1973,FA AQUA 50MLS,PIECE,2,6500,11017,1983,13000,February
1974,FA CARRIEAN LEMON,PIECE,2,6500,11017,1983,13000,February
1978,FA FLORAL PROTECT 50MLS,PIECE,2,6000,10169,1831,12000,February
1983,FA MEN ATTRACTION FORCE,PIECE,2,6500,11017,1983,13000,February
2047,FAX LEMON FRESH,PIECE,2,8000,13559,2441,16000,February
2048,FAX ROSE,PIECE,2,8000,13559,2441,16000,February
2061,FEATHERS PADS REGULAR,PIECE,2,3000,5085,915,6000,February
2064,FEELINGS SPRAY,PIECE,2,12000,20339,3661,24000,February
2073,FIDODIDO CHOCO-VANI 500ML,PIECE,2,5000,8475,1525,10000,February
2106,FLASKS 3.2LTRS 35000,PIECE,2,32500,55085,9915,65000,February
2117,FOGG ABSOLUTE BODY SPRAY,PIECE,2,18000,30508,5492,36000,February
2122,FOGG DYNAMIC SPRAY,PIECE,2,18000,30508,5492,36000,February
2131,FOGG MASTER OAK,PIECE,2,18500,31356,5644,37000,February
2132,FOGG MASTER PINE,PIECE,2,18500,31356,5644,37000,February
2170,FORKS 5000,PIECE,2,5000,8475,1525,10000,February
2181,FORTUNE SPAGHETTI 450,PIECE,2,3500,5932,1068,7000,February
2294,GEISHA MORINGA OIL 125G,PIECE,2,4000,6780,1220,8000,February
2298,GEISHA ROSE&HONEY 225G,PIECE,2,4000,6780,1220,8000,February
2354,GLASSES 15000,PIECE,2,15000,25424,4576,30000,February
2359,GLASSES 5000 PCS,PIECE,2,5000,8475,1525,10000,February
2393,GOLDEN CLING FILM 25000,PIECE,2,25000,42373,7627,50000,February
2474,GUN TOYS 8000,PIECE,2,8000,13559,2441,16000,February
2515,HARPIC CITRUS,PIECE,2,15000,25424,4576,30000,February
2530,HEINZ KETCHUP 300G,PIECE,2,8000,13559,2441,16000,February
2660,IMPERIAL LEATHER MEN INTENSE COOL LOTION 200ML,PIECE,2,8000,13559,2441,16000,February
2714,JAGO SCRUB 250G,PIECE,2,7500,12712,2288,15000,February
2730,JAMIES CROCKDILE BREAD 1KG,PIECE,2,6000,10169,1831,12000,February
2769,JEE NAIL REMOVER,PIECE,2,1500,2542,458,3000,February
2943,KABODY QUICK PORRIDGE1KG,PIECE,2,6000,10169,1831,12000,February
2944,KABODY RICE FLOUR 1KG,PIECE,2,6500,11017,1983,13000,February
2947,KABODY WHITE OATS WITH RICE,PIECE,2,6000,10169,1831,12000,February
2948,KADIO CALCULATOR,PIECE,2,15000,25424,4576,30000,February
3013,KENT OLIVE OIL EXTRA VIRGIN 500ML,PIECE,2,32000,54237,9763,64000,February
3052,KIBIMBA RICE 2KG,PIECE,2,15500,26271,4729,31000,February
3071,KIDS BOXERS 6000,PIECE,2,6000,10169,1831,12000,February
3079,KIDS PATRAS 6000,PIECE,2,6000,10169,1831,12000,February
3106,KINKIZI TEA 500G,PIECE,2,13500,22881,4119,27000,February
3114,KIRUNGI KITUZI,PIECE,2,1000,1695,305,2000,February
3140,KIWI POLISH 12G,PIECE,2,2500,4237,763,5000,February
3154,KNICKERS 5000,PIECE,2,5000,8475,1525,10000,February
3159,KNIFE 3000,PIECE,2,3000,5085,915,6000,February
3221,KRYSTAL WATER 500ML,PIECE,2,1000,1695,305,2000,February
3246,LA BELLE JELLY 250G,PIECE,2,6000,10169,1831,12000,February
3276,LANZO BUBBLY SOAP,PIECE,2,3500,5932,1068,7000,February
3277,LANZO COCONUT SHEA SOAP,PIECE,2,3500,5932,1068,7000,February
3278,LANZO MENTHOL SOAP,PIECE,2,4500,7627,1373,9000,February
3402,LONDON FACIAL WIPES,PIECE,2,3500,5932,1068,7000,February
3405,LONGHORN ATLAS,PIECE,2,40000,67797,12203,80000,February
3411,LOTUS TOOTHBRUSH EXPERT,PIECE,2,4000,6780,1220,8000,February
3417,LOVE BEARS,PIECE,2,15000,25424,4576,30000,February
3456,LUX VESTS,PIECE,2,16000,27119,4881,32000,February
3471,M&G HEART PEN AB87575,PIECE,2,2000,3390,610,4000,February
3525,MACDO TOMATO SAUCE SACHETS,PIECE,2,13000,22034,3966,26000,February
3634,MELAMINE PLATES 5000,PIECE,2,5000,8475,1525,10000,February
3671,MENTHO PLUS,PIECE,2,2000,3390,610,4000,February
3875,MOVIT BABYJELLY 50g,PIECE,2,1500,2542,458,3000,February
3892,MOVIT FAMILY SOAP COCONUT 230G,PIECE,2,4000,6780,1220,8000,February
3897,MOVIT FAMILY SOAP V.P ROSE,PIECE,2,7000,11864,2136,14000,February
3906,MOVIT HERBAL JELLY 120G,PIECE,2,3500,5932,1068,7000,February
3913,MOVIT JELLY 200G,PIECE,2,5000,8475,1525,10000,February
3918,MOVIT LEAVE-IN 100ML,PIECE,2,3500,5932,1068,7000,February
3938,MR. GREEN SCOURING PADS,PIECE,2,5000,8475,1525,10000,February
3954,MUKWANO OIL 1LTR JERRYCAN,PIECE,2,10000,16949,3051,20000,February
3957,MUKWANO STAR WHITE SOAP 1KG,PIECE,2,7000,11864,2136,14000,February
3994,NACET 500 PCS,PIECE,2,500,847,153,1000,February
4019,NASA HAIR REMOVAL LEMON 50ML,PIECE,2,7000,11864,2136,14000,February
4027,NATARAJ SETS,PIECE,2,10000,16949,3051,20000,February
4054,NEW FASHION RUBBER BANDS 1500,PIECE,2,1500,2542,458,3000,February
4120,NISA HAIR REMOVAL LEMON 100ML,PIECE,2,10000,16949,3051,20000,February
4124,NISA NORMAL SKIN,PIECE,2,5000,8475,1525,10000,February
4125,NISA ROSE HAIR REMOVAL CREAM 20ML,PIECE,2,2000,3390,610,4000,February
4126,NISA SOAP DRY SKIN,PIECE,2,5000,8475,1525,10000,February
4127,NISA SOAP OILY SKIN,PIECE,2,5000,8475,1525,10000,February
4140,NIVEA COOL KICK ROLLON,PIECE,2,11000,18644,3356,22000,February
4141,NIVEA DEEP AMAZONIA,PIECE,2,11000,18644,3356,22000,February
4142,NIVEA DRY COMFORT ROLLON,PIECE,2,11000,18644,3356,22000,February
4170,NIVEA MEN REVITALIZING 200ML,PIECE,2,15000,25424,4576,30000,February
4172,NIVEA NOURISHING COCOA 200ML,PIECE,2,15000,25424,4576,30000,February
4214,NTALE 100G,PIECE,2,4000,6780,1220,8000,February
4224,NUMA SOYARICE WITH ENKEJJE 1KG,PIECE,2,7500,12712,2288,15000,February
4325,OLIVE OIL BODY LOTION 400ML,PIECE,2,22000,37288,6712,44000,February
4336,OMO BLEACH LEMON,PIECE,2,8000,13559,2441,16000,February
4337,OMO BLEACH MULTI -PURPOSE,PIECE,2,4000,6780,1220,8000,February
4340,OMO BLEACH REGULAR 250ML,PIECE,2,3500,5932,1068,7000,February
4365,ORCHID VALLEY APPLE 1LTR,PIECE,2,7500,12712,2288,15000,February
4431,PADLOCK 3500,PIECE,2,3500,5932,1068,7000,February
4432,PADLOCK 4000,PIECE,2,4000,6780,1220,8000,February
4434,PADLOCK 6000,PIECE,2,6000,10169,1831,12000,February
4447,PAMPER 3 L.C PANTS,PIECE,2,9500,16102,2898,19000,February
4500,PASSION WOODY OUD,PIECE,2,17000,28814,5186,34000,February
4517,PELIKAN RUBBERS 1000,PIECE,2,1000,1695,305,2000,February
4546,PEPTANG KETCHUP 400G,PIECE,2,7500,12712,2288,15000,February
4587,PICFARE HANDWRITING BOOKS,PIECE,2,2000,3390,610,4000,February
4665,POPPER 4500,PIECE,2,4500,7627,1373,9000,February
4701,PRADIP CHOCOLATE ESSENCE,PIECE,2,5500,9322,1678,11000,February
4706,PRADIP VANILLA ESSENCE,PIECE,2,5000,8475,1525,10000,February
4716,PRESTIGE 1KG,PIECE,2,14000,23729,4271,28000,February
4742,PRINGLES ORIGINAL 165G BURSTING,PIECE,2,11500,19492,3508,23000,February
4767,PROTEX CLASSIC 150G,PIECE,2,6500,11017,1983,13000,February
4787,PUCELLE FOR MY HEART,PIECE,2,7500,12712,2288,15000,February
4791,PUCELLE JOYFUL SUMMER,PIECE,2,5000,8475,1525,10000,February
4837,RADIANT HAIR DYE 15ML,PIECE,2,1500,2542,458,3000,February
4841,RADIANT OLIVE OIL HAIR SPRAY 100ML,PIECE,2,6500,11017,1983,13000,February
4843,RADIANT OLIVE OIL SPRAY 250MLS,PIECE,2,11000,18644,3356,22000,February
4898,RED COCK BASMATI 1KG,PIECE,2,14000,23729,4271,28000,February
4933,RIBBONS 1000,PIECE,2,1000,1695,305,2000,February
4934,RIBBONS 2500,PIECE,2,2500,4237,763,5000,February
4962,RIHAM SHORTCAKE BISCUITS TIN,PIECE,2,18000,30508,5492,36000,February
4976,RIOLA LUNCH BOX,PIECE,2,6000,10169,1831,12000,February
5005,ROSE PENS,PIECE,2,2000,3390,610,4000,February
5073,SAMONA EGG YELLOW SHAMPO1LTR,PIECE,2,6000,10169,1831,12000,February
5087,SANDALS 6000,PIECE,2,6000,10169,1831,12000,February
5091,SANTA LUCIA 450G,PIECE,2,5000,8475,1525,10000,February
5143,SAVANNAH COCOPINE 3LTR,PIECE,2,22000,37288,6712,44000,February
5146,SAVANNAH MANGO 2LTRS,PIECE,2,18000,30508,5492,36000,February
5147,SAVANNAH MANGO 3LTR,PIECE,2,22000,37288,6712,44000,February
5149,SAVANNAH ORANGE 2LTRS,PIECE,2,18000,30508,5492,36000,February
5168,SCHOOL SOCKS BLUE&WHITE ORIGINAL 7500,PIECE,2,7500,12712,2288,15000,February
5170,SCHOOL SOCKS RED/GREEN YELLOW,PIECE,2,4000,6780,1220,8000,February
5172,SCHOOL SOCKS WHITE&MAROON,PIECE,2,4000,6780,1220,8000,February
5196,SCRUBING BRUSHES WHITE 9000,PIECE,2,9000,15254,2746,18000,February
5250,SHADES 6000,PIECE,2,6000,10169,1831,12000,February
5268,SHENKE LOTUS SCENT,PIECE,2,8000,13559,2441,16000,February
5269,SHENKE MOSQUITO COIL,PIECE,2,6000,10169,1831,12000,February
5282,SHIVA HONEY 400G,PIECE,2,13000,22034,3966,26000,February
5303,SHOWER TO SHOWER HAPPY DAYS,PIECE,2,6000,10169,1831,12000,February
5307,SHOWER TO SHOWER SPRING RAIN,PIECE,2,6000,10169,1831,12000,February
5332,SHUYA 280MM,PIECE,2,6000,10169,1831,12000,February
5389,SKALA CARROT BODY CREAM,PIECE,2,4000,6780,1220,8000,February
5391,SKALA FOR MEN JELLY,PIECE,2,4000,6780,1220,8000,February
5392,SKALA FOR MEN LOTION 400ML,PIECE,2,6000,10169,1831,12000,February
5404,SKIN CARE 50G,PIECE,2,2000,3390,610,4000,February
5425,SKINDOCTOR HERBAL 120G,PIECE,2,3500,5932,1068,7000,February
5426,SKINDOCTOR HERBAL 60G,PIECE,2,2000,3390,610,4000,February
5482,SNOW SPRAYS 4500,PIECE,2,5000,8475,1525,10000,February
5485,SO SOFT KITCHEN TOWEL,PIECE,2,8000,13559,2441,16000,February
5527,SOFTCARE BABY PANTS L40,PIECE,2,27000,45763,8237,54000,February
5557,SOSOFT BABY 2.5L,PIECE,2,29000,49153,8847,58000,February
5569,SOY SAUCE LIGHT 500G,PIECE,2,10000,16949,3051,20000,February
5658,STA-SOFT SPRING FRESH 750MLS,PIECE,2,12000,20339,3661,24000,February
5693,STRAWBERRY PRADIP COLORED,PIECE,2,5000,8475,1525,10000,February
5696,STRAWS 2500,PIECE,2,2500,4237,763,5000,February
5733,SUMZ CHOCOLATE COOKIES 200G,PIECE,2,4000,6780,1220,8000,February
5752,SUMZ PEANUT BUTTER 800G,PIECE,2,14000,23729,4271,28000,February
5771,SUN SIP MANGO 2LTR,PIECE,2,11000,18644,3356,22000,February
5772,SUN SIP PASSION 2LTR,PIECE,2,11000,18644,3356,22000,February
5774,SUN SIP PASSION 5LTRS,PIECE,2,24000,40678,7322,48000,February
5784,SUNLIGHT LAVENDER 1KG,PIECE,2,11000,18644,3356,22000,February
5785,SUNLIGHT LAVENDER 3.5KG,PIECE,2,34000,57627,10373,68000,February
5812,SUN--SIP APPLE 2LTR,PIECE,2,11000,18644,3356,22000,February
5814,SUNSIP APPLE 5LTR,PIECE,2,24000,40678,7322,48000,February
5818,SUNSIP MANGO 3LTRS,PIECE,2,16000,27119,4881,32000,February
5823,SUNSIP STRAWBERRY 5LTRS,PIECE,2,24000,40678,7322,48000,February
5892,SWEETY FITPANTZ M9,PIECE,2,9000,15254,2746,18000,February
5903,SWT BASMATI 1KG BLUE,PIECE,2,15000,25424,4576,30000,February
6012,TIGER HEAD BIG,PIECE,2,3000,5085,915,6000,February
6051,TOILET BRUSHES METTALIC,PIECE,2,8000,13559,2441,16000,February
6117,TORCH DH-168 2500,PIECE,2,2500,4237,763,5000,February
6127,TORCHES 1500,PIECE,2,1500,2542,458,3000,February
6171,TRI-CIRCLE 262,PIECE,2,6000,10169,1831,12000,February
6185,TROPICAL HEAT BEEF MASALA 100G,PIECE,2,5000,8475,1525,10000,February
6186,TROPICAL HEAT BLACK PEPPER 100G,PIECE,2,8500,14407,2593,17000,February
6192,TROPICAL HEAT CORIANDER 50G,PIECE,2,4500,7627,1373,9000,February
6198,TROPICAL HEAT GARAM MASALA 50G,PIECE,2,5000,8475,1525,10000,February
6204,TROPICAL HEAT MIXED HERBS,PIECE,2,4000,6780,1220,8000,February
6207,TROPICAL HEAT OREGANO 20G,PIECE,2,4000,6780,1220,8000,February
6208,TROPICAL HEAT PAPRIKA,PIECE,2,3500,5932,1068,7000,February
6214,TROPICAL HEAT ROSEMARYLEANES,PIECE,2,3500,5932,1068,7000,February
6288,U-FRESH MANGO,PIECE,2,700,1186,214,1400,February
6318,UMBRELLAS 8000,PIECE,2,8000,13559,2441,16000,February
6340,USOFIA 5000,PIECE,2,5000,8475,1525,10000,February
6401,VASELINE BLUESEAL COCOA BUTTER250ML,PIECE,2,9500,16102,2898,19000,February
6406,VASELINE BLUESEAL ORIGINAL 250ML,PIECE,2,9500,16102,2898,19000,February
6424,VASELINE MEN EXTRA HYDRATION,PIECE,2,14500,24576,4424,29000,February
6443,VERSMAN COOL LOTION 200ML,PIECE,2,9500,16102,2898,19000,February
6517,WATER GAMES 2000,PIECE,2,2000,3390,610,4000,February
6543,WEETABIX CORNFLAKES 250G,PIECE,2,15000,25424,4576,30000,February
6548,WEETABIX OATIBIX 1KG,PIECE,2,18500,31356,5644,37000,February
6581,WHITEDENT HERBAL 250G,PIECE,2,8000,13559,2441,16000,February
6619,YARRISON UNDER SHIRT 30000,PIECE,2,35000,59322,10678,70000,February
6675,ZESTA STRAWBERRY JAM 300GM,PIECE,2,7500,12712,2288,15000,February
6724,US MUSTARD 227G-8000,PIECE,2,8000,13559,2441,16000,February
6770,SUNLIGHT SPRING 2KG,PIECE,2,20000,33898,6102,40000,February
6771,SUNLIGHT LAVENDER 2KG,PIECE,2,20000,33898,6102,40000,February
6806,KIWI DARKTAN LEATHER 100ML,PIECE,2,7000,11864,2136,14000,February
6851,PIZZA 16'' BEEF,PIECE,2,35000,59322,10678,70000,February
6885,JAGO SCRUB 110G,PIECE,2,4000,6780,1220,8000,February
6942,CADBURY WHOLENUT CHOCOLATE 150G,PIECE,2,13000,22034,3966,26000,February
6948,NIVEA DOULBLE EFFECT 48HRS,PIECE,2,11000,18644,3356,22000,February
6959,S CONTROL HAIR TEXTURIZER 125ML,PIECE,2,5000,8475,1525,10000,February
6994,COLOUR PENCILS 3000,PIECE,2,3000,5085,915,6000,February
7036,SOAP DISH 3500,PIECE,2,3500,5932,1068,7000,February
7053,TREET SHAVER 1000,PIECE,2,1000,1695,305,2000,February
7070,QUENCHER ORANGE 300ML,PIECE,2,2000,3390,610,4000,February
7071,QUENCHER LEMON TREAT 300ML,PIECE,2,2000,3390,610,4000,February
7089,JAMIES WHITE SALT BREAD 500G,PIECE,2,3000,5085,915,6000,February
7140,SUMZ CORN CRAX 350G,PIECE,2,5000,8475,1525,10000,February
7153,INNOCENCE BODY SPRAY ,PIECE,2,12000,20339,3661,24000,February
7174,JAMIES LIQUID SOAP 5LTR 10000,PIECE,2,10000,16949,3051,20000,February
7175,JAMIES LIQUID SOAP 3LTR,PIECE,2,3000,5085,915,6000,February
7304,AMERICA CROWN SANDALWOOD,PIECE,2,5500,9322,1678,11000,February
7337,LUX PREMIUMS MENS UNDER WEAR,PIECE,2,16000,27119,4881,32000,February
7339,SOFTCARE GOLD S48,PIECE,2,25000,42373,7627,50000,February
7349,BODY SCRUBBER GLOVE,PIECE,2,2500,4237,763,5000,February
7394,HIKMA G.NUTS 3000,PIECE,2,3000,5085,915,6000,February
7411,PAMPERS PANTS 6,PIECE,2,40000,67797,12203,80000,February
7425,JAMIES QUEEN CAKES WHOLESALE 2500,PIECE,2,2500,4237,763,5000,February
7449,ROYALE FEMME 12000,PIECE,2,12000,20339,3661,24000,February
7450,DOVE INVISIBLE DRY ROLL ON 10000,PIECE,2,10500,17797,3203,21000,February
7467,C.B SALTED CARAMEL ALMOND 500ML,PIECE,2,23000,38983,7017,46000,February
7476,MENTOS MINT 29G,PIECE,2,2500,4237,763,5000,February
7504,ISLAND BREEZE A.F LAVENDER 350ML,PIECE,2,7000,11864,2136,14000,February
7507,ISLAND BREEZE A.F BLUE OCEAN 500ML,PIECE,2,7000,11864,2136,14000,February
7520,VERSMAN MILLIONAIRE MEN 400ML,PIECE,2,15000,25424,4576,30000,February
7525,KIDS GLASSES 2500,PIECE,2,2250,3814,686,4500,February
7546,DOLLS 15000,PIECE,2,15000,25424,4576,30000,February
7568,RIGGS VOYAGE,PIECE,2,16000,27119,4881,32000,February
7598,NISA ALOEVERA LOTION 200ML,PIECE,2,8000,13559,2441,16000,February
7599,NISA LAVENDER LOTION 200ML,PIECE,2,8000,13559,2441,16000,February
7607,LABELLE BABY JELLY 450G,PIECE,2,10000,16949,3051,20000,February
7622,SAVANNAH LEMON 2LTRS,PIECE,2,18000,30508,5492,36000,February
7623,BECCA BOOK 2Q 3500,PIECE,2,3500,5932,1068,7000,February
7628,NIVEA MEN FRESH ACTIVE 150ML,PIECE,2,16000,27119,4881,32000,February
7629,TROPIKAL FRUIT COCKTAIL FRSHENER 300ML,PIECE,2,12000,20339,3661,24000,February
7633,CLERE COCOA BUTTER 400ML,PIECE,2,8000,13559,2441,16000,February
7636,NISA LAVENDER HAND&BODY LOTION 50ML,PIECE,2,3000,5085,915,6000,February
7644,FANEST CHICKEN SAUSAGES 500G,PIECE,2,20000,33898,6102,40000,February
7645,SOFTCARE GOLD XL36,PIECE,2,25000,42373,7627,50000,February
7667,SCHOOL SOCKS WHITE 6000,PIECE,2,6000,10169,1831,12000,February
7702,SUMZ FRIED PEAS CHILLI 80G,PIECE,2,2500,4237,763,5000,February
7712,REXONA COTTON DRY ROLL 50ML,PIECE,2,9995,16941,3049,19990,February
7715,REXONA PASSION 50ML,PIECE,2,10000,16949,3051,20000,February
7718,BERTINI OLIVE OIL 100ML,PIECE,2,18000,30508,5492,36000,February
7734,JAMIES MARBLE CAKE 500G,PIECE,2,8000,16000,0,16000,February
7737,CUP& HANKIE GIFT 15000,PIECE,2,15000,25424,4576,30000,February
7739,GLASS& BEAR GIFT15000,PIECE,2,15000,25424,4576,30000,February
7742,RIHAM MILK&HONEY,PIECE,2,11000,18644,3356,22000,February
7766,JAMIES CAKE 45000,PIECE,2,45000,76271,13729,90000,February
7779,DAIMA MANGO 500ML,PIECE,2,3000,5085,915,6000,February
3,10LTR JERRICAN 6000,PIECE,3,6500,16525,2975,19500,February
18,7DAYS PANT LINERS,PIECE,3,4000,10169,1831,12000,February
88,ALWAYS LONG,PIECE,3,3500,8898,1602,10500,February
103,AMARA COCOA BUTTER 200ML,PIECE,3,6000,15254,2746,18000,February
105,AMARA COCOA BUTTER LOTION 400ML,PIECE,3,8500,21610,3890,25500,February
113,AMARA MEN 400ML,PIECE,3,8500,21610,3890,25500,February
114,AMARA MEN COOLING,PIECE,3,6000,15254,2746,18000,February
147,AMLA OIL WITH COCONUT,PIECE,3,10000,25424,4576,30000,February
175,ANTOL SOAP 75G,PIECE,3,3000,7627,1373,9000,February
186,APTAMIL 1 400G,PIECE,3,52000,132203,23797,156000,February
344,AZAM BAKING FLOUR 2KG,PIECE,3,8500,21610,3890,25500,February
383,BABY BOTTLE 092 6000,PIECE,3,6000,15254,2746,18000,February
390,BABY BOTTLES JIAAI,PIECE,3,5000,12712,2288,15000,February
429,BABY FEEDING BOTTLES 3000,PIECE,3,3000,7627,1373,9000,February
440,BABY JUNIOR 50G,PIECE,3,1500,3814,686,4500,February
523,BALLET ACTIVE VITAMIN 120MLS,PIECE,3,5000,12712,2288,15000,February
525,BALLET ALMOMD OIL 125ML,PIECE,3,9500,24153,4347,28500,February
537,BALLET BUTTER BLEND 120MLS,PIECE,3,4500,11441,2059,13500,February
538,BALLET BUTTER BLEND 300ML,PIECE,3,9500,24153,4347,28500,February
614,BECCA COUNTERBOOKS 6000,PIECE,3,5000,12712,2288,15000,February
659,BIKERS ST MICHAEL 10000,PIECE,3,10000,25424,4576,30000,February
667,BIRTHDAY CROWNS 5000,PIECE,3,5000,12712,2288,15000,February
692,BIYINZINKA LIVER 500G,PIECE,3,6000,15254,2746,18000,February
729,BLUE TOILET BLOCKS DOUBLE,PIECE,3,5000,12712,2288,15000,February
765,BOTTLES 12000,PIECE,3,12000,30508,5492,36000,February
808,BREAD CRUMBS 7000,PIECE,3,7000,17797,3203,21000,February
862,BUCKET 11000,PIECE,3,11000,27966,5034,33000,February
866,BUCKET 7000,PIECE,3,7000,17797,3203,21000,February
995,CANDLES 300,PIECE,3,300,763,137,900,February
1046,CB CLASSIC VANILLA 120MLS,PIECE,3,2500,6356,1144,7500,February
1053,CB MAGIC S-BERRY 200MLS,PIECE,3,4000,10169,1831,12000,February
1066,CERELAC 12MONTHS 400G,PIECE,3,27000,68644,12356,81000,February
1068,CERELAC 7MONTHS MIXEDFRUITS,PIECE,3,27000,68644,12356,81000,February
1097,CHAPA NYOTA BROWN 600G,PIECE,3,4000,10169,1831,12000,February
1197,CLIMAX CITRUS FRUITS 170G,PIECE,3,6000,15254,2746,18000,February
1239,COCOPULP CREME 100ML,PIECE,3,7500,19068,3432,22500,February
1257,COLGATE MAX FRESH 65G,PIECE,3,3500,8898,1602,10500,February
1268,COLGATE TOTAL12 75MLS,PIECE,3,11000,27966,5034,33000,February
1324,CORTEZ HERBAL MOUTH FRESHNER,PIECE,3,7500,19068,3432,22500,February
1357,CREAMBELL STRAWBERRY VAN 500ML,PIECE,3,10000,25424,4576,30000,February
1358,CREAMBELL STRAW-VAN 120ML,PIECE,3,2500,6356,1144,7500,February
1379,CUPS 6000,PIECE,3,6000,15254,2746,18000,February
1384,CUPS STALLION 3000,PIECE,3,3000,7627,1373,9000,February
1434,D.L PINACOLANDA 500ML,PIECE,3,10000,25424,4576,30000,February
1466,DAIRYLAND PEACH MELBA 500ML,PIECE,3,10000,25424,4576,30000,February
1468,DAITY AMIRALDOUBLE CHOCOLATE,PIECE,3,4500,11441,2059,13500,February
1532,DERBY CLUB HOUSE MIST,PIECE,3,16000,40678,7322,48000,February
1544,DETTOL EVENTONE 175G,PIECE,3,6500,16525,2975,19500,February
1552,DETTOL JUNIORS GLYCERINE SOAP 100G,PIECE,3,4500,11441,2059,13500,February
1560,DETTOL SKINCARE 175G,PIECE,3,6500,16525,2975,19500,February
1653,DOLLS 2000,PIECE,3,2000,5085,915,6000,February
1666,DOMS COLOUR PENCILS LONG,PIECE,3,7000,17797,3203,21000,February
1751,DOWNY FEEL LUXURIOUS 280ML,PIECE,3,11000,27966,5034,33000,February
1773,DURU CUCUMBER,PIECE,3,4500,11441,2059,13500,February
1804,E.A HONEY 1LTR,PIECE,3,29000,73729,13271,87000,February
1816,EAST AFRICAN HONEY 350G,PIECE,3,13000,33051,5949,39000,February
1825,ECO STYLING GEL 236ML,PIECE,3,11000,27966,5034,33000,February
1962,F.D UNSALTED BUTTER 250G,PIECE,3,11000,27966,5034,33000,February
1982,FA INVISIBLE POWER,PIECE,3,6500,16525,2975,19500,February
1992,FA SPORT RECHARGE 72H,PIECE,3,6167,15678,2822,18500,February
2040,FAX ARGAN&MILK 225G,PIECE,3,4000,10169,1831,12000,February
2044,FAX LAVENDER,PIECE,3,8000,20339,3661,24000,February
2118,FOGG ABSOLUTE ROLLON,PIECE,3,8500,21610,3890,25500,February
2128,FOGG MARCO SPRAY,PIECE,3,18000,45763,8237,54000,February
2140,FOGG ULTIMATE ROLLON,PIECE,3,8500,21610,3890,25500,February
2154,FOOD COLOUR ORANGE,PIECE,3,1000,2542,458,3000,February
2176,FORTUNE GOLD 1LTR,PIECE,3,10000,25424,4576,30000,February
2307,GENIUS SHORTHAND BOOK,PIECE,3,2000,5085,915,6000,February
2313,GIFT BAG 3500,PIECE,3,3500,8898,1602,10500,February
2408,GOLDEN SPEED YEAST,PIECE,3,13000,33051,5949,39000,February
2454,GREEN POLYTHENE,PIECE,3,300,763,137,900,February
2477,HABARI SALT SMALL,PIECE,3,700,1780,320,2100,February
2673,INDO CAFE 50G,PIECE,3,10000,25424,4576,30000,February
2726,JAMIES CAKES @60K,PIECE,3,60000,152542,27458,180000,February
2794,JESA MILK UHT 500ML,PIECE,3,2200,5593,1007,6600,February
2921,JUMBO STRAWBERRY RIPPLE 175ML,PIECE,3,4000,10169,1831,12000,February
2936,KABODY MILLET SOYA PORRIDGE,PIECE,3,6500,16525,2975,19500,February
2941,KABODY PUMPKIN SEED 1KG,PIECE,3,6500,16525,2975,19500,February
2962,KANGARO STAPLES,PIECE,3,2000,5085,915,6000,February
2987,KAZIRE ORANGE,PIECE,3,2000,5085,915,6000,February
2999,KENPOLY LUNCH BOX,PIECE,3,5000,12712,2288,15000,February
3087,KIDS VEST 3000,PIECE,3,3000,7627,1373,9000,February
3091,KIDS WATCH 10000,PIECE,3,10000,25424,4576,30000,February
3098,KILLIT 400MLS,PIECE,3,18000,45763,8237,54000,February
3110,KIRINGI KAZI BOOSTER 280ML,PIECE,3,1000,2542,458,3000,February
3151,KNICKERS 3000,PIECE,3,3000,7627,1373,9000,February
3156,KNICKERS 7000,PIECE,3,7000,17797,3203,21000,February
3380,LIMOUSINE,PIECE,3,1500,3814,686,4500,February
3528,MADAM RANEE PAPAYA SOAP,PIECE,3,8000,20339,3661,24000,February
3548,MAGANJO PURE MILLET 1KG,PIECE,3,6500,16525,2975,19500,February
3550,MAGANJO RICE FLOUR 1KG,PIECE,3,7500,19068,3432,22500,February
3620,MATHEMATICAL SET,PIECE,3,4000,10169,1831,12000,February
3644,MELEX G.NUTS 1000,PIECE,3,1000,2542,458,3000,February
3650,MELEX HARDCORNS 500,PIECE,3,500,1271,229,1500,February
3653,MELEX SIMSIM 170G 2000,PIECE,3,2000,5085,915,6000,February
3667,MEN BOXERS 7000,PIECE,3,7000,17797,3203,21000,February
3676,MENTOS MINT,PIECE,3,2500,6356,1144,7500,February
3786,MONACO MIST,PIECE,3,16000,40678,7322,48000,February
3788,MONEY CHOCOLATE,PIECE,3,3500,8898,1602,10500,February
3869,MOVIT BABY JELLY 110G,PIECE,3,3000,7627,1373,9000,February
3888,MOVIT FAMILY SOAP ALOE 120G,PIECE,3,2500,6356,1144,7500,February
3889,MOVIT FAMILY SOAP ALOE 230G,PIECE,3,4000,10169,1831,12000,February
3907,MOVIT HERBAL JELLY 200G,PIECE,3,6000,15254,2746,18000,February
3930,MOVIT SOAP LEMON 120G,PIECE,3,2500,6356,1144,7500,February
3935,MOZZARELLA CHEESE 500G,PIECE,3,25000,63559,11441,75000,February
3939,MR.ZECO SWEETS,PIECE,3,300,763,137,900,February
3995,NACET BLADES 2500 PKT,PIECE,3,2500,6356,1144,7500,February
4053,NEW FASHION RUBBER BANDS,PIECE,3,1000,2542,458,3000,February
4147,NIVEA FRESH ENERGY 50ML,PIECE,3,11000,27966,5034,33000,February
4158,NIVEA MEN DEEP ROLLON,PIECE,3,11000,27966,5034,33000,February
4200,NOTE BOOK PICFARE,PIECE,3,5000,12712,2288,15000,February
4244,NUTRO ORANGE WAFFERS 150G,PIECE,3,5500,13983,2517,16500,February
4271,NUVITA GO COOKIES,PIECE,3,2000,5085,915,6000,February
4295,OFFICE GLUE 90G,PIECE,3,2000,5085,915,6000,February
4326,OLIVE OIL BODY WHIP 444ML,PIECE,3,28000,71186,12814,84000,February
4328,OLIVE OIL ORS SPRAY 472ML,PIECE,3,15000,38136,6864,45000,February
4330,OLIVE OIL SPRAY 85ML,PIECE,3,7500,19068,3432,22500,February
4335,OMO BLEACH COLOUR SAFE 700ML.,PIECE,3,9000,22881,4119,27000,February
4339,OMO BLEACH REGULAR,PIECE,3,8000,20339,3661,24000,February
4429,PADLOCK 2500,PIECE,3,2500,6356,1144,7500,February
4450,PAMPER 4 L.C PANTS,PIECE,3,9333,23729,4271,28000,February
4459,PAMPER S.6 JUMBO 48DIAP,PIECE,3,73000,185593,33407,219000,February
4466,PANASONIC BIG,PIECE,3,6000,15254,2746,18000,February
4511,PEGS 5000,PIECE,3,5000,12712,2288,15000,February
4516,PELIKAN RUBBER,PIECE,3,1000,2542,458,3000,February
4523,PENCIL BAGS 7000,PIECE,3,7000,17797,3203,21000,February
4590,PICFARE RULED PAPER BIG,PIECE,3,20000,50847,9153,60000,February
4801,PUFF HOLDERS 1000,PIECE,3,1000,2542,458,3000,February
4807,PUFFIN 60G,PIECE,3,2000,5085,915,6000,February
4878,RAZAC HAND&BODY LOTION 20Z,PIECE,3,5000,12712,2288,15000,February
4958,RIHAM GINGER TIN,PIECE,3,18000,45763,8237,54000,February
4991,ROKI OIL 3LTRS,PIECE,3,27000,68644,12356,81000,February
5022,ROYCO CHICKEN 500G,PIECE,3,12000,30508,5492,36000,February
5055,SAFETY PIN 300,PIECE,3,200,508,92,600,February
5063,SAF-LEVURE 125G,PIECE,3,8500,21610,3890,25500,February
5081,SAMONA HERBAL SOAP 100G,PIECE,3,4000,10169,1831,12000,February
5255,SHAKERS 4000,PIECE,3,4000,10169,1831,12000,February
5274,SHENKE ORANGE,PIECE,3,8000,20339,3661,24000,February
5284,SHIVA HONEY 80G,PIECE,3,4001,10171,1831,12002,February
5302,SHOWER CAPS,PIECE,3,2000,5085,915,6000,February
5308,SHOWER TOSHOWER FRESH MORNING,PIECE,3,6000,15254,2746,18000,February
5331,SHUYA 240 MM,PIECE,3,6000,15254,2746,18000,February
5363,SIMBA MBILI 50G,PIECE,3,5500,13983,2517,16500,February
5497,SOAP DISH KENPOLY 1000,PIECE,3,2000,5085,915,6000,February
5535,SOFTCARE PAMPERS M12,PIECE,3,7000,17797,3203,21000,February
5558,SOSOFT BABY 750MLS,PIECE,3,11000,27966,5034,33000,February
5611,SPONGE 4000,PIECE,3,4000,10169,1831,12000,February
5725,SULFO GLYCERINE PINK,PIECE,3,2000,5085,915,6000,February
5777,SUNLIGHT DISH LIQUID LEMON 400MLS,PIECE,3,7000,17797,3203,21000,February
5786,SUNLIGHT LAVENDER 500G,PIECE,3,5500,13983,2517,16500,February
5902,SWIVVEL HANGERS MUKWANO,PIECE,3,9000,22881,4119,27000,February
6069,TOOTHPICK NATURAL,PIECE,3,2500,6356,1144,7500,February
6154,TOY PHONES 4000,PIECE,3,3500,8898,1602,10500,February
6190,TROPICAL HEAT CINNAMON 50G,PIECE,3,4500,11441,2059,13500,February
6191,TROPICAL HEAT CLOVE POWDER,PIECE,3,7500,19068,3432,22500,February
6215,TROPICAL HEAT TEA MASALA 100G,PIECE,3,10000,25424,4576,30000,February
6218,TROPICAL HEAT TURMERIC 50G,PIECE,3,3500,8898,1602,10500,February
6317,UMBRELLAS 20000 POCKET,PIECE,3,19333,49153,8847,58000,February
6412,VASELINE DRY SKIN REPAIR 200ML,PIECE,3,8000,20339,3661,24000,February
6533,WEET CORNFLAKES 750G,PIECE,3,33000,83898,15102,99000,February
6782,CHICKEN STEW 8000,PIECE,3,8000,20339,3661,24000,February
6848,PIZZA 16'' CHICKEN ,PIECE,3,35000,88983,16017,105000,February
6972,FAX ROSE HAND WASH 400ML,PIECE,3,8000,20339,3661,24000,February
6993,DOMS WAX CRAYONS BIG,PIECE,3,5000,12712,2288,15000,February
6998,KADIO SCIENTIFIC CALCULATOR KD-82MS-B,PIECE,3,15000,38136,6864,45000,February
7025,FACE TOWELS 6000,PIECE,3,6000,15254,2746,18000,February
7068,QUENCHER PINEAPPLE 300ML,PIECE,3,2000,5085,915,6000,February
7093,PEPTANG TOMATO KETCHUP 700G,PIECE,3,12000,30508,5492,36000,February
7096,FRESH BITE TOMATO KETCHUP 1OOPCS,PIECE,3,12000,30508,5492,36000,February
7101,JAMIES DADDIES TIN 17000,PIECE,3,17000,43220,7780,51000,February
7277,DOUGHNUTS WHOLESALE 2500,PIECE,3,2500,6356,1144,7500,February
7295,PLASTIC SWINGING CANDLE 2500,PIECE,3,2500,6356,1144,7500,February
7333,MEN BOXERS,PIECE,3,15000,38136,6864,45000,February
7363,SUMZ PUMPKIN SEEDS 100G,PIECE,3,5000,12712,2288,15000,February
7395,HIKMA HARD CORNS 2500,PIECE,3,2000,5085,915,6000,February
7549,TOYS 30000,PIECE,3,30000,76271,13729,90000,February
7576,VENUS CURL ACTIVATOR,PIECE,3,5000,12712,2288,15000,February
7608,KOOKSY BLUEBERRY CHEESE CAKE 125ML,PIECE,3,3000,7627,1373,9000,February
7630,TROPIKAL SPECIAL EDITION FRESHENER 300ML,PIECE,3,12000,30508,5492,36000,February
7643,KAXUE KIDS TOOTHBRUSH,PIECE,3,2500,6356,1144,7500,February
7689,CONTAINER AND BOTTLE 15000,PIECE,3,15000,38136,6864,45000,February
7690,CONTAINER AND BOTTLE 20000,PIECE,3,20000,50847,9153,60000,February
7691,CONTAINER 23000,PIECE,3,23000,58475,10525,69000,February
7695,PIAO PIAO EXTRA LENGTH PADS,PIECE,3,3500,8898,1602,10500,February
7697,BODY SCRUBBER GLOVE 5000,PIECE,3,5000,12712,2288,15000,February
7714,REXONA SPORT DEFENSE 50ML,PIECE,3,10000,25424,4576,30000,February
7722,JAMIES BRONCH BREAD 1KG,PIECE,3,6000,15254,2746,18000,February
7723,JAMIES BROCRH BREAD 500G,PIECE,3,3500,8898,1602,10500,February
7725,JAMIES BRONCH BREAD 500G,PIECE,3,3500,8898,1602,10500,February
7741,LOVE BEAR 7000,PIECE,3,7000,17797,3203,21000,February
7758,LOVE BEAR 13000,PIECE,3,13000,33051,5949,39000,February
7759,LOVE GLASS 15000,PIECE,3,13000,33051,5949,39000,February
7760,LOVE CUP AND BEAR 10000,PIECE,3,10000,25424,4576,30000,February
7767,PEPSODENT CHARCOAL WHITE 160G,PIECE,3,11000,27966,5034,33000,February
7783,MENTOS PEACH ORANGE,PIECE,3,2500,6356,1144,7500,February
84,Always dreamzz,PIECE,4,3500,11864,2136,14000,February
120,AMARO MOSQUITO REPELLENT,PIECE,4,4000,13559,2441,16000,February
125,AMERICAN GARDEN KETCHUP 340G,PIECE,4,7500,25424,4576,30000,February
157,ANKIT BOURBON,PIECE,4,5000,16949,3051,20000,February
215,ARIEL ORIGINAL 1KG,PIECE,4,15500,52542,9458,62000,February
270,ART BOOK BIG,PIECE,4,4000,13559,2441,16000,February
279,ASANTEE PAPAYA SOAP,PIECE,4,6500,22034,3966,26000,February
442,BABY JUNIOR JELLY 200g,PIECE,4,6000,20339,3661,24000,February
497,BABY& ME BABYJELLY 240ML,PIECE,4,5000,16949,3051,20000,February
534,BALLET BABY OIL ALMOND 240ML,PIECE,4,14000,47458,8542,56000,February
542,BALLET REGULAR,PIECE,4,3500,11864,2136,14000,February
612,BECCA COUNTER BOOKS 6500,PIECE,4,6500,22034,3966,26000,February
672,BIRTHDAY HATS 3500,PIECE,4,3500,11864,2136,14000,February
676,BIRTHDAYCROWNS 3500,PIECE,4,3500,11864,2136,14000,February
681,BIYINZIKA CHICKEN GIZZARDS 500G,PIECE,4,11000,37288,6712,44000,February
689,BIYINZIKA SUPA 1KG,PIECE,4,20000,67797,12203,80000,February
769,BOTTLES 15000,PIECE,4,15000,50847,9153,60000,February
838,BROOKSIDE FRUIT VANILLA 250G,PIECE,4,3000,10169,1831,12000,February
892,BUSHENYI HONEY 90G,PIECE,4,3500,11864,2136,14000,February
913,C.B RIPPLES CHOCOLATE 200ML,PIECE,4,4000,13559,2441,16000,February
944,CADBURY DRINKING CHOCOLATE 125G,PIECE,4,8500,28814,5186,34000,February
1048,CB CLASSIC VANILLA 500ML,PIECE,4,10000,33898,6102,40000,February
1054,CB MAGIC STRAW 500ML,PIECE,4,10000,33898,6102,40000,February
1199,CLIMAX EXOTIC TROPICAL FRUITS 170G,PIECE,4,6000,20339,3661,24000,February
1262,COLGATE MAXIMUM CAVITY 35G,PIECE,4,2500,8475,1525,10000,February
1278,COMB 500,PIECE,4,500,1695,305,2000,February
1359,CREAMY EFFECT WIPES,PIECE,4,6000,20339,3661,24000,February
1389,CUSSON SOAP MILD&GENTLE,PIECE,4,3500,11864,2136,14000,February
1391,CUSSONS BABY OIL 100MLS,PIECE,4,9000,30508,5492,36000,February
1412,CUTTERS 1000,PIECE,4,1000,3390,610,4000,February
1451,DABUR HERBAL MINT&LEMON,PIECE,4,6000,20339,3661,24000,February
1462,DAIRY MILK TOP DECK 80G,PIECE,4,8000,27119,4881,32000,February
1538,DESSERT NOTE BOOK 4000,PIECE,4,4500,15254,2746,18000,February
1670,DOMS PENCILS A1 5000,PIECE,4,5000,16949,3051,20000,February
1688,DOUBLE REFINED SALT 650G,PIECE,4,7000,23729,4271,28000,February
1999,FACE TOWEL 1000,PIECE,4,1000,3390,610,4000,February
2071,FIDODIDO CHOCOLATE 250ML,PIECE,4,4000,13559,2441,16000,February
2087,FIDODIDO STRAW-VANI 250ML,PIECE,4,4000,13559,2441,16000,February
2281,GARDEN TEA 250,PIECE,4,14000,47458,8542,56000,February
2284,GARDEN TEA BAGS 100G,PIECE,4,6500,22034,3966,26000,February
2389,GOLDEN ALUMINIUM FOIL,PIECE,4,34000,115254,20746,136000,February
2416,GOOD DOCTOR KIDS TOOTH,PIECE,4,1000,3390,610,4000,February
2417,GOOD DOCTOR TOOTHBRUSH,PIECE,4,1000,3390,610,4000,February
2780,JESA CHOCOLATE FLAVOURED MILK 200ML,PIECE,4,1500,5085,915,6000,February
2781,JESA FINO BOX,BOX,4,24000,81356,14644,96000,February
2934,KABODY COMPOSITE FLOUR,PIECE,4,6000,20339,3661,24000,February
2942,KABODY PURE MILLET 1KG,PIECE,4,6125,20763,3737,24500,February
3085,KIDS TOOTHBRUSH 1000,PIECE,4,1000,3390,610,4000,February
3137,KIWI DARK TAN 32G,PIECE,4,4500,15254,2746,18000,February
3171,KOFA MATHEMATICAL SET,PIECE,4,4000,13559,2441,16000,February
3367,LET'S IMAGINE SPRAY,PIECE,4,12000,40678,7322,48000,February
3400,LMZ HERBAL 55G,PIECE,4,3000,10169,1831,12000,February
3468,M&G FLEXIBLE RULER,PIECE,4,2500,8475,1525,10000,February
3535,MAGANJO BABY SOYA WITH MILK 500G,PIECE,4,8500,28814,5186,34000,February
3552,MAGANJO SOYA MILLET,PIECE,4,6500,22034,3966,26000,February
3607,MARIKA ICING SUGAR 500G,PIECE,4,4000,13559,2441,16000,February
3625,MAYONNAISE 237ML,PIECE,4,19000,64407,11593,76000,February
3673,MENTOS FRUIT,PIECE,4,2500,8475,1525,10000,February
3679,MENTOS STRAWBERRY,PIECE,4,2500,8475,1525,10000,February
3844,MORTEIN ODOURLESS 300MLS,PIECE,4,22000,74576,13424,88000,February
4001,NANA HERBAL MOUTH 60MLS,PIECE,4,7500,25424,4576,30000,February
4026,NATARAJ RULER,PIECE,4,1500,5085,915,6000,February
4191,NOMI BUCKET 1KG,PIECE,4,12500,42373,7627,50000,February
4215,NTALE 25G,PIECE,4,2000,6780,1220,8000,February
4219,NUMA BUSHERA 2KG,PIECE,4,12000,40678,7322,48000,February
4338,OMO BLEACH MULTI-PURPOSE 70ML,PIECE,4,1500,5085,915,6000,February
4342,OMO COMFORT 1KG,PIECE,4,13000,44068,7932,52000,February
4470,PANCHAVATI,PIECE,4,3000,10169,1831,12000,February
4539,PEPSODENT CAVITY 65G,PIECE,4,2500,8475,1525,10000,February
4696,POULTRY VIENNAS 500G,PIECE,4,20000,67797,12203,80000,February
4792,PUCELLE JOYFULSUMMER 150ML,PIECE,4,7500,25424,4576,30000,February
4943,RIHAM BUTTER COOKIES BISCUIT 1KG,PIECE,4,18000,61017,10983,72000,February
4963,RIHAM VANILLA CREAMYCRUNCH,PIECE,4,3000,10169,1831,12000,February
4990,ROKI OIL 1LTR,PIECE,4,10000,33898,6102,40000,February
5018,ROYCO BEEF 500G,PIECE,4,12000,40678,7322,48000,February
5025,ROYCO CUBES BEEF,PIECE,4,4000,13559,2441,16000,February
5223,SENSODYNE MULTICARE 40MLS,PIECE,4,7000,23729,4271,28000,February
5287,SHOE BRUSH 5000,PIECE,4,5000,16949,3051,20000,February
5291,SHOE BRUSHES 2500,PIECE,4,3000,10169,1831,12000,February
5314,SHOWERTOSHOWER FRESH DAWN,PIECE,4,6000,20339,3661,24000,February
5400,SKIN CARE 150G,PIECE,4,4500,15254,2746,18000,February
5491,SOAP DISH 2000,PIECE,4,2000,6780,1220,8000,February
5515,SOFT BROOM 15000,PIECE,4,15000,50847,9153,60000,February
5530,SOFTCARE L40,PIECE,4,25000,84746,15254,100000,February
5638,SSCHOOL SOCKS WHITE,PIECE,4,4000,13559,2441,16000,February
5738,SUMZ CREAMY PEANUT BUTTER 420G,PIECE,4,8000,27119,4881,32000,February
5769,SUN SIP BLACKCURRANT 2LTR,PIECE,4,11000,37288,6712,44000,February
5773,SUN SIP PASSION 3LTR,PIECE,4,16000,54237,9763,64000,February
5783,SUNLIGHT DWL 750MLS LEMON,PIECE,4,11000,37288,6712,44000,February
5796,SUNLIGHT TROPICAL 1KG,PIECE,4,11000,37288,6712,44000,February
5911,SWT-P RICE YELLOW 2KG,PIECE,4,17000,57627,10373,68000,February
5964,TEEPEE BRUSH A9,PIECE,4,3000,10169,1831,12000,February
6102,TOP UP 700G,PIECE,4,3500,11864,2136,14000,February
6304,UGANDA SAFARI TEA 100G,PIECE,4,3500,11864,2136,14000,February
6307,UGANDA TEA BAGS,PIECE,4,5500,18644,3356,22000,February
6411,VASELINE COCOAGLOW LOTION 400G radiant,PIECE,4,14500,49153,8847,58000,February
6422,VASELINE MEN COOLING JELLY 240ML,PIECE,4,9500,32203,5797,38000,February
6458,VICTAN SINGLE VEST,PIECE,4,5000,16949,3051,20000,February
6537,WEETABIX 450G,PIECE,4,15500,52542,9458,62000,February
6665,ZESTA 300 G,PIECE,4,7500,25424,4576,30000,February
6674,ZESTA STRAWBERRY JAM,PIECE,4,10500,35593,6407,42000,February
6778,PILAO PLAIN 5000,PIECE,4,5850,19831,3569,23400,February
6921,ZENDEN PLASTIC PLAYING CARDS ,PIECE,4,5000,16949,3051,20000,February
6987,DOMS CUBOID PEN ,PIECE,4,700,2373,427,2800,February
6997,PELIKAN HB PENCILS 12PCS,PIECE,4,6000,20339,3661,24000,February
7029,QUENCHER STRAWBERRY 300ML,PIECE,4,2000,6780,1220,8000,February
7050,MARSHMALLOW PALAZI 1500,PIECE,4,2000,6780,1220,8000,February
7077,VASELINE BLUESEAL ALOEVERA 95ML,PIECE,4,5000,16949,3051,20000,February
7078,VASELINE BLUESEAL ALOEVERA 240ML,PIECE,4,9500,32203,5797,38000,February
7243,PLAIN WHITE RICE 8000,PIECE,4,3275,11102,1998,13100,February
7336,MODY UNDER WEAR,PIECE,4,15000,50847,9153,60000,February
7361,SUMZ DADDIES 300G,PIECE,4,5000,16949,3051,20000,February
7362,SUMZ BAGGIA 200G,PIECE,4,5000,16949,3051,20000,February
7513,ELMALEKA PASTA RINGS 400G,PIECE,4,3500,11864,2136,14000,February
7552,TOYS 5000,PIECE,4,5000,16949,3051,20000,February
7617,NUVITA COOKIES COCONUT 100GM,PIECE,4,2300,7797,1403,9200,February
7731,SUMZ CASSAVA CRISPS 100G,PIECE,4,2500,8475,1525,10000,February
7757,LOVE BEAR 45000,PIECE,4,45000,152542,27458,180000,February
6793,LIVER 4000,PIECE,4.5,3222,12288,2212,14500,February
58,AFRICANA TEA BAGS 50,PIECE,5,5000,21186,3814,25000,February
81,ALWAYS COTTON EXTRA LONG,PIECE,5,3000,12712,2288,15000,February
213,ARIEL DOWNY LAVENDER500G,PIECE,5,8000,33898,6102,40000,February
253,AROMAT 200G,PIECE,5,11000,46610,8390,55000,February
277,ART PENCILS 6B,PIECE,5,1000,4237,763,5000,February
313,AUNT PORRIDGE 6MONTHS,PIECE,5,14000,59322,10678,70000,February
527,BALLET ALOE VERA JELLY 300MLS,PIECE,5,9500,40254,7246,47500,February
570,BAMBOO TOOTHPICK 2500,PIECE,5,2500,10593,1907,12500,February
704,BLESSED KISUBI TEA 200G,PIECE,5,6000,25424,4576,30000,February
890,BUSHENYI HONEY 250G,PIECE,5,6000,25424,4576,30000,February
891,BUSHENYI HONEY 5OOG,PIECE,5,9000,38136,6864,45000,February
916,C.B RIPPLES STRAWBERRY 200ML,PIECE,5,4000,16949,3051,20000,February
966,CAKE WRAPPER 1000,PIECE,5,1000,4237,763,5000,February
1063,CELOTAPE MEDIUM,PIECE,5,5000,21186,3814,25000,February
1131,CHINA GREEN TEA 50G,PIECE,5,5000,21186,3814,25000,February
1195,CLIMAX BERRIES 170G,PIECE,5,6000,25424,4576,30000,February
1244,COLGATE 0-2YEARS,PIECE,5,4000,16949,3051,20000,February
1259,COLGATE MAX-FRESH 130G,PIECE,5,6500,27542,4958,32500,February
1261,COLGATE MAXIMUM CAVITY 140G,PIECE,5,7500,31780,5720,37500,February
1269,COLGATE TRIPLE ACTION 140G,PIECE,5,6500,27542,4958,32500,February
1277,COMB 1500,PIECE,5,1500,6356,1144,7500,February
1352,CRANE BOOK PC 1000,PIECE,5,1000,4237,763,5000,February
1400,CUSSONS OIL PINK 100MLS,PIECE,5,9000,38136,6864,45000,February
1401,CUSSONS PERFUMED JELLY A&R 100ML,PIECE,5,5500,23305,4195,27500,February
1419,D.L BLUEBERRY SWIRL 500ML,PIECE,5,10000,42373,7627,50000,February
1453,DABUR NEEM TOOTHPASTE 150G,PIECE,5,6000,25424,4576,30000,February
1558,DETTOL ORIGINAL 175G,PIECE,5,6500,27542,4958,32500,February
1662,DOLPHIN MONDI PAPERS,PIECE,5,27000,114407,20593,135000,February
1939,F.D MANGO 100G,PIECE,5,1000,4237,763,5000,February
2490,HAND WRITING BOOK 2000,PIECE,5,2000,8475,1525,10000,February
2495,HANKIE 1000,PIECE,5,1000,4237,763,5000,February
2518,HARPIC ORIGINAL PLUS,PIECE,5,15000,63559,11441,75000,February
2595,HOT FRESH 20ML,PIECE,5,2500,10593,1907,12500,February
2603,HP FACIAL WIPES,PIECE,5,3500,14831,2669,17500,February
2659,IMPERIAL LEATHER MEN FRESH BURST,PIECE,5,4500,19068,3432,22500,February
2676,INDOCAFE CAPPUCCINO CREAMY,PIECE,5,3000,12712,2288,15000,February
2725,JAMIES CAKES @50k,PIECE,5,50000,211864,38136,250000,February
2789,JESA FRUIT STRAWBERRY 500G,PIECE,5,6000,25424,4576,30000,February
2803,JESA TOFFEE 250G,PIECE,5,2500,10593,1907,12500,February
2830,JIK COLOURS 250MLS,PIECE,5,7000,29661,5339,35000,February
3134,KIWI CREME BLACK 100MLS,PIECE,5,4000,16949,3051,20000,February
3213,KOPIKO BLANCA CREAMY,PIECE,5,2000,8475,1525,10000,February
3239,KYOGERO HERBAL SOAP 120G,PIECE,5,3500,14831,2669,17500,February
3275,LANZO ANTI-BACTERIAL SOAP,PIECE,5,4500,19068,3432,22500,February
3279,LANZO VANILLA SOAP,PIECE,5,3500,14831,2669,17500,February
3290,LATO FLAVOURED BOX 23000,BOX,5,23000,97458,17542,115000,February
3410,LOTUS TOOTH BRUSH DEEP CLEAN,PIECE,5,4000,16949,3051,20000,February
3478,M&G MATHEMATICAL SET,PIECE,5,5000,21186,3814,25000,February
3526,MACRO DENTAL FLOSS,PIECE,5,3000,12712,2288,15000,February
3533,MAGANJO BABY SOYA 1KG,PIECE,5,6500,27542,4958,32500,February
3584,MAMIS PEANUT PASTE 1KG,PIECE,5,15000,63559,11441,75000,February
3608,MARLOS CHOCOLATE,PIECE,5,2000,8475,1525,10000,February
3628,MAYONNAISE MEDIUM 473ML,PIECE,5,25000,105932,19068,125000,February
3648,MELEX HARDCORNS 1000,PIECE,5,1000,4237,763,5000,February
3654,MELEX SIMSIM 85G 1000,PIECE,5,1000,4237,763,5000,February
3945,MUKISA MANDAZI,PIECE,5,3000,12712,2288,15000,February
4029,NATURAL NAPKINS,PIECE,5,2500,10593,1907,12500,February
4043,NESCAFE CLASSIC 100G,PIECE,5,17000,72034,12966,85000,February
4198,NOTE BOOK 4000,PIECE,5,4000,16949,3051,20000,February
4240,NUTRO DIGESTIVE,PIECE,5,6500,27542,4958,32500,February
4465,PANASONIC AAA,PIECE,5,2000,8475,1525,10000,February
4580,PICFARE 4 QUIRE 10000,PIECE,5,10000,42373,7627,50000,February
4588,PICFARE PENCILS 3000,PIECE,5,2700,11441,2059,13500,February
4595,PICK n PEEL APPLE 1LTR,PIECE,5,9500,40254,7246,47500,February
4695,POULTRY VIENNAS 250G,PIECE,5,12000,50847,9153,60000,February
4705,PRADIP VANILLA CLEAR FLAVOURING,PIECE,5,5000,21186,3814,25000,February
4751,PRIVE EYE CANDY PARFUM,PIECE,5,16000,67797,12203,80000,February
4777,PROTEX HERBAL 150G,PIECE,5,6500,27542,4958,32500,February
4950,RIHAM CREAMY CRUNCH CHOCOLATE,PIECE,5,3000,12712,2288,15000,February
4992,ROKI OIL 500ML,PIECE,5,5000,21186,3814,25000,February
5007,ROTATRIM,PIECE,5,28000,118644,21356,140000,February
5021,ROYCO CHICKEN 200G,PIECE,5,6000,25424,4576,30000,February
5024,ROYCO CUBE CHICKEN FLAVOUR,PIECE,5,4200,17797,3203,21000,February
5049,SAFA TOMATO PASTE 400G,PIECE,5,6000,25424,4576,30000,February
5181,SCOURING PADS 500,PIECE,5,500,2119,381,2500,February
5264,SHENKE COIL 4500,PIECE,5,4500,19068,3432,22500,February
5265,SHENKE FLOWER REPELLENT,PIECE,5,8000,33898,6102,40000,February
5273,SHENKE MOSQUITO REPELLANT DOUBLE 20000,PIECE,5,20000,84746,15254,100000,February
5301,SHOWER 2 SHOWER CONFIDENT,PIECE,5,6000,25424,4576,30000,February
5531,SOFTCARE M42 GOLD,PIECE,5,25000,105932,19068,125000,February
5816,SUNSIP BLACKCURRANT 5LTR,PIECE,5,24000,101695,18305,120000,February
6045,TOILET BLUE BLOCKS 4PCS,PIECE,5,7500,31780,5720,37500,February
6187,TROPICAL HEAT BLACK PEPPER 50G,PIECE,5,5500,23305,4195,27500,February
6188,TROPICAL HEAT CHICKEN MASALA 100G,PIECE,5,5000,21186,3814,25000,February
6268,U.S.A BEAUTY SOAP BLACK,PIECE,5,6500,27542,4958,32500,February
6281,UBISCO MILK&HONEY 108PKTS,PIECE,5,10000,42373,7627,50000,February
6516,WATER BUBBLES 700,PIECE,5,700,2966,534,3500,February
6544,WEETABIX CORNFLAKES 500G,PIECE,5,22000,93220,16780,110000,February
6651,YOUR CHOICE SAUSAGES 500G,PIECE,5,17000,72034,12966,85000,February
6882,SUMZ FRIED PEAS,PIECE,5,2500,10593,1907,12500,February
7120,JAMIES DADDIES 500G 10000,PIECE,5,10000,42373,7627,50000,February
7146,JAMIES COOKIES TIN 500G 10000,PIECE,5,10000,42373,7627,50000,February
7366,D.L SOY NON-DAIRY ICE CREAM STRAWBERRY 500ML,PIECE,5,10000,42373,7627,50000,February
7388,HIKMA YELLOW BAGIYA 4000,PIECE,5,4000,16949,3051,20000,February
7403,SCOURING PAD & SPONGE,PIECE,5,1499,6353,1144,7497,February
7491,C.B DOUBLES BLUEBERRY ICE CREAM,PIECE,5,2500,10593,1907,12500,February
7557,MEGA SPAGHETTI,PIECE,5,4500,19068,3432,22500,February
7588,SUMZ CASHEW NUTS 75G,PIECE,5,7500,31780,5720,37500,February
7610,MARSHAL SET,PIECE,5,4000,16949,3051,20000,February
7692,CONTAINER 13000,PIECE,5,13000,55085,9915,65000,February
7707,JAMIES COOKIES@20000,PIECE,5,20000,84746,15254,100000,February
7735,JAMIES MARBLE CAKE @8000,PIECE,5,8000,33898,6102,40000,February
7778,DAIMA MILK VANILLA 250ML,PIECE,5,2500,10593,1907,12500,February
671,BIRTHDAY HATS 2500,PIECE,6,2500,12712,2288,15000,February
781,BOUNTY CHOCOLATE,PIECE,6,4000,20339,3661,24000,February
935,CADBURY DAIRY MILK CHOCOLATE 150G,PIECE,6,13000,66102,11898,78000,February
981,CAMERA NIPPLES L,PIECE,6,1500,7627,1373,9000,February
1011,CAR TOYS 3000,PIECE,6,3000,15254,2746,18000,February
1059,CELOTAPE BIGGER 1OOOO,PIECE,6,10000,50847,9153,60000,February
1095,CHAPA BAKING POWDER,PIECE,6,1500,7627,1373,9000,February
1111,CHERRY COTTON BUDS,PIECE,6,2500,12712,2288,15000,February
1212,CLOSEUP TRIPLEFRESH 60G,PIECE,6,3000,15254,2746,18000,February
1248,COLGATE DEEP CLEAN,PIECE,6,1500,7627,1373,9000,February
1288,COMPACT NAPKINS,PIECE,6,3000,15254,2746,18000,February
1428,D.L MAXIMO VAN-CHOCO FLAKES 175ML,PIECE,6,4000,20339,3661,24000,February
1450,DABUR HERBAL CLOVE 150G,PIECE,6,6000,30508,5492,36000,February
1474,DAITY SAFFRON ICE CREAM,PIECE,6,5500,27966,5034,33000,February
1557,DETTOL ORIGINAL 100G,PIECE,6,4500,22881,4119,27000,February
1559,DETTOL SENSITIVE 175G,PIECE,6,6500,33051,5949,39000,February
1568,DEXE BLACK HAIR SHAMPOO,PIECE,6,2000,10169,1831,12000,February
1600,DISPOSABLE PLATES 6000,PIECE,6,6000,30508,5492,36000,February
1668,DOMS GEOMETRY SET,PIECE,6,8500,43220,7780,51000,February
1818,EAST AFRICAN ORGANIC HONEY 100G,PIECE,6,3500,17797,3203,21000,February
2000,FACE TOWEL 1500,PIECE,6,1500,7627,1373,9000,February
2209,FRESH UP TOOTHPASTE,PIECE,6,2000,10169,1831,12000,February
2317,GIFT BAG FLORAL LARGE,PIECE,6,6000,30508,5492,36000,February
2461,GUINEA SHOE CREME BROWN,PIECE,6,3500,17797,3203,21000,February
2496,HANKIES 1500,PIECE,6,1250,6356,1144,7500,February
2651,IMPERIAL LEATHER 4*175,PIECE,6,13000,66102,11898,78000,February
2719,JAMIES BROWN SALT BREAD 1KG,PIECE,6,5500,27966,5034,33000,February
2796,JESA PLAIN YOGHURT 500G,PIECE,6,3700,18814,3386,22200,February
2916,JUMBO BLUE SWIRL 175ML,PIECE,6,4000,20339,3661,24000,February
2988,KAZIRE POWER TONIC,PIECE,6,2000,10169,1831,12000,February
3093,KIDS WATCHES 5000 GODLER,PIECE,6,5000,25424,4576,30000,February
3096,KILL IT 150MLS,PIECE,6,11000,55932,10068,66000,February
3115,KIRUNGI MULONDO EXTRA 280ML,PIECE,6,1000,5085,915,6000,February
3141,KIWI SHOE CREAM DARKTAN,PIECE,6,5500,27966,5034,33000,February
3234,KYOGERO HERBAL JELLY 100ML,PIECE,6,3500,17797,3203,21000,February
3318,LATO VANILLA YOGHURT 250ML,PIECE,6,2500,12712,2288,15000,February
3663,MEN BOXERS 10000,PIECE,6,10000,50847,9153,60000,February
3973,MUSAWO SOAP 240G,PIECE,6,3000,15254,2746,18000,February
4123,NISA LEMON HAIR REMOVAL CREME 20ML,PIECE,6,2000,10169,1831,12000,February
4201,NOTE BOOK SPIRAL 10000,PIECE,6,10000,50847,9153,60000,February
4222,NUMA RICE FLOUR 1KG,PIECE,6,7500,38136,6864,45000,February
4239,NUTRO CREAM WAFERS 3,PIECE,6,6500,33051,5949,39000,February
4284,OATIBIX 500G,PIECE,6,12000,61017,10983,72000,February
4343,OMO COMFORT 500G,PIECE,6,7500,38136,6864,45000,February
4367,ORCHID VALLEY GUAVA 1LTR,PIECE,6,7500,38136,6864,45000,February
4415,OWEN'S G-NUTS 2000,PIECE,6,2200,11186,2014,13200,February
4430,PADLOCK 3000,PIECE,6,3000,15254,2746,18000,February
4541,PEPSODENT HERBAL 65G,PIECE,6,2500,12712,2288,15000,February
5053,SAFARI TEA 50G,PIECE,6,1500,7627,1373,9000,February
5324,SHREEJI GRAPH BOOK 96,PIECE,6,3000,15254,2746,18000,February
5536,SOFTCARE PAMPERS S15,PIECE,6,7500,38136,6864,45000,February
5566,SOY SAUCE DARK 150G,PIECE,6,5000,25424,4576,30000,February
5568,SOY SAUCE LIGHT 150G,PIECE,6,5000,25424,4576,30000,February
5610,SPONGE 3000,PIECE,6,3000,15254,2746,18000,February
5630,SQUEEZERS 5000,PIECE,6,5000,25424,4576,30000,February
5761,SUMZ ROASTED NUTS 120G,PIECE,6,3000,15254,2746,18000,February
5798,SUNLIGHT TROPICAL 500G,PIECE,6,5500,27966,5034,33000,February
5852,SUPREME BAKING FLOUR,PIECE,6,9000,45763,8237,54000,February
5979,TEMMY'S CORNFLAKES 250G,PIECE,6,9000,45763,8237,54000,February
5980,TEMMY'S CORNFLAKES 500G,PIECE,6,16000,81356,14644,96000,February
6041,TOCEBA AAA,PIECE,6,700,3559,641,4200,February
6217,TROPICAL HEAT TURMERIC 100G,PIECE,6,7000,35593,6407,42000,February
6384,VALUE MAX PREP RAZOR,PIECE,6,3500,17797,3203,21000,February
6427,VASELINE MEN JELLY FRESH 240ML,PIECE,6,9500,48305,8695,57000,February
6469,VIM LAVENDER 500G,PIECE,6,5000,25424,4576,30000,February
6474,VINEGAR WHITE 700MLS,PIECE,6,2500,12712,2288,15000,February
6564,WHISPPEX SHAVERS,PIECE,6,3000,15254,2746,18000,February
6642,YOJUS APPLE DRINK,PIECE,6,1000,5085,915,6000,February
6650,YOUR CHOICE SAUSAGE 1KG,PIECE,6,30000,152542,27458,180000,February
6936,JESA MIXED BERRY YOGHURT 500G,PIECE,6,3700,18814,3386,22200,February
7321,ECLAIRS 300,PIECE,6,300,1525,275,1800,February
7538,KIDS SHADES 2000,PIECE,6,2000,10169,1831,12000,February
7547,TOYS 15000,PIECE,6,10000,50847,9153,60000,February
7642,KAXUE TOOTH BRUSH,PIECE,6,2500,12712,2288,15000,February
7658,HANDSOME BOXER 18000,PIECE,6,18000,91525,16475,108000,February
7693,HAND BRUSH 2500,PIECE,6,2500,12712,2288,15000,February
7726,DABUR CHARCOAL 150G,PIECE,6,6500,33051,5949,39000,February
7748,BAKEMATE LOVE 1500,PIECE,6,1500,7627,1373,9000,February
7761,LOVE HEART 2000,PIECE,6,2000,10169,1831,12000,February
9,500MLS DISPOSABLE GLASSES,PIECE,7,6000,35593,6407,42000,February
639,BEST RULER 1000,PIECE,7,1000,5932,1068,7000,February
686,BIYINZIKA MIXED PORTIONS 2KG,PIECE,7,37000,219492,39508,259000,February
901,C.B CHOCOLATE CHOCO CHIP 120ML,PIECE,7,2500,14831,2669,17500,February
902,C.B CHOCOLATE CHOCO CHIPS 200ML,PIECE,7,5000,29661,5339,35000,February
914,C.B RIPPLES MIXED 200MLS,PIECE,7,4000,23729,4271,28000,February
1064,CELOTAPE SMALL 1000,PIECE,7,1000,5932,1068,7000,February
1096,CHAPA NYOTA BLUE 600G,PIECE,7,4000,23729,4271,28000,February
1237,COCONUTY CHOCOLATE,PIECE,7,1500,8898,1602,10500,February
1443,D.L VANILLA 500ML,PIECE,7,9500,56356,10144,66500,February
1510,DELIDENT MAX 70G,PIECE,7,2000,11864,2136,14000,February
1511,DELLA CHOCOLATE,PIECE,7,3000,17797,3203,21000,February
1525,DENTAL FLOSS,PIECE,7,2500,14831,2669,17500,February
1527,DENTEX TOOTHBRUSH SOFT,PIECE,7,3500,20763,3737,24500,February
1547,DETTOL FRESH 175G,PIECE,7,6500,38559,6941,45500,February
2113,FLOWERS 2000,PIECE,7,2000,11864,2136,14000,February
2174,FORTUNE BUTTO 1LTR,PIECE,7,8500,50424,9076,59500,February
2302,GEISHA TRADITIONAL BLACK SOAP,PIECE,7,5500,32627,5873,38500,February
2538,HERMELA GUEST SOAP,PIECE,7,3500,20763,3737,24500,February
2636,IBON ELVAN SWEETS,PIECE,7,200,1186,214,1400,February
2764,JAMIES SWEET YELLOW SCONES,PIECE,7,3500,20763,3737,24500,February
2924,JUNSHENG COTTON SWABS,PIECE,7,2071,12288,2212,14500,February
3131,KIWI 20G,PIECE,7,3000,17797,3203,21000,February
3153,KNICKERS 4000,PIECE,7,4000,23729,4271,28000,February
3224,KUAKUA TOILET BLOCKS 6PCS,PIECE,7,10000,59322,10678,70000,February
3538,MAGANJO CORNFLAKES,PIECE,7,10000,59322,10678,70000,February
3553,MAGANJO SOYA RICE 1KGS,PIECE,7,7500,44492,8008,52500,February
3645,MELEX G.NUTS 2000,PIECE,7,2000,11864,2136,14000,February
3760,MOCACINE SOCKS 2000,PIECE,7,2000,11864,2136,14000,February
3855,MOTH BALLS 4000,PIECE,7,7000,41525,7475,49000,February
4022,NATARAJ JUMBO WAX CRAYONS,PIECE,7,6000,35593,6407,42000,February
4223,NUMA SOYA RICE 1KG,PIECE,7,7000,41525,7475,49000,February
4235,NUTRO CHOC CREAM WAFERS,PIECE,7,6500,38559,6941,45500,February
4372,ORCHID VALLEY TROPICAL 1LTR,PIECE,7,7500,44492,8008,52500,February
4444,PAMPER 2 L.C,PIECE,7,9286,55085,9915,65000,February
4454,PAMPER 5 L.C PANTS,PIECE,7,9000,53390,9610,63000,February
4554,PETANG TOMATO SAUCE 700G,PIECE,7,7500,44492,8008,52500,February
4589,PICFARE PENCILS PIECES 300,PIECE,7,300,1780,320,2100,February
4653,PLUTO ADVANCED AA,PIECE,7,6000,35593,6407,42000,February
4667,POPPER 7000,PIECE,7,7000,41525,7475,49000,February
4712,PREMIUM QUALITY TISSUE,PIECE,7,7500,44492,8008,52500,February
4778,PROTEX HERBAL 90G,PIECE,7,4000,23729,4271,28000,February
5026,ROYCO CURRY+MCHUZI,PIECE,7,6500,38559,6941,45500,February
5259,SHARPENER SMALL,PIECE,7,500,2966,534,3500,February
5272,SHENKE MOSQUITO REPELLANT,PIECE,7,16000,94915,17085,112000,February
5290,SHOE BRUSHES 2000,PIECE,7,2000,11864,2136,14000,February
5355,SILVER PLATE 300,PIECE,7,300,1780,320,2100,February
5567,SOY SAUCE DARK 500G,PIECE,7,10000,59322,10678,70000,February
5597,SPLASH GUAVA 1LTR,PIECE,7,8000,47458,8542,56000,February
5660,STEEPO CHOCOLATE,PIECE,7,2000,11864,2136,14000,February
5731,SUMZ COCONUT COOKIES,PIECE,7,4000,23729,4271,28000,February
5734,SUMZ CORN CRAX CHILLI80G,PIECE,7,1500,8898,1602,10500,February
5766,SUMZ TANGY LEMON CRISPS 30G,PIECE,7,1500,8898,1602,10500,February
5822,SUNSIP STRAWBERRY 3LTR,PIECE,7,16000,94915,17085,112000,February
6471,VIM LEMON FRESH 500G,PIECE,7,5000,29661,5339,35000,February
6607,WRAPPING PAPER 1000,PIECE,7,1000,5932,1068,7000,February
6676,ZESTA TOMATO KETCHUP,PIECE,7,7000,41525,7475,49000,February
6953,STRIKE NUTS CHOCOLATE BAR,PIECE,7,1500,8898,1602,10500,February
7015,JESA STRAWBERRY&CHOCOLATE 450G,PIECE,7,6000,35593,6407,42000,February
7308,COTTON EAR SWABS 4000,PIECE,7,4000,23729,4271,28000,February
7606,BEYOGLU BISCUITO,PIECE,7,1500,8898,1602,10500,February
7621,MINTORE X PLUS 500,PIECE,7,500,2966,534,3500,February
7706,JAMIES MILK BREAD 500G,PIECE,7,3143,18644,3356,22000,February
54,AFIA ORANGE 500ML,PIECE,8,3000,20339,3661,24000,February
289,ASTRO'S CHOCOLATES,PIECE,8,1500,10169,1831,12000,February
529,BALLET BABY JELLY 300MLS,PIECE,8,9500,64407,11593,76000,February
655,BIG DADDY 300 SWEETS,PIECE,8,300,2034,366,2400,February
683,BIYINZIKA CHICKENLEGS 1KGS,PIECE,8,19000,128814,23186,152000,February
776,BOTTLES 7000,PIECE,8,7000,47458,8542,56000,February
852,BROOMS 2000,PIECE,8,2000,13559,2441,16000,February
1037,CASHO CALC,PIECE,8,15000,101695,18305,120000,February
1247,COLGATE CHILDREN 50MLS,PIECE,8,4500,30508,5492,36000,February
1263,COLGATE MAXIMUM CAVITY 70G,PIECE,8,4500,30508,5492,36000,February
1406,CUSSONS SOAP SOFT&SMOOTH,PIECE,8,3500,23729,4271,28000,February
1420,D.L CHOCO BOMB 70ML,PIECE,8,2500,16949,3051,20000,February
1427,D.L MAXIMO CARAMEL NUTS,PIECE,8,3500,23729,4271,28000,February
1433,D.L NEOPOLITAN 500MLS,PIECE,8,9500,64407,11593,76000,February
1440,D.L VAN-CHOC 500ML,PIECE,8,9500,64407,11593,76000,February
1447,D.L VAN-STRAW 500ML,PIECE,8,9500,64407,11593,76000,February
1471,DAITY CAPPUCCINO VANILLA ICE CREAM,PIECE,8,5500,37288,6712,44000,February
1853,EGGS HALF TRAY,PIECE,8,7000,47458,8542,56000,February
1984,FA MEN INVISIBLE POWER,PIECE,8,6500,44068,7932,52000,February
2233,FRUITVILLE APPLE DRINK,PIECE,8,3500,23729,4271,28000,February
2724,JAMIES CAKES @ 40K,PIECE,8,40000,271186,48814,320000,February
2989,KAZIRE RED TONIC 350MLS,PIECE,8,2000,13559,2441,16000,February
3049,KEY HOLDERS 2000,PIECE,8,2000,13559,2441,16000,February
3051,KEY HOLDERS 3500,PIECE,8,3500,23729,4271,28000,February
3465,M&G COUNTER BOOK AQUIRE,PIECE,8,5000,33898,6102,40000,February
3470,M&G GLUE STICK 2500,PIECE,8,2500,16949,3051,20000,February
3472,M&G HELLO BEARS PEN ERASE,PIECE,8,2500,16949,3051,20000,February
4046,NESCAFE CLASSIC 50G,PIECE,8,10750,72881,13119,86000,February
4245,NUTRO STRAW CREAM WAFERS,PIECE,8,3500,23729,4271,28000,February
4341,OMO BLEACH REGULAR 70ML,PIECE,8,1200,8136,1464,9600,February
4346,OMO FAST ACTION 500G,PIECE,8,7500,50847,9153,60000,February
4542,PEPSODENT HERBAL TRIPPLE140G,PIECE,8,5000,33898,6102,40000,February
4740,PRINGLES KETCHUP 165G,PIECE,8,11000,74576,13424,88000,February
4936,RIBENA 1LTR,PIECE,8,10000,67797,12203,80000,February
5020,ROYCO BEEF 60G,PIECE,8,1200,8136,1464,9600,February
5023,ROYCO CHICKEN 60G,PIECE,8,1200,8136,1464,9600,February
5171,SCHOOL SOCKS WHITE 7000,PIECE,8,5313,36017,6483,42500,February
5214,SENSITIVE BABY WIPES,PIECE,8,7000,47458,8542,56000,February
5313,SHOWERTO SHOWER MUSK ALIVE,PIECE,8,6000,40678,7322,48000,February
5323,SHREEJI GRAPH BOOK 48PGSS,PIECE,8,1500,10169,1831,12000,February
5334,SHUYA PANT LINERS,PIECE,8,6000,40678,7322,48000,February
5381,SIMKA VANILLA 300MLS,PIECE,8,3500,23729,4271,28000,February
5382,SIMKA VANILLA 500MLS,PIECE,8,4500,30508,5492,36000,February
6068,TOOTHPICK 1000,PIECE,8,1000,6780,1220,8000,February
6216,TROPICAL HEAT TEA MASALA 45G,PIECE,8,5000,33898,6102,40000,February
6323,UMOJA SANDALS 8000,PIECE,8,10000,67797,12203,80000,February
6470,VIM LEMON 1KG,PIECE,8,8000,54237,9763,64000,February
6707,VASELINE BLUESEAL MEN COOLING 95ML,PIECE,8,5000,33898,6102,40000,February
6736,JESA STRAWBERRY 450G,PIECE,8,6000,40678,7322,48000,February
7324,OYAL COCOX,PIECE,8,1500,10169,1831,12000,February
7387,HB PENCILS,PIECE,8,1500,10169,1831,12000,February
7705,JAMIES CAKE SLICE@8000,PIECE,8,8000,54237,9763,64000,February
7784,TOUCH AKY,PIECE,8,1000,6780,1220,8000,February
4,180ML DISPOSABLE GLASSES,PIECE,9,3000,22881,4119,27000,February
254,AROMAT 75G,PIECE,9,5500,41949,7551,49500,February
716,BLUE BAND 500G,PIECE,9,10000,76271,13729,90000,February
730,BLUE TOILET BLOCKS SINGLE50G,PIECE,9,2500,19068,3432,22500,February
946,CADBURY FRUIT & NUT 80G,PIECE,9,8000,61017,10983,72000,February
1045,CB CHOC-VANILLA 120MLS,PIECE,9,2500,19068,3432,22500,February
1267,COLGATE TOOTHBRUSH CHARCOAL,PIECE,9,2500,19068,3432,22500,February
1356,CREAMBELL MAGIC STRAW120ML,PIECE,9,2500,19068,3432,22500,February
1421,D.L CHOCO NUT 70ML,PIECE,9,2500,19068,3432,22500,February
1457,DAIRIES 12000,PIECE,9,12000,91525,16475,108000,February
1461,DAIRY MILK PLAIN 80G,PIECE,9,8000,61017,10983,72000,February
1486,DATES 3000,PIECE,9,3500,26695,4805,31500,February
1687,DOUBLE A REAM,PIECE,9,29000,221186,39814,261000,February
1785,DURU NATURAL CARE,PIECE,9,4500,34322,6178,40500,February
2765,JAMIES TWISTED BREAD 1KG,PIECE,9,6000,45763,8237,54000,February
2986,KAZIRE LEMON TEA,PIECE,9,2000,15254,2746,18000,February
3059,KICK SNACKS BBQ BEEF 15G,PIECE,9,500,3814,686,4500,February
3672,MENTHOXYL,PIECE,9,500,3814,686,4500,February
3956,MUKWANO OIL 500ML JERRYCAN,PIECE,9,5000,38136,6864,45000,February
3972,MUSAWO SOAP 120G,PIECE,9,1500,11441,2059,13500,February
3997,NAIL CUTTER 2500,PIECE,9,2500,19068,3432,22500,February
4247,NUTRO TEA BISCUIT,PIECE,9,3500,26695,4805,31500,February
4484,PAPERLINE EXERCISE BK,PIECE,9,4000,30508,5492,36000,February
4576,PIAO PIAO TP,PIECE,9,1500,11441,2059,13500,February
5016,ROYCO BEEF 200G,PIECE,9,6000,45763,8237,54000,February
5724,SULFO GLYCERINE COLORLESS,PIECE,9,2000,15254,2746,18000,February
5741,SUMZ CRISPS FRUIT CHUTNEY,PIECE,9,1500,11441,2059,13500,February
5746,SUMZ GINGER COOKIES,PIECE,9,4000,30508,5492,36000,February
5763,SUMZ ROASTED NUTS 60G,PIECE,9,1500,11441,2059,13500,February
5795,SUNLIGHT SPRING SENSATIONS 500G,PIECE,9,5500,41949,7551,49500,February
5802,SUNSEED OIL 1LTRS,PIECE,9,12000,91525,16475,108000,February
6404,VASELINE BLUESEAL MEN FRESH 100ML,PIECE,9,5000,38136,6864,45000,February
6535,WEETABIX 225G,PIECE,9,8500,64831,11669,76500,February
6598,WISDOM SMOKERS TOOTHBRUSH,PIECE,9,2500,19068,3432,22500,February
6791,CHICKEN PIE 5000,PIECE,9,5000,38136,6864,45000,February
7102,JAMIES DADDIES TIN 20000,PIECE,9,20000,152542,27458,180000,February
7239,BEEF PILAU 20000,PIECE,9,6356,48475,8725,57200,February
7306,MAVAL GIRL PANTY LINERS,PIECE,9,2500,19068,3432,22500,February
7494,FRUIT VILLE TROPICAL,PIECE,9,3500,26695,4805,31500,February
7619,NICE BISCUITS ,PIECE,9,1500,11441,2059,13500,February
7687,NOTE BOOK 6500,PIECE,9,6500,49576,8924,58500,February
349,AZAM MALT 500MLS,PIECE,10,3000,25424,4576,30000,February
454,BABY NIPPLES 700,PIECE,10,700,5932,1068,7000,February
703,BLESSED KISUBI TEA 125G,PIECE,10,5000,42373,7627,50000,February
915,C.B RIPPLES ORANGE 200ML,PIECE,10,4000,33898,6102,40000,February
1094,CHAMPION A4 96 PAGES,PIECE,10,2000,16949,3051,20000,February
1437,D.L VAN.STRAW 250ML,PIECE,10,5000,42373,7627,50000,February
1526,DENTAL FLOSS /PICKS,PIECE,10,2500,21186,3814,25000,February
1769,DURACELL AA PLUS,PIECE,10,8000,67797,12203,80000,February
1893,ELITE HANGERS,PIECE,10,7000,59322,10678,70000,February
1940,F.D MANGO 250G,PIECE,10,2500,21186,3814,25000,February
2088,FIDODIDO STRAW-VANI 500ML,PIECE,10,5000,42373,7627,50000,February
2290,GEISHA COCONUTMILK 125G,PIECE,10,2500,21186,3814,25000,February
2299,GEISHA SHEA AND ALMOND BUTTER SOAP 225G,PIECE,10,5500,46610,8390,55000,February
2720,JAMIES BROWN SALT BREAD 500G,PIECE,10,3000,25424,4576,30000,February
2831,JIK REGULAR 250MLS,PIECE,10,6500,55085,9915,65000,February
3119,KISUBI 85GM,PIECE,10,1500,12712,2288,15000,February
3130,KITUZI,PIECE,10,1000,8475,1525,10000,February
3293,LATO MILK 250G,PIECE,10,12000,101695,18305,120000,February
4190,NOMI 250G BUCKET,PIECE,10,4000,33898,6102,40000,February
4195,NOTE BOOK 2000,PIECE,10,2000,16949,3051,20000,February
4368,ORCHID VALLEY MANGO 1LTR6161101061483,PIECE,10,7500,63559,11441,75000,February
4540,PEPSODENT CAVITY FIGHTER 150G,PIECE,10,5000,42373,7627,50000,February
4592,PICFARE SET,PIECE,10,6000,50847,9153,60000,February
4951,RIHAM CREAMY CRUNCH STRAWBERRY,PIECE,10,3000,25424,4576,30000,February
5083,SAN MARIO SPAGHETTI 500G,PIECE,10,4000,33898,6102,40000,February
5189,SCRUBBING BRUSH LONG 5000,PIECE,10,6000,50847,9153,60000,February
6606,WRAPPERS 500,PIECE,10,500,4237,763,5000,February
6831,JESA MIXED BERRY YOGHURT 250G,PIECE,10,2500,21186,3814,25000,February
7147,JAMIES COOKIES 800G TIN 17000,PIECE,10,17600,149153,26847,176000,February
7364,SUMZ BAGGIA 100G,PIECE,10,3000,25424,4576,30000,February
7405,SUMZ FRIED SOYA BEANS 100G,PIECE,10,2500,21186,3814,25000,February
7558,HISS,PIECE,10,2500,21186,3814,25000,February
7561,SANTA LUCIA 5500,PIECE,10,5500,46610,8390,55000,February
7701,CLEAR BAGS 1500,PIECE,10,1500,12712,2288,15000,February
6874,MUSHROOM STEW,PIECE,10.63,7347,66186,11914,78100,February
613,BECCA COUNTERBOOK 5000,PIECE,11,4318,40254,7246,47500,February
768,BOTTLES 13000,PIECE,11,13000,121186,21814,143000,February
939,CADBURY DAIRY MILK MINT CRISP 80G,PIECE,11,8000,74576,13424,88000,February
1093,CHAMPION A4 200PAGES,PIECE,11,4000,37288,6712,44000,February
1507,DEG'S SWEET SNACKS 500,PIECE,11,500,4661,839,5500,February
1723,DOVE PINK ROSA SOAP 135G,PIECE,11,6000,55932,10068,66000,February
1856,EGGS TRAY,PIECE,11,14000,130508,23492,154000,February
1936,F.D CHOCOLATE MILK 250MLS,PIECE,11,2000,18644,3356,22000,February
2002,FACE TOWEL 3000 WHITE,PIECE,11,3000,27966,5034,33000,February
2026,FANAKA GUAVA 500ML,PIECE,11,3500,32627,5873,38500,February
2175,FORTUNE BUTTO 500ML,PIECE,11,4500,41949,7551,49500,February
2235,FRUITVILLE MANGO 500ML,PIECE,11,3500,32627,5873,38500,February
2288,GEISHA ALOEVERA &HONEY 125G,PIECE,11,2500,23305,4195,27500,February
2295,GEISHA MORINGA OIL 225G,PIECE,11,5500,51271,9229,60500,February
2303,GEISHA TRADITIONAL BLACK SOAP 125G,PIECE,11,4000,37288,6712,44000,February
2833,JIK REGULAR 750MLS,PIECE,11,14000,130508,23492,154000,February
3050,KEY HOLDERS 2500,PIECE,11,2500,23305,4195,27500,February
3143,KIWI SHOE POLISH 32G,PIECE,11,5000,46610,8390,55000,February
3322,LATO YOG STRAWBERRY 100G,PIECE,11,1200,11186,2014,13200,February
3560,MAGIC 1KG SACHET,PIECE,11,8500,79237,14263,93500,February
3563,MAGIC 500G BUCKET,PIECE,11,6500,60593,10907,71500,February
3684,MIA GONJA 1000,PIECE,11,1000,9322,1678,11000,February
3745,MIRINDA PINEAPPLE,PIECE,11,1500,13983,2517,16500,February
4056,NEWFARM BANANA JUICE 500ML,PIECE,11,3500,32627,5873,38500,February
4414,OWEN'S G-NUTS 1000,PIECE,11,1000,9322,1678,11000,February
4743,PRINGLES ORIGINAL 40G,PIECE,11,5500,51271,9229,60500,February
5289,SHOE BRUSHES 1500,PIECE,11,1500,13983,2517,16500,February
5743,SUMZ CRUNCHY DADDIES 150G,PIECE,11,3000,27966,5034,33000,February
5744,SUMZ DADDIES 75G 1000,PIECE,11,1500,13983,2517,16500,February
5750,SUMZ GONJA CRISPS 160G,PIECE,11,5500,51271,9229,60500,February
5877,SWEETS 1500 ICECREAMM LOLLIPOP,PIECE,11,1500,13983,2517,16500,February
6129,TOREN CHOCOLATE CLASSIC,PIECE,11,5000,46610,8390,55000,February
6710,VASELINE BLUESEAL COCOA BUTTER 95ML,PIECE,11,5000,46610,8390,55000,February
6996,NATARAJ WAX CRAYONS 2500,PIECE,11,2500,23305,4195,27500,February
7173,D.L FIESTA WHITE 70ML,PIECE,11,3000,27966,5034,33000,February
7379,SUMZ COATED PEANUTS PLAINMASALA 150G,PIECE,11,3000,27966,5034,33000,February
7437,MOODLENA NOODLES BEEF 1000,PIECE,11,1000,9322,1678,11000,February
7524,TOYS 2000,PIECE,11,2045,19068,3432,22500,February
7553,TOYS 3000,PIECE,11,3000,27966,5034,33000,February
842,BROOKSIDE LEMON 250G,PIECE,12,3000,30508,5492,36000,February
843,BROOKSIDE LEMON BISCUITS 450G,PIECE,12,5000,50847,9153,60000,February
845,BROOKSIDE PEAR CARAMEL,PIECE,12,5000,50847,9153,60000,February
846,BROOKSIDE PEAR CARAMEL 250G,PIECE,12,3000,30508,5492,36000,February
918,C.B ROYAL MANGO 200ML,PIECE,12,4500,45763,8237,54000,February
1047,CB CLASSIC VANILLA 200MLS,PIECE,12,4000,40678,7322,48000,February
1270,COLGATE TRIPPLE ACTION 70G,PIECE,12,3500,35593,6407,42000,February
1444,D.L VANILLA CREAM 120MLS,PIECE,12,2000,20339,3661,24000,February
1651,DOLLAR CHOCOLATE 3.5OZ,PIECE,12,3000,30508,5492,36000,February
1823,ECLAIRS,PIECE,12,200,2034,366,2400,February
1914,ERASER RUBBER,PIECE,12,500,5085,915,6000,February
1946,F.D MIXED BERRIES 400G,PIECE,12,2500,25424,4576,30000,February
2028,FANSICKERS COCOA CREAM,PIECE,12,2500,25424,4576,30000,February
2112,FLOWERS 1500,PIECE,12,1500,15254,2746,18000,February
2825,JIB WATER 20LTRS REFILL,PIECE,12,8000,81356,14644,96000,February
3157,KNICKERS 8000,PIECE,12,8000,81356,14644,96000,February
4218,NUMA BUSHERA 1KG,PIECE,12,6500,66102,11898,78000,February
4473,PANT PEG 5000,PIECE,12,5000,50847,9153,60000,February
4552,PERMANENT MAKER,PIECE,12,1000,10169,1831,12000,February
5591,SPLASH APPLE 1LTR,PIECE,12,8000,81356,14644,96000,February
6042,TOCEBAL AA,PIECE,12,1000,10169,1831,12000,February
6709,VASELINE BLUESEAL JELLY ORIGINAL 95ML,PIECE,12,5000,50847,9153,60000,February
7284,SUMZ SALT& VIEGAR,PIECE,12,600,6102,1098,7200,February
7592,COLGATE CHARCOAL 210G 10000,PIECE,12,10000,101695,18305,120000,February
7593,COLGATE CHARCOAL 35G 2500,PIECE,12,2500,25424,4576,30000,February
7620,SPRITE CAN 330ML,PIECE,12,2700,27458,4942,32400,February
71,ALLIANCE LIVEN COFFEE,PIECE,13,3500,38559,6941,45500,February
91,ALWAYS ULTRA THIN,PIECE,13,3500,38559,6941,45500,February
93,ALWAYS V.P EXTRA LONG,PIECE,13,6500,71610,12890,84500,February
718,BLUE BAND LOW SPREAD 250G,PIECE,13,4000,44068,7932,52000,February
832,BRITANIA SHORTCAKE BISCUITS,PIECE,13,2000,22034,3966,26000,February
1551,DETTOL HERBAL 175G,PIECE,13,6500,71610,12890,84500,February
2375,GLUE STICK 21G,PIECE,13,2500,27542,4958,32500,February
2755,JAMIES SWEET CAKE BREAD 500G,PIECE,13,3000,33051,5949,39000,February
2813,JESA VANILLA YOGHURT 500G,PIECE,13,3700,40763,7337,48100,February
3294,LATO MILK 400G,PIECE,13,19000,209322,37678,247000,February
3564,MAGIC 500G SACHET,PIECE,13,4500,49576,8924,58500,February
3609,MARS CHOCOLATE,PIECE,13,3500,38559,6941,45500,February
3946,MUKISA MANDAZI 1000,PIECE,13,1500,16525,2975,19500,February
4192,NOMI BUCKET 500G,PIECE,13,6500,71610,12890,84500,February
4582,PICFARE 96 PGS 11000,PIECE,13,11000,121186,21814,143000,February
4583,PICFARE 96PGS,PIECE,13,1000,11017,1983,13000,February
4948,RIHAM CREAM CHOCOLATE,PIECE,13,1200,13220,2380,15600,February
5293,SHOE BRUSHES 4000,PIECE,13,4154,45763,8237,54000,February
5604,SPLASH MANGO JUICE 1LTR,PIECE,13,8000,88136,15864,104000,February
5626,SPRITE 350MLS,PIECE,13,1000,11017,1983,13000,February
5730,SUMZ COATED PEANUT 50G,PIECE,13,1200,13220,2380,15600,February
6981,BAKEMATE LOVE CHOCOLATE ,PIECE,13,3500,38559,6941,45500,February
7065,BRITANIA SWEET MEAL BISCUITS,PIECE,13,2500,27542,4958,32500,February
7344,COMB 1000,PIECE,13,1000,11017,1983,13000,February
7346,LED TOUCH,PIECE,13,4000,44068,7932,52000,February
7554,AFIA LEMON 500ML,PIECE,13,3000,33051,5949,39000,February
7618,NUVITA SPONGE CAKE 18G,PIECE,13,600,6610,1190,7800,February
271,ART BOOK SMALL,PIECE,14,2000,23729,4271,28000,February
790,BOX FILES 6000,PIECE,14,7000,83051,14949,98000,February
851,BROOMS 1000,PIECE,14,1000,11864,2136,14000,February
1249,COLGATE DOUBLE ACTION,PIECE,14,4000,47458,8542,56000,February
1424,D.L FIESTA SALTED CARAMEL,PIECE,14,4000,47458,8542,56000,February
1472,DAITY DARK'N'DARK ICE CREAM,PIECE,14,5000,59322,10678,70000,February
1484,DATES 1000,PIECE,14,1000,11864,2136,14000,February
1949,F.D PLAIN YOGHURT 400G,PIECE,14,2500,29661,5339,35000,February
1950,F.D PLAIN YOGHURT 450G,PIECE,14,3700,43898,7902,51800,February
1961,F.D UHT MILK 2000,PIECE,14,2000,23729,4271,28000,February
2180,FORTUNE SPAGHETTI 250G,PIECE,14,2000,23729,4271,28000,February
2315,GIFT BAG 4500,PIECE,14,4500,53390,9610,63000,February
2802,JESA STRAWBERRY YOGHURT 500G,PIECE,14,3700,43898,7902,51800,February
3302,LATO MIXED BERRIES 250G,PIECE,14,3000,35593,6407,42000,February
3493,M&G STICK GLUE 1500,PIECE,14,1500,17797,3203,21000,February
3678,MENTOS RAINBOW,PIECE,14,2000,23729,4271,28000,February
3867,MOUSE &RAT TRAPS GREEN,PIECE,14,3000,35593,6407,42000,February
4577,PICFARE 192 PAGES 6000,PIECE,14,6000,71186,12814,84000,February
5235,SESAME SNACKS,PIECE,14,5000,59322,10678,70000,February
5366,SIMKA CHOC- VAN 300ML,PIECE,14,3500,41525,7475,49000,February
5371,SIMKA CHOC-VANILLA 500ML,PIECE,14,4500,53390,9610,63000,February
5759,SUMZ PUMPKIN SEEDS 50G,PIECE,14,2500,29661,5339,35000,February
6798,CADBURY DAIRY MILK 35G,PIECE,14,4000,47458,8542,56000,February
7378,SUMZ COATED PEANUTS CHILLI MASALA 150G,PIECE,14,3000,35593,6407,42000,February
7648,COCKROACH KILLING BAIT 5G,PIECE,14,999,11854,2134,13988,February
86,ALWAYS EXTRA LONG,PIECE,15,3500,44492,8008,52500,February
731,BLUEBAND LOW FAT 100G,PIECE,15,2000,25424,4576,30000,February
947,CADBURY FRUIT&NUT CHOCOLATE 37G,PIECE,15,4000,50847,9153,60000,February
1252,COLGATE HERBAL 140G,PIECE,15,7500,95339,17161,112500,February
1477,DAITY VANILLA ICECREAM,PIECE,15,5500,69915,12585,82500,February
1750,DOWNY FEEL LUX 20ML,PIECE,15,700,8898,1602,10500,February
1932,EVERVESS 500ML,PIECE,15,1500,19068,3432,22500,February
2030,FANTA 330ML CAN,PIECE,15,2700,34322,6178,40500,February
2286,GEISHA ALOE VERA&HONEY,PIECE,15,4000,50847,9153,60000,February
2289,GEISHA COCONUT MILK 200G,PIECE,15,4000,50847,9153,60000,February
2292,GEISHA LEMON&HONEY 125G,PIECE,15,2500,31780,5720,37500,February
2296,GEISHA ROSE&HONEY,PIECE,15,2500,31780,5720,37500,February
2480,HACO RULER ORIGINAL,PIECE,15,2000,25424,4576,30000,February
3133,KIWI BLACK 80G,PIECE,15,8000,101695,18305,120000,February
3304,LATO PEACH&CARAMEL 250G,PIECE,15,3000,38136,6864,45000,February
3306,LATO PLAIN YOGHURT 500G,PIECE,15,3700,47034,8466,55500,February
3319,LATO VANILLA YOGHURT 500G,PIECE,15,3700,47034,8466,55500,February
3562,MAGIC 250G BUCKET,PIECE,15,4000,50847,9153,60000,February
3585,MAMIS PEANUT PASTE 500G,PIECE,15,8000,101695,18305,120000,February
3682,MESSAGE CARDS 500,PIECE,15,500,6356,1144,7500,February
4036,NEEK YOGHURT 500G 3500,PIECE,15,3500,44492,8008,52500,February
6787,VEGETABLE RICE 3500,PIECE,15,2867,36441,6559,43000,February
49,AFIA APPLE 500ML,PIECE,16,3000,40678,7322,48000,February
1941,F.D MANGO 400G,PIECE,16,2500,33898,6102,40000,February
2479,HACO RULER,PIECE,16,2000,27119,4881,32000,February
2663,IMPERIAL LEATHER SOAP RED 175G,PIECE,16,4000,54237,9763,64000,February
3152,KNICKERS 3500,PIECE,16,3500,47458,8542,56000,February
3335,LAVITA PINEAPPLE 320MLS,PIECE,16,1000,13559,2441,16000,February
3378,LIGHTERS,PIECE,16,1000,13559,2441,16000,February
3575,MAKE UP FACIAL WIPES,PIECE,16,3500,47458,8542,56000,February
3674,MENTOS GRAPE,PIECE,16,2063,27966,5034,33000,February
4035,NEEK YOGHURT 300G 2000,PIECE,16,2500,33898,6102,40000,February
4718,PRESTIGE 500G,PIECE,16,7500,101695,18305,120000,February
4953,RIHAM CREAMY STRAWBERRY,PIECE,16,1200,16271,2929,19200,February
5180,SCOURER 1000,PIECE,16,1000,13559,2441,16000,February
5735,SUMZ CORN CRAX 160G,PIECE,16,2500,33898,6102,40000,February
5764,SUMZ SALT&VINEGAR 30G,PIECE,16,1500,20339,3661,24000,February
7163,SPIDERMAN SWEETS 700,PIECE,16,744,10085,1815,11900,February
7365,SUMZ BAGGIA 50G,PIECE,16,1500,20339,3661,24000,February
52,AFIA MIXED FRUIT 500MLS,PIECE,17,3000,43220,7780,51000,February
636,BESSA MILLET DRINK 500MLS,PIECE,17,4500,64831,11669,76500,February
1224,COCACOLA CAN 330ML,PIECE,17,2700,38898,7002,45900,February
1254,COLGATE HERBAL 35G,PIECE,17,2500,36017,6483,42500,February
1910,ENVELOPES 200,PIECE,17,200,2881,519,3400,February
1959,F.D STRAWBERRY MILK 500MLS,PIECE,17,4000,57627,10373,68000,February
1970,F.D VANILLA MILK 500MLS,PIECE,17,4000,57627,10373,68000,February
2414,GOOD DAY CHOCO CHIP,PIECE,17,5000,72034,12966,85000,February
3070,KIDS BOXERS 3000,PIECE,17,3000,43220,7780,51000,February
3315,LATO VANILLA 100G,PIECE,17,1200,17288,3112,20400,February
3321,LATO YOG MIXED BERRIES 450G,PIECE,17,5000,72034,12966,85000,February
3323,LATO YOG STRAWBERRY 250G,PIECE,17,2500,36017,6483,42500,February
3435,LUCOZADE 250MLS,PIECE,17,3000,43220,7780,51000,February
4252,NUTRO WAFERS VANILLA,PIECE,17,3500,50424,9076,59500,February
4535,PEPSI 2LTR,PIECE,17,4500,64831,11669,76500,February
4747,PRINGLES SOUR CREAM 40G,PIECE,17,5500,79237,14263,93500,February
5333,SHUYA 330MM,PIECE,17,6000,86441,15559,102000,February
5376,SIMKA STRAW-VAN 300MLS,PIECE,17,3500,50424,9076,59500,February
5377,SIMKA STRAW-VAN 500MLS,PIECE,17,4500,64831,11669,76500,February
6534,WEETABIX 112G,PIECE,17,4500,64831,11669,76500,February
6988,ELITE BALL PENS 500,PIECE,17,500,7203,1297,8500,February
849,BROOKSIDE STRAWBERRIES 250G,PIECE,18,3000,45763,8237,54000,February
943,CADBURY DREAM WHITE CREAMY 80G,PIECE,18,8000,122034,21966,144000,February
1253,COLGATE HERBAL 230G,PIECE,18,9500,144915,26085,171000,February
1266,COLGATE TOOTHBRUSH 1500,PIECE,18,1500,22881,4119,27000,February
1306,CONTAINERS 3500,PIECE,18,3500,53390,9610,63000,February
1445,D.L VAN-STRAW 120ML,PIECE,18,2000,30508,5492,36000,February
1953,F.D STRAWBERRY 150G,PIECE,18,1800,27458,4942,32400,February
2476,HABARI SALT BIG,PIECE,18,1000,15254,2746,18000,February
2985,KAZIRE ALOEVERA,PIECE,18,1500,22881,4119,27000,February
3737,MIRINDA APPLE 2LTR,PIECE,18,4500,68644,12356,81000,February
3744,MIRINDA ORANGE 500ML,PIECE,18,1500,22881,4119,27000,February
3998,NAIL CUTTERS 1500,PIECE,18,1500,22881,4119,27000,February
5433,SKY VIEW FRUITII 320ML,PIECE,18,1000,15254,2746,18000,February
5521,SOFT CARE BABY WIPES,PIECE,18,7000,106780,19220,126000,February
346,AZAM EMBE MANGO,PIECE,19,1500,24153,4347,28500,February
637,BESSA MILLET MALT DRINK 330ML,PIECE,19,3000,48305,8695,57000,February
1245,COLGATE CHARCOAL GENTLE CLEAN,PIECE,19,7500,120763,21737,142500,February
1485,DATES 2000,PIECE,19,2000,32203,5797,38000,February
3311,LATO STRAWBERRY YOGHURT 500G,PIECE,19,3700,59576,10724,70300,February
3742,MIRINDA ORANGE 2LTRS,PIECE,19,4500,72458,13042,85500,February
4081,NICE CLEAR PENS,PIECE,19,500,8051,1449,9500,February
4581,PICFARE 48PGS,PIECE,19,500,8051,1449,9500,February
5624,SPRING FILE 3000,PIECE,19,3000,48305,8695,57000,February
5667,GOLDER STICK NOTES,PIECE,19,2000,32203,5797,38000,February
5859,SWEET IVORY PCS,PIECE,19,100,1610,290,1900,February
7073,SUMZ TANGY LEMON CRISPS 12G,PIECE,19,600,9661,1739,11400,February
7137,JAMIES COOKIES 2000,PIECE,19,2000,32203,5797,38000,February
7385,RIHAM X-ENERGY 320ML,PIECE,19,1500,24153,4347,28500,February
7746,SWEETS 1500,PIECE,19,1500,24153,4347,28500,February
1265,COLGATE TOOTBRUSH,PIECE,20,2500,42373,7627,50000,February
1431,D.L MINI FIESTA CLASSIC 70MLS,PIECE,20,2500,42373,7627,50000,February
1475,DAITY STRAWBERRY VAN,PIECE,20,5500,93220,16780,110000,February
1911,ENVELOPES 300,PIECE,20,300,5085,915,6000,February
3305,LATO PEACH&CARAMEL FRUIT 450G,PIECE,20,5000,84746,15254,100000,February
4021,NATARAJ COLOR PENCILS,PIECE,20,7500,127119,22881,150000,February
5753,SUMZ POTATO CRISP BBQ 30G,PIECE,20,1500,25424,4576,30000,February
7164,NUTRO ORANGE BISCUIT 1200,PIECE,20,1200,20339,3661,24000,February
1915,ERASER RUBBER BIG,PIECE,21,1000,17797,3203,21000,February
1964,F.D VANILLA 150G,PIECE,21,1800,32034,5766,37800,February
2311,GIFT BAG 2500,PIECE,21,2500,44492,8008,52500,February
2797,JESA STRAW 250G YOGHURT,PIECE,21,2500,44492,8008,52500,February
3964,MUSA'S COOKIES 180G,PIECE,21,3000,53390,9610,63000,February
4082,NICE TOOTHBRUSH,PIECE,21,600,10678,1922,12600,February
6843,PIZZA BEEF SLICE BIG,PIECE,21,5000,88983,16017,105000,February
836,BROOKSIDE FRUIT STRAWBERRIES,PIECE,22,5000,93220,16780,110000,February
1255,COLGATE HERBAL 70G,PIECE,22,4500,83898,15102,99000,February
1937,F.D FLAVOURED CHOCOLATE,PIECE,22,4000,74576,13424,88000,February
2183,FOUNTAIN PEN,PIECE,22,8000,149153,26847,176000,February
2811,JESA VANILLA YOGHURT 250G,PIECE,22,2500,46610,8390,55000,February
3215,KOPIKO CAPPUCCINO CHOCO,PIECE,22,1500,27966,5034,33000,February
4034,NEEK YOGHURT 1LTR,PIECE,22,7000,130508,23492,154000,February
4350,ONER MANGO 1LTR,PIECE,22,5000,93220,16780,110000,February
4896,RED BULL 250MLS,PIECE,22,7000,130508,23492,154000,February
7486,APPLES PACKED 11000,PIECE,22,11000,205085,36915,242000,February
7733,SUMZ MATOOKE CRISPS BBQ 20G,PIECE,22,600,11186,2014,13200,February
648,BIC SHEVARS,PIECE,23,1000,19492,3508,23000,February
1753,DOWNY VALLEY DEW 20ML,PIECE,23,700,13644,2456,16100,February
1958,F.D STRAWBERRY FLAVOURED 250ML,PIECE,23,2000,38983,7017,46000,February
2450,GRAPES 12000,PIECE,23,12000,233898,42102,276000,February
3433,LUCOZADE 1LTR,PIECE,23,10000,194915,35085,230000,February
5593,SPLASH APPLES 150ML,PIECE,23,1500,29237,5263,34500,February
5876,SWEETS 1000,PIECE,23,1000,19492,3508,23000,February
51,AFIA MANGO 500MLS,PIECE,24,3000,61017,10983,72000,February
1166,PICFARE GOLD 96PGS,PIECE,24,1000,20339,3661,24000,February
1607,DIVINE 300MLS,PIECE,24,2500,50847,9153,60000,February
1971,F.D YOGHURT MIXED BERRIES 450G,PIECE,24,3700,75254,13546,88800,February
2952,KAKIRA SUGAR 2KG,PIECE,24,14000,284746,51254,336000,February
3739,MIRINDA FRUITY,PIECE,24,1500,30508,5492,36000,February
3761,MOCACINE SOCKS 2500,PIECE,24,2500,50847,9153,60000,February
3963,MUSA'S BAKERY COOKIES 360G,PIECE,24,5500,111864,20136,132000,February
5050,SAFA TOMATO PASTE 70GM,PIECE,24,1500,30508,5492,36000,February
5481,SNICKERS CHOCOLATE,PIECE,24,3500,71186,12814,84000,February
7688,YAKET TAMARIND FRUIT DRINK 500ML,PIECE,24,1000,20339,3661,24000,February
6876,"GREENS (NAKATI,DODO ETC)",PIECE,24.1,9257,189025,34025,223050,February
1246,COLGATE CHARCOAL TWIN TOOTHBRUSH,PIECE,25,4000,84746,15254,100000,February
2072,FIDODIDO CHOCO-VAN 220ML,PIECE,25,2500,52966,9534,62500,February
2728,JAMIES COCONUT BREAD 500G,PIECE,25,3000,63559,11441,75000,February
6816,BLUE BAND 250G,PIECE,25,5000,105932,19068,125000,February
7296,BANANA JUICE 3000,PIECE,25,3000,63559,11441,75000,February
1423,D.L FIESTA CLASSIC 100MLS,PIECE,26,3500,77119,13881,91000,February
2089,FIDODIDO STRWABERRY 220ML,PIECE,26,2500,55085,9915,65000,February
2716,JAMAA WHITE WASHING BAR,PIECE,26,6000,132203,23797,156000,February
3214,KOPIKO BROWN COFFEE,PIECE,26,1500,33051,5949,39000,February
3458,LUXURY TOILET PAPER,PIECE,26,600,13220,2380,15600,February
3656,MELEX SIMSIM BALLS 2000,PIECE,26,2000,44068,7932,52000,February
4700,POWERPLAY 400MLS,PIECE,26,2000,44068,7932,52000,February
5435,SKY VIEW ORANGE 320ML,PIECE,26,1000,22034,3966,26000,February
5736,SUMZ CORN CRAX 80G,PIECE,26,1500,33051,5949,39000,February
713,BLUE BAND 100G,PIECE,27,2500,57203,10297,67500,February
844,BROOKSIDE MILK 500ML,PIECE,27,2300,52627,9473,62100,February
1935,EXOTIC 320MLS,PIECE,27,1000,22881,4119,27000,February
3944,MUKISA CAKE 2500,PIECE,27,2500,57203,10297,67500,February
4023,NATARAJ PENCILS 6000,PIECE,27,6000,137288,24712,162000,February
4534,PEPSI,PIECE,27,1500,34322,6178,40500,February
5167,SCHOOL SOCKS BLUE&WHITE 4000,PIECE,27,4000,91525,16475,108000,February
5379,SIMKA VANILLA 120MLS,PIECE,27,1000,22881,4119,27000,February
55,AFIA WHITE GUAVA,PIECE,28,3000,71186,12814,84000,February
1942,F.D MANGO 450G,PIECE,28,3700,87797,15803,103600,February
2070,FIDODIDO CHOCOLATE 120ML,PIECE,28,1200,28475,5125,33600,February
3738,MIRINDA APPLE 330ML,PIECE,28,1000,23729,4271,28000,February
4964,RIHAM WATER 1.5LTRS,PIECE,28,2000,47458,8542,56000,February
6101,TOP UP 400G,PIECE,28,2000,47458,8542,56000,February
1969,F.D VANILLA FLAVOURED 250ML,PIECE,29,2000,49153,8847,58000,February
2291,GEISHA LEMON&HONEY,PIECE,29,4000,98305,17695,116000,February
3566,MAGIC SACHET 45G,PIECE,29,500,12288,2212,14500,February
4579,PICFARE 288PAGES 8500,PIECE,29,8000,196610,35390,232000,February
5539,SOFTCARE SANITARY PADS,PIECE,29,3000,73729,13271,87000,February
5609,SPONGE 2000,PIECE,29,2000,49153,8847,58000,February
5739,SUMZ CRISPS CHILLI 60G,PIECE,29,2500,61441,11059,72500,February
7279,JUICE 4000 500ml,PIECE,29,4000,98305,17695,116000,February
7404,MELEX SIMSIM BALLS 250G,PIECE,29,5000,122881,22119,145000,February
1176,CLEAR BAG 1000,PIECE,30,1000,25424,4576,30000,February
2799,JESA STRAW YOGHURT 400G,PIECE,30,2500,63559,11441,75000,February
3655,MELEX SIMSIM BALLS 1000,PIECE,30,1000,25424,4576,30000,February
5477,SMILE PENS WAVE 500,PIECE,30,500,12712,2288,15000,February
5602,SPLASH MANGO 150ML,PIECE,30,1500,38136,6864,45000,February
2060,FAY TP,PIECE,31,2000,52542,9458,62000,February
5811,SUNSHINE TOMATO FLAVOR,PIECE,31,500,13136,2364,15500,February
7703,TOYS 1000,PIECE,31,1000,26271,4729,31000,February
7745,CHOCOLATE 800,PIECE,31,800,21017,3783,24800,February
4965,RIHAM WATER 600ML,PIECE,32,1000,27119,4881,32000,February
5345,SILKEE DESIGNER SERVIETTES,PIECE,32,2500,67797,12203,80000,February
5808,SUNSHINE CHICKEN FLAVOR,PIECE,32,500,13559,2441,16000,February
7165,ONER APPLE DRINK 1LTR,PIECE,32,5000,135593,24407,160000,February
1334,COVERTINA CHOCOLATE 500,PIECE,33,500,13983,2517,16500,February
1966,F.D VANILLA 250G,PIECE,33,2500,69915,12585,82500,February
4937,RIBENA 250MLS,PIECE,33,3000,83898,15102,99000,February
6943,SUMZ POTATO CRISPS FRUIT CHUTNEY 12G,PIECE,33,600,16780,3020,19800,February
348,AZAM MALT 300MLS,PIECE,34,1500,43220,7780,51000,February
1931,EVERVESS,PIECE,34,1000,28814,5186,34000,February
2342,GILLETTE BLUE2 PLUS,PIECE,34,2500,72034,12966,85000,February
4615,PK CHEWING GUM 500,PIECE,34,500,14407,2593,17000,February
4717,PRESTIGE 250G,PIECE,34,4500,129661,23339,153000,February
4945,RIHAM COFFEE MALT,PIECE,34,1500,43220,7780,51000,February
5634,SQUISHY FRUIT DRINK 200ML,PIECE,34,2000,57627,10373,68000,February
347,AZAM ENERGY DRINK 300MLS,PIECE,35,1500,44492,8008,52500,February
3729,MINUTEMAID BERRY BLAST 1LTR,PIECE,35,5000,148305,26695,175000,February
4047,NESCAFE CLASSIC SACHETS 1.6G,PIECE,35,500,14831,2669,17500,February
5636,SQUISHY STRAWBERRY 200ML,PIECE,35,2000,59322,10678,70000,February
6272,UBISCO CREAMS VANILLA,PIECE,35,1000,29661,5339,35000,February
6612,YAKET 1.5LTR,PIECE,35,1500,44492,8008,52500,February
7704,JAMIES MILK BREAD 5500,PIECE,35,5871,174153,31347,205500,February
2729,JAMIE'S COOKIE SCONES,PIECE,36,2000,61017,10983,72000,February
2801,JESA STRAWBERRY MILK 200MLS,PIECE,36,1500,45763,8237,54000,February
3862,MOUNTAIN DEW,PIECE,36,1500,45763,8237,54000,February
5090,SANTA LUCIA 250G,PIECE,36,2500,76271,13729,90000,February
2809,JESA VANILLA FLAVOURED 200ML,PIECE,37,1500,47034,8466,55500,February
4711,PREDATOR ENERGY DRINK,PIECE,37,2000,62712,11288,74000,February
5592,SPLASH APPLE 250MLS,PIECE,37,2000,62712,11288,74000,February
1608,DIVINE 500MLS,PIECE,38,4000,128814,23186,152000,February
5749,SUMZ GONJA 90G CRISPS,PIECE,38,3000,96610,17390,114000,February
5807,SUNSHINE BEEF FLAVOR,PIECE,38,500,16102,2898,19000,February
1029,CARROT CAKE,PIECE,39,5000,165254,29746,195000,February
3284,LATO CHOCO PWDER MILK 15G,PIECE,39,500,16525,2975,19500,February
3722,MINUTE MAID APPLE 400ML,PIECE,39,2500,82627,14873,97500,February
3863,MOUNTAIN DEW 2LTR,PIECE,39,4500,148729,26771,175500,February
4537,PEPSI MAX,PIECE,39,1000,33051,5949,39000,February
5717,SUGAR 1KG,PIECE,39,6500,214831,38669,253500,February
5754,SUMZ POTATO CRISPS 180G,PIECE,39,5000,165254,29746,195000,February
5810,SUNSHINE PLAIN FLAVOR,PIECE,39,500,16525,2975,19500,February
7143,GRAVY SOUP 1000,PIECE,39.79,999,33678,6062,39740,February
2812,JESA VANILLA YOGHURT 400G,PIECE,40,2500,84746,15254,100000,February
5672,STING RED RUSH,PIECE,40,2000,67797,12203,80000,February
5674,STONEY 500MLS,PIECE,40,1500,50847,9153,60000,February
1955,F.D STRAWBERRY 250G,PIECE,41,2500,86864,15636,102500,February
3736,MIRINDA APPLE,PIECE,41,1500,52119,9381,61500,February
5367,SIMKA CHOCO BAR 100MLS,PIECE,41,2500,86864,15636,102500,February
5436,SKYVIEW 320MLS,PIECE,41,1000,34746,6254,41000,February
5625,SPRITE 2LTR,PIECE,41,5000,173729,31271,205000,February
7278,JUICE 2000 300ML,PIECE,41,2000,69492,12508,82000,February
5635,SQUISHY FRUIT DRINK MANGO 200ML,PIECE,42,2000,71186,12814,84000,February
6464,VIGOS HAZELNUT CHOCOLATE 800,PIECE,42,800,28475,5125,33600,February
6894,SQUISHY JUICE APPLE,PIECE,42,2000,71186,12814,84000,February
7647,SKY VIEW APPLE 320ML,PIECE,42,1000,35593,6407,42000,February
1960,F.D UHT 200ML MILK,PIECE,43,1000,36441,6559,43000,February
2681,INDOMIE BEEF 70G,PIECE,43,1200,43729,7871,51600,February
2684,INDOMIE NOODLES CHICKEN 120G,PIECE,43,2000,72881,13119,86000,February
4364,ORANGES 2000,PIECE,43,2500,91102,16398,107500,February
5380,SIMKA VANILLA 230MLS,PIECE,43,2000,72881,13119,86000,February
4045,NESCAFE CLASSIC 2G,PIECE,44,500,18644,3356,22000,February
4209,NOVIDA 500MLS,PIECE,44,1500,55932,10068,66000,February
4616,PK CHEWING GUM BIG,PIECE,44,1000,37288,6712,44000,February
5809,SUNSHINE ONION FLAVOR,PIECE,44,500,18644,3356,22000,February
4236,NUTRO CHOCOLATE BISCUITS,PIECE,45,1200,45763,8237,54000,February
6280,UBISCO KREAMY CREAMS STRAWBERRY,PIECE,45,1000,38136,6864,45000,February
1289,COMPACT T.P,PIECE,46,1000,38983,7017,46000,February
2682,INDOMIE BEEF NOODLES 120G,PIECE,46,2000,77966,14034,92000,February
3740,MIRINDA FRUITY 2LTR,PIECE,46,4500,175424,31576,207000,February
6976,SUMZ POTATO CRIPS TASTY TOMATO 30G,PIECE,46,1500,69000,0,69000,February
5673,STONEY 350MLS,PIECE,48,1000,40678,7322,48000,February
5633,SQUISHY BLUE RASBERRY 200ML,PIECE,49,2000,83051,14949,98000,February
6859,ROLEX NORMAL 2EGGS,PIECE,49,2500,103814,18686,122500,February
6871,POSHO KG,PIECE,49.38,5420,226814,40826,267640,February
1169,CLASSIC G.B.K WHOLE MILK 500ML,PIECE,51,2200,95085,17115,112200,February
2234,FRUITVILLE GUAVA 500ML,PIECE,51,3500,151271,27229,178500,February
1968,F.D VANILLA 450G,PIECE,52,3700,163051,29349,192400,February
1957,F.D STRAWBERRY 450G,PIECE,54,3700,169322,30478,199800,February
3690,MIKOSHI GREEN TEA,PIECE,55,6000,279661,50339,330000,February
5748,SUMZ GONJA 40G,PIECE,55,1500,69915,12585,82500,February
5879,SWEETS 300,PIECE,55,300,13983,2517,16500,February
3285,LATO CHOCOLATE MILK 250MLS,PIECE,56,2000,94915,17085,112000,February
5671,STING,PIECE,56,2000,94915,17085,112000,February
7130,JAMIES MUFFINS 2000,PIECE,56,2000,94915,17085,112000,February
3217,KREST 500MLS,PIECE,57,1500,72458,13042,85500,February
3299,LATO MILK PWDER STRAWBERRY 15G,PIECE,57,500,24153,4347,28500,February
6271,UBISCO CREAMS CHOCOLATE,PIECE,57,1000,48305,8695,57000,February
6572,WHITE STAR SOAP 1KG,PIECE,57,7000,338136,60864,399000,February
7431,JAMIES MARBLE CAKE 10000,PIECE,58,10000,491525,88475,580000,February
1464,DAIRY TOP YOGHURT STRAWBERRY 250G,PIECE,61,1000,51695,9305,61000,February
2029,FANTA 2LTRS ORANGE,PIECE,61,5000,258475,46525,305000,February
3743,MIRINDA ORANGE 330ML,PIECE,61,1000,51695,9305,61000,February
5356,SILVER PLATE 500,PIECE,62,500,26271,4729,31000,February
6613,YAKET 550ML,PIECE,62,500,26271,4729,31000,February
3310,LATO STRAWBERRY MILK 250MLS,PIECE,63,2000,106780,19220,126000,February
6776,KEBAB 3000,PIECE,63,3000,160169,28831,189000,February
3324,LATO YOGHURT 400G VANILLA,PIECE,64,2500,135593,24407,160000,February
5864,SWEET PEPSI,PIECE,66,100,5593,1007,6600,February
2727,JAMIES COCONUT BREAD 1KG,PIECE,67,5500,312288,56212,368500,February
4024,NATARAJ PENS,PIECE,68,700,40339,7261,47600,February
7397,JAMIES SWEET YELLOW 500G WHOLE SALE 2500,PIECE,68,2500,144068,25932,170000,February
2032,FANTA 500MLS,PIECE,69,1500,87712,15788,103500,February
2950,KAKIRA SUGAR 1KG,PIECE,69,7000,409322,73678,483000,February
4956,RIHAM EXOTIC TAMARIND,PIECE,69,1000,58475,10525,69000,February
6310,UKWAJU,PIECE,69,1500,87712,15788,103500,February
3317,LATO VANILLA MILK 250MLS,PIECE,70,2000,118644,21356,140000,February
3326,LATO YOGHURT STRAWBERRY 400G,PIECE,70,2500,148305,26695,175000,February
4575,PIAO PIAO TP ORIGINAL,PIECE,72,2000,122034,21966,144000,February
6643,YOJUS MANGO 150ML,PIECE,72,1000,61017,10983,72000,February
6695,JAMIES CAKE SLICE @6k,PIECE,72,6000,366102,65898,432000,February
6799,SPRING ROLLS VEGETABLE 1000,PIECE,72,1000,61017,10983,72000,February
2085,FIDODIDO STRAW-VAN 120MLS,PIECE,73,1200,74237,13363,87600,February
2203,FRESH DAIRY MILK UHT 500ML,PIECE,74,2000,125424,22576,148000,February
5627,SPRITE 500MLS,PIECE,74,1500,94068,16932,111000,February
5758,SUMZ POTATO CRISPS TASTY TOMATO12G,PIECE,74,600,37627,6773,44400,February
2739,JAMIES HOT DOG BUNS 6PCS,PIECE,75,4000,254237,45763,300000,February
2498,HANKIES 3000,PIECE,76,3000,193220,34780,228000,February
7139,SUMZ BBQ CRISPS 12G,PIECE,76,600,38644,6956,45600,February
2754,JAMIES SWEET CAKE BREAD 1KG,PIECE,77,5500,358898,64602,423500,February
7587,ONER TAMARIND 300ML,PIECE,77,1500,97881,17619,115500,February
7650,JAMIES SWEET WHITE BUNS @4000,PIECE,77,4000,261017,46983,308000,February
824,BRITANIA MILK BISCUIT,PIECE,78,500,33051,5949,39000,February
6841,PIZZA CHICKEN SLICE BIG ,PIECE,79,6000,401695,72305,474000,February
7374,JAMIES WHOLE SALE SWEET YELLOW 5000,PIECE,81,5000,343220,61780,405000,February
1967,F.D VANILLA 400G,PIECE,82,2500,173729,31271,205000,February
7410,ONER TAMARIND 500ML,PIECE,84,2500,177966,32034,210000,February
2033,FANTA FRUIT BLAST 350ML,PIECE,85,1000,72034,12966,85000,February
563,BALOON 300,PIECE,86,300,21864,3936,25800,February
4536,PEPSI 330ML,PIECE,87,1000,73729,13271,87000,February
5882,SWEETS 700 BIG FIVE,PIECE,87,709,52288,9412,61700,February
3061,KICK SNACKS TOMATO FLAVOUR 15G,PIECE,88,500,37288,6712,44000,February
7398,JAMIES SWEET BROWN 500G WHOLE SALE 2500,PIECE,88,2500,186441,33559,220000,February
1223,COCACOLA 500MLS,PIECE,89,1500,113136,20364,133500,February
4248,NUTRO VANILLA 30G,PIECE,89,1200,90508,16292,106800,February
4961,RIHAM ONER MANGO 300ml,PIECE,89,1500,113136,20364,133500,February
4888,REBEX RICH MILK STICK BISCUITS,PIECE,90,1200,91525,16475,108000,February
4984,ROCK BOOM 320MLS,PIECE,90,2000,152542,27458,180000,February
7375,JAMIES WHOLE SALE SWEET BROWN 5000,PIECE,90,5000,381356,68644,450000,February
7656,JAMIES MANDAZ 1000,PIECE,90,1000,76271,13729,90000,February
1221,COCACOLA 2LTRS,PIECE,91,5000,385593,69407,455000,February
3316,LATO VANILLA 125ML MILK,PIECE,91,1000,77119,13881,91000,February
3361,LEMON CAKES 1000,PIECE,91,1200,92542,16658,109200,February
826,BRITANIA MUNCHIES BISCUITS,PIECE,92,500,38983,7017,46000,February
3296,LATO MILK CHOCOLATE 125ML FLAVOURED,PIECE,92,1000,77966,14034,92000,February
6808,CRACKERS 1500,PIECE,92,2000,155932,28068,184000,February
3721,MINUTE MAID 1LTRS,PIECE,94,5000,398305,71695,470000,February
1855,EGGS PIECES,PIECE,95,500,40254,7246,47500,February
2514,HARMONY POT WATER 1LTR,PIECE,98,2000,166102,29898,196000,February
3723,MINUTE MAID BERRY BLAST 400MLS,PIECE,98,2500,207627,37373,245000,February
5354,SILVER PLATE 1000,PIECE,98,1000,83051,14949,98000,February
5757,SUMZ POTATO CRISPS 90G,PIECE,99,3000,251695,45305,297000,February
3060,KICK SNACKS CHICKEN,PIECE,100,500,42373,7627,50000,February
7144,JAMIES DOUGHNUT BIG CHOCOLATE 2500,PIECE,101,2500,213983,38517,252500,February
3309,LATO STRAWBERRY MILK 125MLS,PIECE,105,1000,88983,16017,105000,February
5603,SPLASH MANGO 250MLS,PIECE,106,2000,179661,32339,212000,February
3741,MIRINDA FRUITY 330MLS,PIECE,109,1000,92373,16627,109000,February
1963,F.D VANILLA 100G,PIECE,110,1200,111864,20136,132000,February
2736,JAMIES COOKIES 4000,PIECE,111,4000,376271,67729,444000,February
4349,ONER BERRIES JUICE DRINK,PIECE,111,2500,235169,42331,277500,February
4351,ONER MANGO 500MLS,PIECE,111,2500,235169,42331,277500,February
3864,MOUNTAIN DEW 300MLS,PIECE,113,1000,95763,17237,113000,February
4208,NOVIDA 350MLS,PIECE,115,1000,97458,17542,115000,February
2805,JESA UHT FINO,PIECE,116,2000,196610,35390,232000,February
7376,JAMIES WHOLE SALE SWEET WHITE 5000,PIECE,117,5000,495763,89237,585000,February
7370,JAMIES SCONES WHOLESALE 1000,PIECE,120,1000,101695,18305,120000,February
3327,LATO YOGHURT VANILLA 200G,PIECE,122,1000,103390,18610,122000,February
5369,SIMKA CHOC-VAN 230MLS,PIECE,122,2000,206780,37220,244000,February
2748,JAMIES QUEEN CAKES 6PCS 3000,PIECE,123,3500,364831,65669,430500,February
2431,GORILLO'S CHILLI TOMATO 24G,PIECE,126,500,53390,9610,63000,February
7142,JAMIES MARBLE CAKE 3000,PIECE,127,3000,322881,58119,381000,February
1956,F.D STRAWBERRY 400G,PIECE,128,2500,271186,48814,320000,February
182,APPLES GREEN,PIECE,132,1500,167797,30203,198000,February
4131,NIVANA WATER 1.5L,PIECE,132,1500,167797,30203,198000,February
5878,SWEETS 200,PIECE,132,200,22373,4027,26400,February
2683,INDOMIE NOODLES 70G,PIECE,133,1200,135254,24346,159600,February
3325,LATO YOGHURT SRAWBERRY 200G,PIECE,137,1000,116102,20898,137000,February
3725,Minute maid mango,PIECE,138,2500,292373,52627,345000,February
7396,JAMIES SWEET WHITE WHOLESALE 500G 2500,PIECE,138,2500,292373,52627,345000,February
2763,JAMIES SWEET YELLOW BUNS 6PCS,PIECE,139,3500,412288,74212,486500,February
4347,ONER APPLE JUICE DRINK,PIECE,139,2500,294492,53008,347500,February
2752,JAMIES SWEET BROWN BREAD 500G,PIECE,141,3000,358475,64525,423000,February
2758,JAMIES SWEET WHITE BUNS 12PCS,PIECE,142,3500,421186,75814,497000,February
5375,SIMKA STRAW-VAN 230MLS,PIECE,142,2000,240678,43322,284000,February
1952,F.D STRAWBERRY 100G,PIECE,143,1200,145424,26176,171600,February
6775,CHAPS 3000,PIECE,145,3000,368644,66356,435000,February
6784,LIVER STEW 8000,PIECE,145.42,7625,939661,169139,1108800,February
4960,RIHAM ONER APPLE 300ML,PIECE,146,1500,185593,33407,219000,February
5368,SIMKA CHOC-VAN 120MLS,PIECE,149,1000,126271,22729,149000,February
2513,HARMONY POT WATER,PIECE,150,1000,127119,22881,150000,February
647,BIC PENS,PIECE,151,700,89576,16124,105700,February
4348,ONER BERRIES 300ML,PIECE,152,1500,193220,34780,228000,February
2761,JAMIES SWEET YELLOW BREAD 500G,PIECE,163,3000,414407,74593,489000,February
1134,CHOCOLATE 500,PIECE,167,500,70763,12737,83500,February
2734,JAMIES DOUGH NUTS HUGE,PIECE,171,2000,289831,52169,342000,February
2740,JAMIES MANDAZ 8PCS,PIECE,173,3000,439831,79169,519000,February
6813,GRILLED CHICKEN 7000,PIECE,173,7000,1026271,184729,1211000,February
2759,JAMIES SWEET WHITE BUNS 6PCS,PIECE,174,3368,496610,89390,586000,February
2792,JESA MILK 1LTR,PIECE,175,3600,533898,96102,630000,February
2718,JAMIES BROWN BUNS 6PCS,PIECE,177,3342,501271,90229,591500,February
5043,RWENZORI WATER 500ML,PIECE,181,1000,153390,27610,181000,February
6970,YAM SLICE 1000,PIECE,183,1000,155085,27915,183000,February
2757,JAMIES SWEET WHITE BREAD 500,PIECE,191,3000,485593,87407,573000,February
7497,JAMIES SWEET BUNS BROWN 6PCS WHOLESALE,PIECE,193,2500,408898,73602,482500,February
7727,JAMIES SWEET WHITE BUNS WHOLESALE,PIECE,193,2500,482500,0,482500,February
1286,COMFORT T.P 1000,PIECE,198,1000,167797,30203,198000,February
7430,JAMIES SWEET YELLOW BUNS WHOLESALE 2500,PIECE,202,2500,427966,77034,505000,February
3298,LATO MILK POWDER 15G,PIECE,213,500,90254,16246,106500,February
2031,FANTA 330MLS,PIECE,217,1000,183898,33102,217000,February
5756,SUMZ POTATO CRISPS 40G,PIECE,226,1500,287288,51712,339000,February
2427,GORILLO'S BBQ BEEF 24G,PIECE,233,500,98729,17771,116500,February
6820,BEEF SAMOSA 1500,PIECE,254,1500,322881,58119,381000,February
5347,SILKEE JUMBO TP,PIECE,255,2000,432203,77797,510000,February
6773,VEGETABLE SAMOSA 1000,PIECE,256,1000,216949,39051,256000,February
2751,JAMIES SWEET BROWN BREAD1KG,PIECE,268,5500,1249153,224847,1474000,February
6840,GONJA FRIED 1000,PIECE,268,1000,227119,40881,268000,February
5036,RWENZORI 1.5LTRS,PIECE,271,2000,459322,82678,542000,February
6807,BEAN STEW 2000,PIECE,283.92,1975,475322,85558,560880,February
6779,PILAO PLAIN 10000,PIECE,284.96,10000,2414915,434685,2849600,February
6868,SPAGHETI 2500,PIECE,292,2497,617966,111234,729200,February
5881,SWEETS 500,PIECE,296,507,127203,22897,150100,February
6781,VEGETABLE RICE 7000,PIECE,298.28,6912,1747203,314497,2061700,February
6790,KATOGO 4000,PIECE,299.62,3995,1014297,182573,1196870,February
5755,SUMZ POTATO CRISPS 20G,PIECE,303,600,154068,27732,181800,February
5374,SIMKA STRAW-VAN 120MLS,PIECE,307,1000,260169,46831,307000,February
1222,COCACOLA 350MLS,PIECE,321,1000,272034,48966,321000,February
2744,JAMIES MUFFINS,PIECE,343,1500,436017,78483,514500,February
4128,NIVANA 500MLS,PIECE,345,500,146186,26314,172500,February
7026,CHICKEN STEW 4000,PIECE,350,4000,1186441,213559,1400000,February
6889,EGGS BOILED 500,PIECE,416,500,176271,31729,208000,February
2429,GORILLO'S CHICKEN 24G,PIECE,440,500,186441,33559,220000,February
6792,CHIPS 2500,PIECE,465.85,2502,987780,177800,1165580,February
6805,PANCAKES 500,PIECE,470,500,199153,35847,235000,February
5875,SWEETS 100,PIECE,480,100,40678,7322,48000,February
2760,JAMIES SWEET YELLOW BREAD 1KG,PIECE,504,5500,2349153,422847,2772000,February
2756,JAMIES SWEET WHITE BREAD 1KG,PIECE,505,5500,2353814,423686,2777500,February
6812,BEEF STEW 6000,PIECE,567,2004,962712,173288,1136000,February
183,APPLES RED,PIECE,575,1500,730932,131568,862500,February
2735,JAMIES DOUGH NUTS SMALL 4000,PIECE,576,3000,1464407,263593,1728000,February
2793,JESA MILK 500ML,PIECE,1114,1800,1699322,305878,2005200,February
6788,BEEF SAUSAGES 1000,PIECE,1413.01,1000,1197464,215544,1413008,February
6821,CHAPATI 1000,PIECE,2566,1000,2174576,391424,2566000,February
3,10LTR JERRICAN 6000,PIECE,1,6500,5508,992,6500,March
61,AFROCARE JELLY 100G,PIECE,1,3000,2542,458,3000,March
62,AFROCARE PERFUMED GLYCERINE,PIECE,1,2500,2119,381,2500,March
98,AMARA ALOEVERA 400ML,PIECE,1,8500,7203,1297,8500,March
103,AMARA COCOA BUTTER 200ML,PIECE,1,6000,5085,915,6000,March
110,AMARA HYDRATING GLYCERINE 200ML,PIECE,1,6000,5085,915,6000,March
116,AMARA RAW SHEA LOTION 400ML,PIECE,1,8500,7203,1297,8500,March
118,AMARA REJUVENATING ALOE 200ML,PIECE,1,6000,5085,915,6000,March
119,AMARA UNSCENTED 100G,PIECE,1,3500,2966,534,3500,March
127,AMERICAN GARDEN KETCHUP 425G,PIECE,1,13500,11441,2059,13500,March
141,AMERICAN NATURAL SESAME OIL 500G,PIECE,1,23000,19492,3508,23000,March
154,AMRAF HIGH STREET MIST,PIECE,1,14000,11864,2136,14000,March
175,ANTOL SOAP 75G,PIECE,1,3000,2542,458,3000,March
179,APPLE CIDER VINEGAR 473MLS,PIECE,1,11000,9322,1678,11000,March
186,APTAMIL 1 400G,PIECE,1,52000,44068,7932,52000,March
208,ARIEL COLOR 1KG,PIECE,1,15500,13136,2364,15500,March
215,ARIEL ORIGINAL 1KG,PIECE,1,15500,13136,2364,15500,March
216,ARIEL ORIGINAL 500G,PIECE,1,8000,6780,1220,8000,March
219,ARMAF AIR FRESHNER SUMMER,PIECE,1,10000,8475,1525,10000,March
225,ARMAF ENCHANTED FOLIAGE A.F,PIECE,1,8000,6780,1220,8000,March
312,AUNT PORRIDGE 2KG,PIECE,1,28000,23729,4271,28000,March
340,AXION LEMON 200G,PIECE,1,6000,5085,915,6000,March
343,AXION PASTE LIME,PIECE,1,6000,5085,915,6000,March
384,BABY BOTTLE 7000,PIECE,1,7000,5932,1068,7000,March
431,BABY FEEDING CUPS 7000,PIECE,1,7000,5932,1068,7000,March
435,BABY FORKS 2000,PIECE,1,2000,1695,305,2000,March
497,BABY& ME BABYJELLY 240ML,PIECE,1,5000,4237,763,5000,March
501,BABY&ME JELLY 120ML,PIECE,1,3000,2542,458,3000,March
517,BALIKIS FISH MASALA,PIECE,1,3500,2966,534,3500,March
524,BALLET ACTIVE VITAMIN 300MLS,PIECE,1,9500,8051,1449,9500,March
525,BALLET ALMOMD OIL 125ML,PIECE,1,9500,8051,1449,9500,March
532,BALLET BABY LOTION 240ML,PIECE,1,12000,10169,1831,12000,March
533,BALLET BABY MILK SOAP,PIECE,1,4000,3390,610,4000,March
562,BALLS SOFT 1000,PIECE,1,2000,1695,305,2000,March
588,BASKETS 2500,PIECE,1,2500,2119,381,2500,March
589,BASKETS 3000,PIECE,1,3000,2542,458,3000,March
631,BELTS 12000,PIECE,1,12000,10169,1831,12000,March
639,BEST RULER 1000,PIECE,1,1000,847,153,1000,March
654,BIG BOSS FOR MEN 100ML,PIECE,1,3000,2542,458,3000,March
659,BIKERS ST MICHAEL 10000,PIECE,1,10000,8475,1525,10000,March
666,BIRTHDAY CROWN 1500,PIECE,1,1500,1271,229,1500,March
674,BIRTHDAY LETTERS 5000,PIECE,1,5000,4237,763,5000,March
681,BIYINZIKA CHICKEN GIZZARDS 500G,PIECE,1,11000,9322,1678,11000,March
687,BIYINZIKA MUCHOMO 1.5KG,PIECE,1,28000,23729,4271,28000,March
688,BIYINZIKA STANDARD1.2KG,PIECE,1,25000,21186,3814,25000,March
692,BIYINZINKA LIVER 500G,PIECE,1,6000,5085,915,6000,March
725,BLUE LAGOON PASSION SPLASH,PIECE,1,17000,14407,2593,17000,March
732,BLUEBAND PEANUT BUTTER,PIECE,1,8000,6780,1220,8000,March
744,BODYLUXE JELLY 100G,PIECE,1,3000,2542,458,3000,March
751,BOTTLE 10000,PIECE,1,10000,8475,1525,10000,March
765,BOTTLES 12000,PIECE,1,12000,10169,1831,12000,March
768,BOTTLES 13000,PIECE,1,13000,11017,1983,13000,March
770,BOTTLES 16000,PIECE,1,16000,13559,2441,16000,March
771,BOTTLES 18000,PIECE,1,18000,15254,2746,18000,March
774,BOTTLES 5000,PIECE,1,5000,4237,763,5000,March
793,BRAINS CHESS,PIECE,1,40000,33898,6102,40000,March
815,BRITANIA ASSORTED 1KG,PIECE,1,20000,16949,3051,20000,March
817,BRITANIA BUTTER 1KG,PIECE,1,20000,16949,3051,20000,March
838,BROOKSIDE FRUIT VANILLA 250G,PIECE,1,3000,2542,458,3000,March
860,BRUT SPRAY SPORT STYLE,PIECE,1,13000,11017,1983,13000,March
867,BUCKET 8000,PIECE,1,8000,6780,1220,8000,March
870,BUCKETS BIG 25000,PIECE,1,25000,21186,3814,25000,March
895,C A PURE RED BODY SPRAY,PIECE,1,10000,8475,1525,10000,March
904,C.B CLASSIC VANILLA 1LTR,PIECE,1,19500,16525,2975,19500,March
946,CADBURY FRUIT & NUT 80G,PIECE,1,8000,6780,1220,8000,March
955,CAKE BOARD 3000,PIECE,1,3000,2542,458,3000,March
958,CAKE BOX 3000,PIECE,1,3000,2542,458,3000,March
959,CAKE BOX 3500,PIECE,1,3500,2966,534,3500,March
994,CANDLES 2400,PIECE,1,2500,2119,381,2500,March
1008,CAR POLICE 12000 NO.3008,PIECE,1,12000,10169,1831,12000,March
1009,CAR TOYS 8000,PIECE,1,8000,6780,1220,8000,March
1015,CAR TOYS 6000,PIECE,1,6000,5085,915,6000,March
1020,CARDS 2500,PIECE,1,2500,2119,381,2500,March
1038,CASIO 401/991MS CALCULATOR,PIECE,1,45000,38136,6864,45000,March
1053,CB MAGIC S-BERRY 200MLS,PIECE,1,4000,3390,610,4000,March
1058,CELOTAPE 2000,PIECE,1,2500,2119,381,2500,March
1063,CELOTAPE MEDIUM,PIECE,1,5000,4237,763,5000,March
1066,CERELAC 12MONTHS 400G,PIECE,1,27000,22881,4119,27000,March
1110,CHELSEA CROWN PERFUME,PIECE,1,10000,8475,1525,10000,March
1166,PICFARE GOLD 96PGS,PIECE,1,1000,847,153,1000,March
1171,CLASSIC MILK BOX 23000,BOX,1,24000,20339,3661,24000,March
1176,CLEAR BAG 1000,PIECE,1,1000,847,153,1000,March
1187,CLERE BABY JELLY 250G,PIECE,1,5000,4237,763,5000,March
1189,CLERE FOR MEN ICE 250G,PIECE,1,6000,5085,915,6000,March
1194,CLERE PETROLEUM JELLY100G,PIECE,1,3000,2542,458,3000,March
1215,CLUB DE NUIT MAN SPLASH,PIECE,1,14000,11864,2136,14000,March
1219,COBWEB 7000,PIECE,1,7000,5932,1068,7000,March
1279,COMB WITH MIRROR 1500,PIECE,1,1500,1271,229,1500,March
1280,COMB WITH MIRROR 2500,PIECE,1,2500,2119,381,2500,March
1338,COVERTINA MILK CHOCOLATE,PIECE,1,3500,2966,534,3500,March
1344,COW & GATE 2,PIECE,1,44000,37288,6712,44000,March
1363,CROWN PERFUME LOVELY,PIECE,1,12000,10169,1831,12000,March
1377,CUPS 5000,PIECE,1,5000,4237,763,5000,March
1391,CUSSONS BABY OIL 100MLS,PIECE,1,9000,7627,1373,9000,March
1419,D.L BLUEBERRY SWIRL 500ML,PIECE,1,10000,8475,1525,10000,March
1423,D.L FIESTA CLASSIC 100MLS,PIECE,1,3500,2966,534,3500,March
1457,DAIRIES 12000,PIECE,1,12000,10169,1831,12000,March
1473,DAITY ICEPRESSO COFFE,PIECE,1,2500,2119,381,2500,March
1492,DEAR BODY KISSING MIGGLE BODY MIST,PIECE,1,16000,13559,2441,16000,March
1499,DEAR BODY SUNDAY BODY MIST,PIECE,1,16000,13559,2441,16000,March
1501,DEAR BODY TUESDAY BODY MIST,PIECE,1,16000,13559,2441,16000,March
1502,DEAR BODY WARM&PLEASANT,PIECE,1,16000,13559,2441,16000,March
1555,DETTOL LIQUID 50MLS,PIECE,1,4000,3390,610,4000,March
1599,DISPOSABLE PLATES 12000,PIECE,1,12000,10169,1831,12000,March
1600,DISPOSABLE PLATES 6000,PIECE,1,6000,5085,915,6000,March
1634,DOLBY SPRAY,PIECE,1,12000,10169,1831,12000,March
1642,DOLL 3000,PIECE,1,3000,2542,458,3000,March
1649,DOLL BAY 15000,PIECE,1,15000,12712,2288,15000,March
1652,DOLLS 12000,PIECE,1,12000,10169,1831,12000,March
1656,DOLLS BABY 35000,PIECE,1,35000,29661,5339,35000,March
1659,DOLLS MOTHER 6000,PIECE,1,6000,5085,915,6000,March
1672,DONGYA PADLOCK 94MM,PIECE,1,40000,33898,6102,40000,March
1734,DOVE ROLLON GRAPEFRUIT,PIECE,1,11000,9322,1678,11000,March
1738,"DOVE SHOWER GELS SECRETS,DEEPLY,PISTACHIO",PIECE,1,27000,22881,4119,27000,March
1768,DURACELL AA ORIGINAL,PIECE,1,7000,5932,1068,7000,March
1779,DURU FRESH SENSATION 4PCS,PIECE,1,16000,13559,2441,16000,March
1783,DURU MISKET 4PCS,PIECE,1,16000,13559,2441,16000,March
1786,DURU NATURAL OLIVE 720G,PIECE,1,18000,15254,2746,18000,March
1790,DURU REFRESHING LEMON,PIECE,1,14000,11864,2136,14000,March
1795,DUST PAN 3000,PIECE,1,3000,2542,458,3000,March
1818,EAST AFRICAN ORGANIC HONEY 100G,PIECE,1,3500,2966,534,3500,March
1820,EAST AFRICAN ORGANIC HONEY 450G,PIECE,1,12000,10169,1831,12000,March
1832,ED MAGNIFICENT SPRAY,PIECE,1,12000,10169,1831,12000,March
1833,ED PINK PEA SPLASH,PIECE,1,16000,13559,2441,16000,March
1840,EDEN BODY MILK 500ML,PIECE,1,25000,21186,3814,25000,March
1853,EGGS HALF TRAY,PIECE,1,7000,5932,1068,7000,March
1873,ELEGANT FASHION AIR FRESHNER,PIECE,1,6000,5085,915,6000,March
1874,ELEGANT FLORAL LEMON A.F,PIECE,1,7000,5932,1068,7000,March
1891,ELGON BLEND COFFEE 100G,PIECE,1,7000,5932,1068,7000,March
1911,ENVELOPES 300,PIECE,1,300,254,46,300,March
1934,EXCEL GLUCOSE 250G,PIECE,1,6500,5508,992,6500,March
1992,FA SPORT RECHARGE 72H,PIECE,1,6000,5085,915,6000,March
2014,FAMILY CAREPERFUMED JELLY 500G,PIECE,1,10000,8475,1525,10000,March
2023,FAMILY TEA 250G,PIECE,1,7500,6356,1144,7500,March
2047,FAX LEMON FRESH,PIECE,1,8000,6780,1220,8000,March
2061,FEATHERS PADS REGULAR,PIECE,1,3000,2542,458,3000,March
2117,FOGG ABSOLUTE BODY SPRAY,PIECE,1,18000,15254,2746,18000,March
2118,FOGG ABSOLUTE ROLLON,PIECE,1,8500,7203,1297,8500,March
2123,FOGG ELEGANCE ROLLON,PIECE,1,8500,7203,1297,8500,March
2128,FOGG MARCO SPRAY,PIECE,1,18000,15254,2746,18000,March
2129,FOGG MASTER AGAR,PIECE,1,18500,15678,2822,18500,March
2131,FOGG MASTER OAK,PIECE,1,18500,15678,2822,18500,March
2132,FOGG MASTER PINE,PIECE,1,18500,15678,2822,18500,March
2134,FOGG NAPOLEON SPRAY,PIECE,1,18000,15254,2746,18000,March
2137,FOGG SPLENDID ROLLON,PIECE,1,8500,7203,1297,8500,March
2155,FOOD COLOUR PINK,PIECE,1,1000,847,153,1000,March
2170,FORKS 5000,PIECE,1,5000,4237,763,5000,March
2182,FORTUNE SUNFLOWER OIL 1LTR,PIECE,1,12000,10169,1831,12000,March
2186,FRACK BOWL CLEANER,PIECE,1,5000,4237,763,5000,March
2201,FRESH DAIRY FINO BOX 25000,BOX,1,25000,21186,3814,25000,March
2202,FRESH DAIRY FLAVOURED BOX,BOX,1,24000,20339,3661,24000,March
2205,FRESH DIARY LONG LIFE BOX,BOX,1,23000,19492,3508,23000,March
2245,FUNNELS 2000,PIECE,1,2000,1695,305,2000,March
2344,GIRL BIKE 8000,PIECE,1,8000,6780,1220,8000,March
2354,GLASSES 15000,PIECE,1,15000,12712,2288,15000,March
2358,GLASSES 3000 PCS,PIECE,1,3000,2542,458,3000,March
2371,GLOVES 6000,PIECE,1,6000,5085,915,6000,March
2389,GOLDEN ALUMINIUM FOIL,PIECE,1,34000,28814,5186,34000,March
2454,GREEN POLYTHENE,PIECE,1,300,254,46,300,March
2490,HAND WRITING BOOK 2000,PIECE,1,2000,1695,305,2000,March
2515,HARPIC CITRUS,PIECE,1,15000,12712,2288,15000,March
2527,HEAVENS WATER RIVAJ BODY MIST,PIECE,1,17000,14407,2593,17000,March
2533,HEMEZ BAKERY SOFT DONUTS,PIECE,1,1000,847,153,1000,March
2554,HIMALAYAN SALT 350G,PIECE,1,15000,12712,2288,15000,March
2605,HPL BULB,PIECE,1,5000,4237,763,5000,March
2623,HUGGIES S.4 H.C,PIECE,1,45000,38136,6864,45000,March
2660,IMPERIAL LEATHER MEN INTENSE COOL LOTION 200ML,PIECE,1,8000,6780,1220,8000,March
2661,IMPERIAL LEATHER MEN SPORT 400ML.,PIECE,1,13000,11017,1983,13000,March
2666,IMPERIAL LEATHER SPORT 175G,PIECE,1,4500,3814,686,4500,March
2668,IMPERIAL LEATHER UPLIFTING 400ML LOTION,PIECE,1,12000,10169,1831,12000,March
2673,INDO CAFE 50G,PIECE,1,10000,8475,1525,10000,March
2706,JAGO 100MLS,PIECE,1,3500,2966,534,3500,March
2714,JAGO SCRUB 250G,PIECE,1,7500,6356,1144,7500,March
2721,JAMIES CAKE @70k,PIECE,1,80000,67797,12203,80000,March
2769,JEE NAIL REMOVER,PIECE,1,1500,1271,229,1500,March
2781,JESA FINO BOX,BOX,1,24000,20339,3661,24000,March
2802,JESA STRAWBERRY YOGHURT 500G,PIECE,1,3700,3136,564,3700,March
2829,JIK COLOURS 1LTRS,PIECE,1,16000,13559,2441,16000,March
2866,JOHNSON EXTRA GENTLE CARE SOAP,PIECE,1,7500,6356,1144,7500,March
2867,JOHNSON GENTLE ALL OVER BABY WIPES,PIECE,1,12000,10169,1831,12000,March
2902,JONISA LEMON CAKE 1000,PIECE,1,1000,847,153,1000,March
2933,KABODY COCONUT MILK 1KG,PIECE,1,6500,5508,992,6500,March
2948,KADIO CALCULATOR,PIECE,1,15000,12712,2288,15000,March
2962,KANGARO STAPLES,PIECE,1,2000,1695,305,2000,March
2971,KASAF BI-CARBONATE 85G,PIECE,1,1000,847,153,1000,March
3049,KEY HOLDERS 2000,PIECE,1,2000,1695,305,2000,March
3052,KIBIMBA RICE 2KG,PIECE,1,15500,13136,2364,15500,March
3089,KIDS VESTS 16000,PIECE,1,16000,13559,2441,16000,March
3094,KIDS WATCHES 7000,PIECE,1,7000,5932,1068,7000,March
3110,KIRINGI KAZI BOOSTER 280ML,PIECE,1,1000,847,153,1000,March
3114,KIRUNGI KITUZI,PIECE,1,1000,847,153,1000,March
3137,KIWI DARK TAN 32G,PIECE,1,4500,3814,686,4500,March
3144,KIWI SUEDE CLEANER BLACK,PIECE,1,7000,5932,1068,7000,March
3145,KIWI SUEDE CLEANER NEUTRAL,PIECE,1,7000,5932,1068,7000,March
3159,KNIFE 3000,PIECE,1,3000,2542,458,3000,March
3171,KOFA MATHEMATICAL SET,PIECE,1,4000,3390,610,4000,March
3229,KUZA INDIAN HEMP 56G,PIECE,1,8000,6780,1220,8000,March
3233,KYOGERO BETTER BODY OIL 1OOML,PIECE,1,7000,5932,1068,7000,March
3246,LA BELLE JELLY 250G,PIECE,1,6000,5085,915,6000,March
3248,LA BELLE SHAMPOO 1LTR,PIECE,1,7500,6356,1144,7500,March
3260,LABELLE HAIR FOOD 150G,PIECE,1,5000,4237,763,5000,March
3268,LA'FRESH SCRUB POMEGRANATE 500ML,PIECE,1,13000,11017,1983,13000,March
3278,LANZO MENTHOL SOAP,PIECE,1,4500,3814,686,4500,March
3289,LATO FLAVOURED 250ML 46000,PIECE,1,46000,38983,7017,46000,March
3295,LATO MILK 900G,PIECE,1,47000,39831,7169,47000,March
3473,M&G HIGHLIGHTER GREEN,PIECE,1,1500,1271,229,1500,March
3485,M&G PENCILS HB12PCS,PIECE,1,6000,5085,915,6000,March
3546,MAGANJO POSHO 5KG,PIECE,1,20000,16949,3051,20000,March
3549,MAGANJO PURE MILLET 2KG,PIECE,1,12000,10169,1831,12000,March
3584,MAMIS PEANUT PASTE 1KG,PIECE,1,15000,12712,2288,15000,March
3586,MANAGEMENT FILE 2000,PIECE,1,2000,1695,305,2000,March
3618,MASSAGE OLIVE OIL,PIECE,1,15000,12712,2288,15000,March
3724,MINUTE MAID BOOST MANGO,PIECE,1,2500,2119,381,2500,March
3786,MONACO MIST,PIECE,1,16000,13559,2441,16000,March
3812,MOPPERS 12000,PIECE,1,12000,10169,1831,12000,March
3815,MOPPERS 8000,PIECE,1,8000,6780,1220,8000,March
3836,MORTAR AND PESTLE 18000,PIECE,1,18000,15254,2746,18000,March
3846,MORTEIN ODOURLESS 600ML,PIECE,1,32000,27119,4881,32000,March
3881,MOVIT BODYMILK 80G,PIECE,1,1500,1271,229,1500,March
3889,MOVIT FAMILY SOAP ALOE 230G,PIECE,1,4000,3390,610,4000,March
3907,MOVIT HERBAL JELLY 200G,PIECE,1,6000,5085,915,6000,March
3915,MOVIT JELLY 50G,PIECE,1,1500,1271,229,1500,March
3949,MUKWANO COOKING OIL 500MLSACHET,PIECE,1,5000,4237,763,5000,March
3963,MUSA'S BAKERY COOKIES 360G,PIECE,1,5500,4661,839,5500,March
3967,MUSAWO BODY JELLY,PIECE,1,2500,2119,381,2500,March
3980,MWANA MUGIMU 100G,PIECE,1,4000,3390,610,4000,March
4000,NAN OPTIPRO 1 400G,PIECE,1,48000,40678,7322,48000,March
4022,NATARAJ JUMBO WAX CRAYONS,PIECE,1,6000,5085,915,6000,March
4032,NECTAR SPRAY,PIECE,1,10000,8475,1525,10000,March
4083,NICE& LOVELY ALOE 48HRS 400ML,PIECE,1,10000,8475,1525,10000,March
4158,NIVEA MEN DEEP ROLLON,PIECE,1,11000,9322,1678,11000,March
4170,NIVEA MEN REVITALIZING 200ML,PIECE,1,15000,12712,2288,15000,March
4177,NIVEA PROTECT&CARE BODY SPRAY,PIECE,1,16000,13559,2441,16000,March
4178,NIVEA REPAIR& CARE 72H 400ML,PIECE,1,19000,16102,2898,19000,March
4184,NIVEA SHEA SMOOTH 200ML,PIECE,1,12000,10169,1831,12000,March
4196,NOTE BOOK 3000,PIECE,1,3000,2542,458,3000,March
4201,NOTE BOOK SPIRAL 10000,PIECE,1,10000,8475,1525,10000,March
4227,NUMA SUPER RICE 2KG,PIECE,1,17000,14407,2593,17000,March
4233,NUTRO ORANGE WAFERS,PIECE,1,3500,2966,534,3500,March
4289,ODEON SCRUBING PAPAYA &CUCUMBER,PIECE,1,11000,9322,1678,11000,March
4294,OFFICE GLUE 1KG,PIECE,1,7000,5932,1068,7000,March
4322,OLITALIA OLIVE OIL POMACE 250ML,PIECE,1,27000,22881,4119,27000,March
4325,OLIVE OIL BODY LOTION 400ML,PIECE,1,22000,18644,3356,22000,March
4326,OLIVE OIL BODY WHIP 444ML,PIECE,1,28000,23729,4271,28000,March
4336,OMO BLEACH LEMON,PIECE,1,8000,6780,1220,8000,March
4344,OMO FAST ACTION 1KG,PIECE,1,12500,10593,1907,12500,March
4383,ORGANIC COCOABUTTER&SHEA BUTTER,PIECE,1,22000,18644,3356,22000,March
4425,P.K GREEN BIG,PIECE,1,1000,847,153,1000,March
4430,PADLOCK 3000,PIECE,1,3000,2542,458,3000,March
4431,PADLOCK 3500,PIECE,1,3000,2542,458,3000,March
4432,PADLOCK 4000,PIECE,1,4000,3390,610,4000,March
4451,PAMPER 4 PANTS H.C,PIECE,1,40000,33898,6102,40000,March
4465,PANASONIC AAA,PIECE,1,2000,1695,305,2000,March
4499,PASSION STRAWBERRY,PIECE,1,16000,13559,2441,16000,March
4500,PASSION WOODY OUD,PIECE,1,17000,14407,2593,17000,March
4515,PELIKAN COLOR PENCILS,PIECE,1,8000,6780,1220,8000,March
4553,PERSONAL EAR BUDS,PIECE,1,2500,2119,381,2500,March
4555,PETTI COT 5000,PIECE,1,5000,4237,763,5000,March
4561,PHONE GOGGLES 6000,PIECE,1,6000,5085,915,6000,March
4563,PHONE TOYS 4000 N70,PIECE,1,4000,3390,610,4000,March
4581,PICFARE 48PGS,PIECE,1,500,424,76,500,March
4584,PICFARE BRONZE 144PGS,PIECE,1,3500,2966,534,3500,March
4592,PICFARE SET,PIECE,1,6000,5085,915,6000,March
4607,PILLOW 10000,PIECE,1,15000,12712,2288,15000,March
4622,PLASTIC FOOD WRAP,PIECE,1,6500,5508,992,6500,March
4659,POLICE FAMOUS CAR,PIECE,1,12000,10169,1831,12000,March
4665,POPPER 4500,PIECE,1,4500,3814,686,4500,March
4688,POTATO TRAINING CUP AQ819 18000,PIECE,1,20000,16949,3051,20000,March
4692,POTTIES MUKWANO 7000,PIECE,1,7000,5932,1068,7000,March
4720,PRICETAGS 1000,PIECE,1,1000,847,153,1000,March
4733,PRINCESS ULTRA THIN,PIECE,1,3000,2542,458,3000,March
4747,PRINGLES SOUR CREAM 40G,PIECE,1,5500,4661,839,5500,March
4748,PRIVE BLACK OPTION BODYSPLASH,PIECE,1,15000,12712,2288,15000,March
4782,PUCELLE BLISSFUL SENSE 150ML,PIECE,1,7000,5932,1068,7000,March
4785,PUCELLE ECCETRIC BREEZE 75ML,PIECE,1,5000,4237,763,5000,March
4787,PUCELLE FOR MY HEART,PIECE,1,7500,6356,1144,7500,March
4790,PUCELLE JOLLY RYTHM 75ML,PIECE,1,5000,4237,763,5000,March
4792,PUCELLE JOYFULSUMMER 150ML,PIECE,1,7500,6356,1144,7500,March
4795,PUCELLE SPARKLING LOVE 75ML,PIECE,1,5000,4237,763,5000,March
4837,RADIANT HAIR DYE 15ML,PIECE,1,1500,1271,229,1500,March
4840,RADIANT HAIR VITALIZER 100G,PIECE,1,5000,4237,763,5000,March
4843,RADIANT OLIVE OIL SPRAY 250MLS,PIECE,1,11000,9322,1678,11000,March
4846,RADIANT SHOWER GEL OLIVE OIL 750ML,PIECE,1,17000,14407,2593,17000,March
4850,RAHA COCOA 200G,PIECE,1,14000,11864,2136,14000,March
4852,RAHA DRINKING CHOCOLATE 200G,PIECE,1,10000,8475,1525,10000,March
4871,RASPBERRY MIST PASSION,PIECE,1,16000,13559,2441,16000,March
4875,RAYAN BLACK PERFUME,PIECE,1,12000,10169,1831,12000,March
4880,RAZAC HAND&BODY LOTION 474ML,PIECE,1,17000,14407,2593,17000,March
4898,RED COCK BASMATI 1KG,PIECE,1,14000,11864,2136,14000,March
4899,RED ROSE AIR FRESHNER,PIECE,1,7000,5932,1068,7000,March
4913,REVLON NATURAL HONEY600ML,PIECE,1,17000,14407,2593,17000,March
4935,RIBBONS 7500,PIECE,1,7500,6356,1144,7500,March
5022,ROYCO CHICKEN 500G,PIECE,1,12000,10169,1831,12000,March
5026,ROYCO CURRY+MCHUZI,PIECE,1,6500,5508,992,6500,March
5028,RUBBER BAND 4000,PIECE,1,4500,3814,686,4500,March
5029,RUBEE LOTION 113G,PIECE,1,7000,5932,1068,7000,March
5077,SAMONA HERBAL JELLY 100G,PIECE,1,4000,3390,610,4000,March
5078,SAMONA HERBAL JELLY 150G,PIECE,1,5000,4237,763,5000,March
5082,SAN MARIO 250G,PIECE,1,2000,1695,305,2000,March
5086,SANDALS 5000,PIECE,1,5000,4237,763,5000,March
5087,SANDALS 6000,PIECE,1,6000,5085,915,6000,March
5141,SAVANNAH 5LTRS STRAWBERRY,PIECE,1,35000,29661,5339,35000,March
5144,SAVANNAH COCOPINE 5LTR,PIECE,1,35000,29661,5339,35000,March
5150,SAVANNAH ORANGE 5LTRS,PIECE,1,33000,27966,5034,33000,March
5155,SAVANNAH STRAWBERRY 3LTRS,PIECE,1,22000,18644,3356,22000,March
5163,SCHOOL BOTTLE SET 18000,PIECE,1,18000,15254,2746,18000,March
5169,SCHOOL SOCKS RED,PIECE,1,7000,5932,1068,7000,March
5189,SCRUBBING BRUSH LONG 5000,PIECE,1,6000,5085,915,6000,March
5209,SECRETS PADS,PIECE,1,4000,3390,610,4000,March
5227,SERVING SPOON 2000,PIECE,1,2000,1695,305,2000,March
5250,SHADES 6000,PIECE,1,6000,5085,915,6000,March
5253,SHAKERS 12000,PIECE,1,12000,10169,1831,12000,March
5255,SHAKERS 4000,PIECE,1,4000,3390,610,4000,March
5260,SHARPENERS,PIECE,1,1000,847,153,1000,March
5264,SHENKE COIL 4500,PIECE,1,4500,3814,686,4500,March
5265,SHENKE FLOWER REPELLENT,PIECE,1,8000,6780,1220,8000,March
5281,SHIVA HONEY 250G,PIECE,1,8000,6780,1220,8000,March
5283,SHIVA HONEY 500G,PIECE,1,15000,12712,2288,15000,March
5323,SHREEJI GRAPH BOOK 48PGSS,PIECE,1,1500,1271,229,1500,March
5363,SIMBA MBILI 50G,PIECE,1,5500,4661,839,5500,March
5372,SIMKA MANGO-VAN 120ML,PIECE,1,1000,847,153,1000,March
5388,SKALA ALOEVERA LOTION 400ML,PIECE,1,6000,5085,915,6000,March
5392,SKALA FOR MEN LOTION 400ML,PIECE,1,6000,5085,915,6000,March
5393,SKALA MEN CREME,PIECE,1,4000,3390,610,4000,March
5394,SKALA PAPAYA CREAM 200G,PIECE,1,4000,3390,610,4000,March
5400,SKIN CARE 150G,PIECE,1,4500,3814,686,4500,March
5404,SKIN CARE 50G,PIECE,1,2000,1695,305,2000,March
5408,SKIN DOCTOR HERBAL 250G,PIECE,1,7000,5932,1068,7000,March
5426,SKINDOCTOR HERBAL 60G,PIECE,1,2000,1695,305,2000,March
5508,SOFINE PURE OLIVE OIL 120ML,PIECE,1,7000,5932,1068,7000,March
5527,SOFTCARE BABY PANTS L40,PIECE,1,27000,22881,4119,27000,March
5535,SOFTCARE PAMPERS M12,PIECE,1,7000,5932,1068,7000,March
5575,SPARKLING CANDLES 9000,PIECE,1,8000,6780,1220,8000,March
5589,SPIRAL NOTE BOOK 70S,PIECE,1,4500,3814,686,4500,March
5618,SPOONS 10000 6PCS,PIECE,1,10000,8475,1525,10000,March
5619,SPOONS 5000,PIECE,1,5000,4237,763,5000,March
5628,SPRITE ZERO 350ML,PIECE,1,1000,847,153,1000,March
5638,SSCHOOL SOCKS WHITE,PIECE,1,4000,3390,610,4000,March
5657,STA-SOFT LAVENDER FRESH 2LTR,PIECE,1,24000,20339,3661,24000,March
5673,STONEY 350MLS,PIECE,1,1000,847,153,1000,March
5693,STRAWBERRY PRADIP COLORED,PIECE,1,5000,4237,763,5000,March
5725,SULFO GLYCERINE PINK,PIECE,1,2000,1695,305,2000,March
5737,SUMZ CORN CRAX PKT 13000,PIECE,1,13000,11017,1983,13000,March
5752,SUMZ PEANUT BUTTER 800G,PIECE,1,14000,11864,2136,14000,March
5768,SUN L DISH WASHING LIQUID400 ML,PIECE,1,7000,5932,1068,7000,March
5773,SUN SIP PASSION 3LTR,PIECE,1,16000,13559,2441,16000,March
5777,SUNLIGHT DISH LIQUID LEMON 400MLS,PIECE,1,7000,5932,1068,7000,March
5780,SUNLIGHT DISHWASHING PASTE,PIECE,1,9000,7627,1373,9000,March
5782,SUNLIGHT DISHWASJING STRAWBERRY 400ML,PIECE,1,6500,5508,992,6500,March
5798,SUNLIGHT TROPICAL 500G,PIECE,1,5500,4661,839,5500,March
5803,SUNSEED OIL 2LTRS,PIECE,1,21000,17797,3203,21000,March
5804,SUNSEED OIL 3LTRS,PIECE,1,28000,23729,4271,28000,March
5846,SUPERMAN PERFUME,PIECE,1,12000,10169,1831,12000,March
5850,SUPERMAX SWIFT 3 BLADE STICK,PIECE,1,7000,5932,1068,7000,March
5867,SWEET.O GOAT MILK SHOWER GEL,PIECE,1,18000,15254,2746,18000,March
5868,SWEET.O LAVENDER SHOWER GEL,PIECE,1,18000,15254,2746,18000,March
5892,SWEETY FITPANTZ M9,PIECE,1,9000,7627,1373,9000,March
5904,SWT CHENAB 2KG,PIECE,1,28000,23729,4271,28000,March
5909,SWT-1 RICE 1KG GREEN,PIECE,1,7500,6356,1144,7500,March
5925,TABLE MATS 25000,PIECE,1,25000,21186,3814,25000,March
5962,TEEPEE BRUSH A25,PIECE,1,3500,2966,534,3500,March
5993,TENNIS BALL 2500,PIECE,1,3000,2542,458,3000,March
6050,TOILET BRUSHES 12000,PIECE,1,12000,10169,1831,12000,March
6138,TOTOS VESTLINE JELLY 200G,PIECE,1,5000,4237,763,5000,March
6139,TOTO'S VESTLINE JELLY 500G,PIECE,1,10000,8475,1525,10000,March
6172,TRI-CIRCLE 263,PIECE,1,7500,6356,1144,7500,March
6197,TROPICAL HEAT FISH MASALA 100G,PIECE,1,5000,4237,763,5000,March
6199,TROPICAL HEAT GARLIC POWDER 100G,PIECE,1,7000,5932,1068,7000,March
6201,TROPICAL HEAT GINGER 100G,PIECE,1,7000,5932,1068,7000,March
6214,TROPICAL HEAT ROSEMARYLEANES,PIECE,1,3500,2966,534,3500,March
6225,TROPIKAL SPICE ISLE A.F,PIECE,1,12000,10169,1831,12000,March
6239,TRUCK TOYS 12000,PIECE,1,12000,10169,1831,12000,March
6240,TRUCK TOYS 20000,PIECE,1,20000,16949,3051,20000,March
6268,U.S.A BEAUTY SOAP BLACK,PIECE,1,6500,5508,992,6500,March
6295,UGACHICK GRILLER 1KG,PIECE,1,24000,20339,3661,24000,March
6298,UGACHICK STARDARD 1.2KG,PIECE,1,27000,22881,4119,27000,March
6308,UGANDA TEA BAGS 100BAGS,PIECE,1,9000,7627,1373,9000,March
6317,UMBRELLAS 20000 POCKET,PIECE,1,18000,15254,2746,18000,March
6345,UTESIL SPONGE 1500,PIECE,1,1500,1271,229,1500,March
6370,VACUUM BOTTLE 33000,PIECE,1,33000,27966,5034,33000,March
6376,VACUUM OFFICE CUP 35000,PIECE,1,35000,29661,5339,35000,March
6385,VANILLA ED PASSION,PIECE,1,16000,13559,2441,16000,March
6397,VASELINE ALOESOOTHE 200ML,PIECE,1,8000,6780,1220,8000,March
6401,VASELINE BLUESEAL COCOA BUTTER250ML,PIECE,1,9500,8051,1449,9500,March
6407,VASELINE COCOA GLOW 200ML,PIECE,1,8000,6780,1220,8000,March
6412,VASELINE DRY SKIN REPAIR 200ML,PIECE,1,8000,6780,1220,8000,March
6413,VASELINE DRY SKIN REPAIR LOTION 400ML,PIECE,1,15000,12712,2288,15000,March
6443,VERSMAN COOL LOTION 200ML,PIECE,1,9500,8051,1449,9500,March
6449,VERSMAN SPORTY LOTION 400ML,PIECE,1,15000,12712,2288,15000,March
6450,VESTLINE ALOEVERA 400ML,PIECE,1,6500,5508,992,6500,March
6462,VICTOR DAY&NIGHT BODY CREME,PIECE,1,5000,4237,763,5000,March
6496,WANDAZ PETROLEUM JELLY 250G,PIECE,1,6000,5085,915,6000,March
6533,WEET CORNFLAKES 750G,PIECE,1,30000,25424,4576,30000,March
6557,WELLICE SHOWER GEL OLIVE OIL 1LTR,PIECE,1,23000,19492,3508,23000,March
6568,WHITE CHALK 5000,PIECE,1,5000,4237,763,5000,March
6614,YANAH COFFEE 5OG,PIECE,1,6000,5085,915,6000,March
6618,YARRISON BOXERS 3PCS 22000,PIECE,1,22000,18644,3356,22000,March
6620,YARRISON VESTS 3PCS 27000,PIECE,1,27000,22881,4119,27000,March
6663,ZERO PIMPLE SOAP 120G,PIECE,1,4000,3390,610,4000,March
6769,SUNLIGHT TROPICAL 2KG,PIECE,1,20000,16949,3051,20000,March
6806,KIWI DARKTAN LEATHER 100ML,PIECE,1,7000,5932,1068,7000,March
6832,RANDA CROWN PERFUME,PIECE,1,12000,10169,1831,12000,March
6833,BEAUTION OIL,PIECE,1,5000,4237,763,5000,March
6880,STA-SOFT 20ML OCEAN&LAVENDER,PIECE,1,700,593,107,700,March
6901,DEAR BODY ANGEL BITTEN 250ML,PIECE,1,18000,15254,2746,18000,March
6929,DOFREL TABLE SEA SALT 330G,PIECE,1,5500,4661,839,5500,March
6940,JAMIES CAKE @100k,PIECE,1,100000,84746,15254,100000,March
6953,STRIKE NUTS CHOCOLATE BAR,PIECE,1,1500,1271,229,1500,March
6959,S CONTROL HAIR TEXTURIZER 125ML,PIECE,1,5000,4237,763,5000,March
6960,NAN GUEST BATHING SOAP,PIECE,1,4000,3390,610,4000,March
6965,AEROPLANE TOYS 12000,PIECE,1,12000,10169,1831,12000,March
6999,CASIO SCIENTIFIC CALCULATORS WHITE ,PIECE,1,55000,46610,8390,55000,March
7040,BUCKETS 4000 1LTR,PIECE,1,4000,3390,610,4000,March
7045,S/S VACUUM JUG 1.5LTRS DAYDAYS,PIECE,1,50000,42373,7627,50000,March
7063,"AXE ICE CHILL, GOLD, ADRENALIN",PIECE,1,13000,11017,1983,13000,March
7094,NICE$LOVELY ALOEVERA 600ML,PIECE,1,15000,12712,2288,15000,March
7107,SECRET POUR FEMME SPRAY,PIECE,1,12000,10169,1831,12000,March
7108,RASASI YOYALE BLUE SPRAY ,PIECE,1,12000,10169,1831,12000,March
7110,SHOWER TO SHOWER MEN ,PIECE,1,6000,5085,915,6000,March
7155,CA DREAMZ PINK SPRAY,PIECE,1,10000,8475,1525,10000,March
7244,PLAIN PILAU RICE 10000,PIECE,1,6000,5085,915,6000,March
7277,DOUGHNUTS WHOLESALE 2500,PIECE,1,2500,2119,381,2500,March
7281,Gama brown sugar 1kg,PIECE,1,12000,10169,1831,12000,March
7282,Downy vanilla&cashmere musk 880ml,PIECE,1,24000,20339,3661,24000,March
7310,DEAR BODY ALWAYS YOURS 16000,PIECE,1,16000,13559,2441,16000,March
7325,TRIDENT CINNAMON,PIECE,1,6000,5085,915,6000,March
7336,MODY UNDER WEAR,PIECE,1,15000,12712,2288,15000,March
7344,COMB 1000,PIECE,1,1000,847,153,1000,March
7362,SUMZ BAGGIA 200G,PIECE,1,5000,4237,763,5000,March
7380,AFROCARE PERFUMED JELLY 500G,PIECE,1,10000,8475,1525,10000,March
7400,NUTRO DIGESTIVE LIGHT 400G,PIECE,1,13000,11017,1983,13000,March
7403,SCOURING PAD & SPONGE,PIECE,1,1499,1270,229,1499,March
7411,PAMPERS PANTS 6,PIECE,1,40000,33898,6102,40000,March
7427,COLGATE CLEAN MINT 10500,PIECE,1,10500,8898,1602,10500,March
7436,MOODLENA NOODLES CHICKEN 1000,PIECE,1,999,847,152,999,March
7437,MOODLENA NOODLES BEEF 1000,PIECE,1,1000,847,153,1000,March
7448,RIGGS VENOM 16000,PIECE,1,16000,13559,2441,16000,March
7454,MOPPER 3000,PIECE,1,3000,2542,458,3000,March
7473,ARTIN MASSAGE OIL OLIVE OIL 1LTR,PIECE,1,13000,11017,1983,13000,March
7488,VERSMAN ACTIVE LOTION 400ML,PIECE,1,17000,14407,2593,17000,March
7493,CS MUKENE SNACK 200G 5500,PIECE,1,5500,4661,839,5500,March
7503,ISLAND BREEZE A.F JASMINE 350ML,PIECE,1,7000,5932,1068,7000,March
7504,ISLAND BREEZE A.F LAVENDER 350ML,PIECE,1,7000,5932,1068,7000,March
7506,ISLAND BREEZE A.F SANDALWOOD 350ML,PIECE,1,7000,5932,1068,7000,March
7511,DELICIA MASREYA SPAGHETTI 500G,PIECE,1,4000,3390,610,4000,March
7526,DOCTORS KIT DOLL 20000,PIECE,1,19998,16947,3051,19998,March
7530,WRITTING BOARDS 10000,PIECE,1,10000,8475,1525,10000,March
7532,WRITTING BOARD 20000,PIECE,1,20000,16949,3051,20000,March
7538,KIDS SHADES 2000,PIECE,1,2000,1695,305,2000,March
7543,DOLLS3000,PIECE,1,4000,3390,610,4000,March
7558,HISS,PIECE,1,2500,2119,381,2500,March
7561,SANTA LUCIA 5500,PIECE,1,5500,4661,839,5500,March
7567,RIGGS DYNAMO,PIECE,1,16000,13559,2441,16000,March
7568,RIGGS VOYAGE,PIECE,1,16000,13559,2441,16000,March
7577,COSMO GREEN APPLE,PIECE,1,18000,15254,2746,18000,March
7578,PRETTY STRAWBEERY GEL,PIECE,1,18000,15254,2746,18000,March
7594,DOVE DEEPLY NOURISHING 750ML GEL,PIECE,1,27000,22881,4119,27000,March
7596,NISA CARROT LOTION 400ML,PIECE,1,13000,11017,1983,13000,March
7598,NISA ALOEVERA LOTION 200ML,PIECE,1,8000,6780,1220,8000,March
7601,DOVE NOURISHING SECRETS 500ML,PIECE,1,22000,18644,3356,22000,March
7604,DOVE SENSITIVE ROLL 50ML,PIECE,1,11000,9322,1678,11000,March
7639,COSMO TROPICAL PAPAYA GEL 480ML,PIECE,1,12000,10169,1831,12000,March
7640,COSMO STRAWBERRY GEL 480ML,PIECE,1,12000,10169,1831,12000,March
7646,AMERICAN GARDEN APPLE CIDER 500ML,PIECE,1,11000,9322,1678,11000,March
7667,SCHOOL SOCKS WHITE 6000,PIECE,1,6000,5085,915,6000,March
7696,KNIFE 5000,PIECE,1,5000,4237,763,5000,March
7713,REXONA INVISIBLE DRY BLACK+ WHITE 50ML,PIECE,1,10000,8475,1525,10000,March
7715,REXONA PASSION 50ML,PIECE,1,10000,8475,1525,10000,March
7716,DOVE RELAXING JASMINE& COCONUT MILK GEL 500ML,PIECE,1,22000,18644,3356,22000,March
7721,SECRETS PANT LINERS PURPLE,PIECE,1,5500,4661,839,5500,March
7722,JAMIES BRONCH BREAD 1KG,PIECE,1,6000,5085,915,6000,March
7729,SUMZ MATOOKE CRISPS CHILLI 60G,PIECE,1,2500,2119,381,2500,March
7740,LOVE BEAR 25000,PIECE,1,25000,21186,3814,25000,March
7747,AI LISHA CHOCOLATE 25000,PIECE,1,25000,21186,3814,25000,March
7761,LOVE HEART 2000,PIECE,1,2000,1695,305,2000,March
7766,JAMIES CAKE 45000,PIECE,1,45000,38136,6864,45000,March
7768,SOAP DISH 5000,PIECE,1,5000,4237,763,5000,March
7776,SUMZ FRUIT CHUTNEY 60G,PIECE,1,3000,2542,458,3000,March
7780,VENUS MOROCCAN ARGAN OIL 200ML,PIECE,1,6000,5085,915,6000,March
7785,JINBO NOTEBOOK 15000,PIECE,1,15000,12712,2288,15000,March
7795,TROPIKAL POWDER FRESH 12000,PIECE,1,12000,10169,1831,12000,March
7805,FACE MASK ALOE 120ML 10000,PIECE,1,10000,8475,1525,10000,March
7811,FLAMINGO ROSE& HONEY 200G,PIECE,1,3500,2966,534,3500,March
7814,CHOCOLATE 20000,PIECE,1,20000,16949,3051,20000,March
7820,REXONA STRESS CONTROL 200ML,PIECE,1,13000,11017,1983,13000,March
7822,DOVE REVIVING GEL 500ML,PIECE,1,22000,18644,3356,22000,March
16,7DAYS ANTIBACTERIAL WIPES,PIECE,2,5000,8475,1525,10000,March
26,ABC BABY WIPES,PIECE,2,9000,15254,2746,18000,March
35,ACTIVE MAN SPRAY,PIECE,2,10000,16949,3051,20000,March
36,ACTIVE WOMAN BODY SPRAY,PIECE,2,10000,16949,3051,20000,March
71,ALLIANCE LIVEN COFFEE,PIECE,2,3500,5932,1068,7000,March
102,AMARA BODY MILK 400ML,PIECE,2,8500,14407,2593,17000,March
114,AMARA MEN COOLING,PIECE,2,6000,10169,1831,12000,March
125,AMERICAN GARDEN KETCHUP 340G,PIECE,2,7500,12712,2288,15000,March
129,AMERICAN GARDEN KETCHUP 680G,PIECE,2,18000,30508,5492,36000,March
131,AMERICAN GARDEN MUSTARD 14OZ,PIECE,2,15000,25424,4576,30000,March
146,AMLA HAIR OIL 100ML,PIECE,2,7000,11864,2136,14000,March
209,Ariel color and style,PIECE,2,8000,13559,2441,16000,March
211,ARIEL DOWNY 1KG,PIECE,2,15500,26271,4729,31000,March
214,ARIEL LAVENDER 1KG,PIECE,2,15500,26271,4729,31000,March
235,ARMAF SHADES FOR MEN,PIECE,2,16000,27119,4881,32000,March
274,ART PENCILS 3B,PIECE,2,1000,1695,305,2000,March
277,ART PENCILS 6B,PIECE,2,1000,1695,305,2000,March
325,AXE APOLLO BODY SPRAY,PIECE,2,13000,22034,3966,26000,March
334,AXE MUSK,PIECE,2,13000,22034,3966,26000,March
443,BABY JUNIOR JELLY 24ML,PIECE,2,700,1186,214,1400,March
500,BABY&ME BABY OIL,PIECE,2,3000,5085,915,6000,March
543,BALLET SHEA BUTTER SOAP,PIECE,2,3500,5932,1068,7000,March
577,BANNERS 7000,PIECE,2,7000,11864,2136,14000,March
664,BIRTHDAY CANDLES 3500,PIECE,2,4000,6780,1220,8000,March
691,BIYINZIKA WINGS 500G,PIECE,2,11000,18644,3356,22000,March
703,BLESSED KISUBI TEA 125G,PIECE,2,5000,8475,1525,10000,March
704,BLESSED KISUBI TEA 200G,PIECE,2,6000,10169,1831,12000,March
712,BLUE 4 MEN SPRAY,PIECE,2,12000,20339,3661,24000,March
717,BLUE BAND LOW FAT,PIECE,2,6500,11017,1983,13000,March
733,BLUEBAND PEANUT BUTTER 400G,PIECE,2,14000,23729,4271,28000,March
734,BNC MOSQUITO COIL,PIECE,2,4500,7627,1373,9000,March
773,BOTTLES 4000,PIECE,2,4000,6780,1220,8000,March
822,BRITANIA GINGER 1KG,PIECE,2,20000,33898,6102,40000,March
866,BUCKET 7000,PIECE,2,7000,11864,2136,14000,March
1059,CELOTAPE BIGGER 1OOOO,PIECE,2,10000,16949,3051,20000,March
1060,CELOTAPE BLACK,PIECE,2,1500,2542,458,3000,March
1064,CELOTAPE SMALL 1000,PIECE,2,1000,1695,305,2000,March
1122,CHICKSTAX SILVER FISH POWDER,PIECE,2,7000,11864,2136,14000,March
1163,CLAIRMEN CREAM 120ML,PIECE,2,7000,11864,2136,14000,March
1235,COCONUT PRADIP,PIECE,2,4500,7627,1373,9000,March
1257,COLGATE MAX FRESH 65G,PIECE,2,3500,5932,1068,7000,March
1274,COLORES NEW ELITE COLOURS BIG,PIECE,2,2000,3390,610,4000,March
1278,COMB 500,PIECE,2,500,847,153,1000,March
1379,CUPS 6000,PIECE,2,6000,10169,1831,12000,March
1451,DABUR HERBAL MINT&LEMON,PIECE,2,6000,10169,1831,12000,March
1510,DELIDENT MAX 70G,PIECE,2,2000,3390,610,4000,March
1542,DETTOL COOL 105G,PIECE,2,4500,7627,1373,9000,March
1548,DETTOL FRESH 90G,PIECE,2,4500,7627,1373,9000,March
1552,DETTOL JUNIORS GLYCERINE SOAP 100G,PIECE,2,4500,7627,1373,9000,March
1553,DETTOL LIQUID 250 MLS,PIECE,2,15000,25424,4576,30000,March
1593,DISPOSABLE B.D GLASSES 2500,PIECE,2,2500,4237,763,5000,March
1595,DISPOSABLE FORKS 2500,PIECE,2,4000,6780,1220,8000,March
1603,DISPOSABLE SPOON 4000,PIECE,2,4000,6780,1220,8000,March
1633,DOLBY SPORT SPRAY,PIECE,2,12000,20339,3661,24000,March
1643,DOLL 4000,PIECE,2,4000,6780,1220,8000,March
1655,DOLLS 8000 WANJU,PIECE,2,8000,13559,2441,16000,March
1666,DOMS COLOUR PENCILS LONG,PIECE,2,7000,11864,2136,14000,March
1667,DOMS COLOUR PENCILS SHORT,PIECE,2,4500,7627,1373,9000,March
1670,DOMS PENCILS A1 5000,PIECE,2,5000,8475,1525,10000,March
1688,DOUBLE REFINED SALT 650G,PIECE,2,7000,11864,2136,14000,March
1718,DOVE ORIGINAL SOAP 135G,PIECE,2,5500,9322,1678,11000,March
1751,DOWNY FEEL LUXURIOUS 280ML,PIECE,2,11000,18644,3356,22000,March
1769,DURACELL AA PLUS,PIECE,2,8000,13559,2441,16000,March
1770,DURACELL AAA,PIECE,2,7000,11864,2136,14000,March
1772,DURU CARING MILK,PIECE,2,4500,7627,1373,9000,March
1775,DURU ENERGIZING HONEY,PIECE,2,4500,7627,1373,9000,March
1776,DURU FLORAL INFUSION,PIECE,2,14000,23729,4271,28000,March
1804,E.A HONEY 1LTR,PIECE,2,29000,49153,8847,58000,March
1829,ED CHERRY BLOSSOM,PIECE,2,16000,27119,4881,32000,March
1861,ELEGANCE COCOA BUTTER,PIECE,2,6000,10169,1831,12000,March
1887,ELEGANT STRAWBERRY 300ML,PIECE,2,7000,11864,2136,14000,March
1909,ENVELOPES 1000,PIECE,2,1000,1695,305,2000,March
1938,F.D FLAVOURED MILK BOX46000,BOX,2,45000,76271,13729,90000,March
1962,F.D UNSALTED BUTTER 250G,PIECE,2,11000,18644,3356,22000,March
1987,FA MYSTIC MOMENTS,PIECE,2,6500,11017,1983,13000,March
2177,FORTUNE GOLD 3LTR,PIECE,2,28000,47458,8542,56000,March
2277,GARDEN FRESH TEA 100G,PIECE,2,4000,6780,1220,8000,March
2317,GIFT BAG FLORAL LARGE,PIECE,2,6000,10169,1831,12000,March
2359,GLASSES 5000 PCS,PIECE,2,5000,8475,1525,10000,March
2408,GOLDEN SPEED YEAST,PIECE,2,13000,22034,3966,26000,March
2413,GOOD DAY CASHEW COOKIES,PIECE,2,2600,4407,793,5200,March
2416,GOOD DOCTOR KIDS TOOTH,PIECE,2,1000,1695,305,2000,March
2461,GUINEA SHOE CREME BROWN,PIECE,2,3500,5932,1068,7000,March
2477,HABARI SALT SMALL,PIECE,2,700,1186,214,1400,March
2501,HANYAN EAR BUDS,PIECE,2,2000,3390,610,4000,March
2528,HEINZ BAKED BEANS 415G,PIECE,2,8000,13559,2441,16000,March
2547,HIGH LIGHTER,PIECE,2,1500,2542,458,3000,March
2617,HUGGIES PANTS 6,PIECE,2,86000,145763,26237,172000,March
2637,ICE CUPS 8000,PIECE,2,8000,13559,2441,16000,March
2723,JAMIES CAKES @30k,PIECE,2,35000,59322,10678,70000,March
2936,KABODY MILLET SOYA PORRIDGE,PIECE,2,6500,11017,1983,13000,March
2940,KABODY PUMPKIN PORRIDGE 1KG,PIECE,2,6000,10169,1831,12000,March
2943,KABODY QUICK PORRIDGE1KG,PIECE,2,6000,10169,1831,12000,March
2944,KABODY RICE FLOUR 1KG,PIECE,2,6500,11017,1983,13000,March
2945,KABODY SOYA PORRIDGE,PIECE,2,6000,10169,1831,12000,March
2988,KAZIRE POWER TONIC,PIECE,2,2000,3390,610,4000,March
2992,KELLOGS CORNFLAKES 500g,PIECE,2,27000,45763,8237,54000,March
2999,KENPOLY LUNCH BOX,PIECE,2,5000,8475,1525,10000,March
3070,KIDS BOXERS 3000,PIECE,2,3000,5085,915,6000,March
3132,KIWI BLACK 160G,PIECE,2,14000,23729,4271,28000,March
3150,KNICKERS 2000,PIECE,2,2000,3390,610,4000,March
3157,KNICKERS 8000,PIECE,2,8000,13559,2441,16000,March
3191,KOOKSY STRAWBERRY 500ML,PIECE,2,5000,8475,1525,10000,March
3195,KOOKSY VAN-CHOC 500ML,PIECE,2,5000,8475,1525,10000,March
3200,KOOKSY VANILLA 500ML,PIECE,2,5000,8475,1525,10000,March
3205,KOOKSY VANILLA MANGO 250ML,PIECE,2,3500,5932,1068,7000,March
3224,KUAKUA TOILET BLOCKS 6PCS,PIECE,2,10000,16949,3051,20000,March
3275,LANZO ANTI-BACTERIAL SOAP,PIECE,2,4500,7627,1373,9000,March
3276,LANZO BUBBLY SOAP,PIECE,2,3500,5932,1068,7000,March
3279,LANZO VANILLA SOAP,PIECE,2,3500,5932,1068,7000,March
3367,LET'S IMAGINE SPRAY,PIECE,2,12000,20339,3661,24000,March
3380,LIMOUSINE,PIECE,2,1500,2542,458,3000,March
3419,LOVE CHOCOLATE,PIECE,2,3000,5085,915,6000,March
3470,M&G GLUE STICK 2500,PIECE,2,2500,4237,763,5000,March
3471,M&G HEART PEN AB87575,PIECE,2,2000,3390,610,4000,March
3493,M&G STICK GLUE 1500,PIECE,2,1500,2542,458,3000,March
3494,M&G STICK GLUE 3000,PIECE,2,3000,5085,915,6000,March
3588,MANILA PAPERS 1000,PIECE,2,1000,1695,305,2000,March
3598,MANUSCRIPT BOOK 2Q,PIECE,2,12000,20339,3661,24000,March
3622,CAR TOY 15000,PIECE,2,15000,25424,4576,30000,March
3626,MAYONNAISE BIG 887ML,PIECE,2,30000,50847,9153,60000,March
3657,MELEX SIMSIM BALLS 500,PIECE,2,500,847,153,1000,March
3668,MEN SOCKS,PIECE,2,3000,5085,915,6000,March
3748,MIRROR 1500,PIECE,2,1500,2542,458,3000,March
3760,MOCACINE SOCKS 2000,PIECE,2,2000,3390,610,4000,March
3837,MORTEIN DOOM LEMON 400ML,PIECE,2,28000,47458,8542,56000,March
3872,MOVIT BABY JELLY 70g,PIECE,2,2000,3390,610,4000,March
3887,MOVIT FAMILY SOAP 230G,PIECE,2,4000,6780,1220,8000,March
3904,MOVIT HAIR FOOD AVACADO OIL 200G,PIECE,2,5500,9322,1678,11000,March
3913,MOVIT JELLY 200G,PIECE,2,5000,8475,1525,10000,March
3930,MOVIT SOAP LEMON 120G,PIECE,2,2500,4237,763,5000,March
3931,MOVIT STYLING GEL 150G,PIECE,2,4500,7627,1373,9000,March
3935,MOZZARELLA CHEESE 500G,PIECE,2,25000,42373,7627,50000,March
3985,MYSTIC AIRFRESHENER BEWITCHING ROSE,PIECE,2,7500,12712,2288,15000,March
4026,NATARAJ RULER,PIECE,2,1500,2542,458,3000,March
4027,NATARAJ SETS,PIECE,2,10000,16949,3051,20000,March
4044,NESCAFE CLASSIC 200G,PIECE,2,26000,44068,7932,52000,March
4047,NESCAFE CLASSIC SACHETS 1.6G,PIECE,2,500,847,153,1000,March
4081,NICE CLEAR PENS,PIECE,2,500,847,153,1000,March
4117,NISA CUCUMBER HAIR REMOVAL 20ML,PIECE,2,2000,3390,610,4000,March
4119,NISA HAIR REMOVAL CUCUMBER 50ML,PIECE,2,7000,11864,2136,14000,March
4125,NISA ROSE HAIR REMOVAL CREAM 20ML,PIECE,2,2000,3390,610,4000,March
4134,NIVEA BLACK & WHITE 50ML,PIECE,2,11000,18644,3356,22000,March
4139,NIVEA COOL KICK 400MLS,PIECE,2,19000,32203,5797,38000,March
4182,NIVEA RICH NOURISHING LOTION 400ML,PIECE,2,19000,32203,5797,38000,March
4192,NOMI BUCKET 500G,PIECE,2,6500,11017,1983,13000,March
4338,OMO BLEACH MULTI-PURPOSE 70ML,PIECE,2,1500,2542,458,3000,March
4339,OMO BLEACH REGULAR,PIECE,2,8000,13559,2441,16000,March
4418,OXFORD PRIMARY DICTIONARY,PIECE,2,40000,67797,12203,80000,March
4433,PADLOCK 5000,PIECE,2,5000,8475,1525,10000,March
4459,PAMPER S.6 JUMBO 48DIAP,PIECE,2,73000,123729,22271,146000,March
4464,PANASONIC AA,PIECE,2,2000,3390,610,4000,March
4470,PANCHAVATI,PIECE,2,3000,5085,915,6000,March
4473,PANT PEG 5000,PIECE,2,5000,8475,1525,10000,March
4511,PEGS 5000,PIECE,2,5000,8475,1525,10000,March
4517,PELIKAN RUBBERS 1000,PIECE,2,1000,1695,305,2000,March
4538,PEPSI MAX 500ML,PIECE,2,1500,2542,458,3000,March
4587,PICFARE HANDWRITING BOOKS,PIECE,2,2000,3390,610,4000,March
4593,PICFARE SQUARE BKS 96PGS,PIECE,2,1500,2542,458,3000,March
4626,PLASTIC GLASSES 3500,PIECE,2,3500,5932,1068,7000,March
4644,PLATES CLAY 3000,PIECE,2,3500,5932,1068,7000,March
4713,PRESSOL HAIR GEL 125G,PIECE,2,5500,9322,1678,11000,March
4732,PRINCESS ULTRA PADS,PIECE,2,2700,4576,824,5400,March
4734,PRINGLES BARBEQUE 165G,PIECE,2,11000,18644,3356,22000,March
4735,PRINGLES BBQ 40G,PIECE,2,5500,9322,1678,11000,March
4794,PUCELLE PURE AROOSAH 75ML,PIECE,2,5000,8475,1525,10000,March
4796,PUCELLE SWEET FANTACY 75ML,PIECE,2,5000,8475,1525,10000,March
4807,PUFFIN 60G,PIECE,2,2000,3390,610,4000,March
4841,RADIANT OLIVE OIL HAIR SPRAY 100ML,PIECE,2,6500,11017,1983,13000,March
4862,RANEE HERBAL ORIGINAL SOAP,PIECE,2,7500,12712,2288,15000,March
4897,RED COCK 2KG,PIECE,2,27000,45763,8237,54000,March
4955,RIHAM DIGESTIVE TIN,PIECE,2,18000,30508,5492,36000,March
4958,RIHAM GINGER TIN,PIECE,2,18000,30508,5492,36000,March
4959,RIHAM MILK&HONEY 108PKT,PIECE,2,10000,16949,3051,20000,March
4962,RIHAM SHORTCAKE BISCUITS TIN,PIECE,2,18000,30508,5492,36000,March
4973,RINJU HAND&BODY CREAM 118ML,PIECE,2,18000,30508,5492,36000,March
4991,ROKI OIL 3LTRS,PIECE,2,27000,45763,8237,54000,March
5013,ROYAL POUR HOMME BLACK,PIECE,2,12000,20339,3661,24000,March
5015,ROYALE BLUE SPRAY,PIECE,2,12000,20339,3661,24000,March
5148,SAVANNAH MANGO 5LTRS,PIECE,2,33000,55932,10068,66000,March
5233,SESACO SOYACUP 150G,PIECE,2,4000,6780,1220,8000,March
5239,SEXY BODY POWDER 50M,PIECE,2,2000,3390,610,4000,March
5269,SHENKE MOSQUITO COIL,PIECE,2,6000,10169,1831,12000,March
5287,SHOE BRUSH 5000,PIECE,2,5000,8475,1525,10000,March
5293,SHOE BRUSHES 4000,PIECE,2,4000,6780,1220,8000,March
5301,SHOWER 2 SHOWER CONFIDENT,PIECE,2,6000,10169,1831,12000,March
5313,SHOWERTO SHOWER MUSK ALIVE,PIECE,2,6000,10169,1831,12000,March
5315,SHOWERTOSHOWER FRESH POWDER,PIECE,2,6000,10169,1831,12000,March
5361,SIMBA MBILI 200G,PIECE,2,9500,16102,2898,19000,March
5402,SKIN CARE 250G,PIECE,2,6500,11017,1983,13000,March
5485,SO SOFT KITCHEN TOWEL,PIECE,2,8000,13559,2441,16000,March
5538,SOFTCARE S48 GOLD,PIECE,2,25000,42373,7627,50000,March
5559,SOSOFT FRESH 750ML,PIECE,2,11000,18644,3356,22000,March
5569,SOY SAUCE LIGHT 500G,PIECE,2,10000,16949,3051,20000,March
5574,SPARKLING CANDLES 8000,PIECE,2,7000,11864,2136,14000,March
5630,SQUEEZERS 5000,PIECE,2,5000,8475,1525,10000,March
5649,STAR COFFEE 250G B. CHOICE,PIECE,2,10000,16949,3051,20000,March
5650,STAR COFFEE 500G,PIECE,2,15000,25424,4576,30000,March
5726,SULTAN COCONUT HAIL OIL,PIECE,2,5000,8475,1525,10000,March
5745,SUMZ DADDIES PKT 13000,PIECE,2,13000,22034,3966,26000,March
5767,SUMZS CRISPS 500G,PIECE,2,12000,20339,3661,24000,March
5778,SUNLIGHT DISH PASTE,PIECE,2,6000,10169,1831,12000,March
5783,SUNLIGHT DWL 750MLS LEMON,PIECE,2,11000,18644,3356,22000,March
5792,SUNLIGHT SOAP 175G,PIECE,2,2500,4237,763,5000,March
5816,SUNSIP BLACKCURRANT 5LTR,PIECE,2,24000,40678,7322,48000,March
5891,SWEETY FITPANTZ LC L8,PIECE,2,9000,15254,2746,18000,March
5967,TEEPEE SHOE BRUSH,PIECE,2,3000,5085,915,6000,March
6042,TOCEBAL AA,PIECE,2,1000,1695,305,2000,March
6047,TOILET BRUSH 6000,PIECE,2,6000,10169,1831,12000,March
6053,TOILET PUMPS,PIECE,2,7000,11864,2136,14000,March
6137,TOTOS VESTLINE JELLY 100G,PIECE,2,3000,5085,915,6000,March
6150,TOY CARS 10000,PIECE,2,10000,16949,3051,20000,March
6190,TROPICAL HEAT CINNAMON 50G,PIECE,2,4500,7627,1373,9000,March
6191,TROPICAL HEAT CLOVE POWDER,PIECE,2,7500,12712,2288,15000,March
6203,TROPICAL HEAT MEAT TENDERISER50G,PIECE,2,4000,6780,1220,8000,March
6209,TROPICAL HEAT PILAU MASALA 100G,PIECE,2,11000,18644,3356,22000,March
6292,UGACHICK FAMILY PACK 2KG,PIECE,2,42000,71186,12814,84000,March
6293,UGACHICK GIZZARDS 500G,PIECE,2,13000,22034,3966,26000,March
6323,UMOJA SANDALS 8000,PIECE,2,10000,16949,3051,20000,March
6406,VASELINE BLUESEAL ORIGINAL 250ML,PIECE,2,9500,16102,2898,19000,March
6421,VASELINE MEN COOLING 400MLS,PIECE,2,14500,24576,4424,29000,March
6468,VIM LAVENDER 1KG,PIECE,2,8000,13559,2441,16000,March
6470,VIM LEMON 1KG,PIECE,2,8000,13559,2441,16000,March
6672,ZESTA MIXED FRUIT JAM,PIECE,2,7500,12712,2288,15000,March
6673,ZESTA MIXED FRUIT JAM 500G,PIECE,2,10500,17797,3203,21000,March
6778,PILAO PLAIN 5000,PIECE,2,4500,7627,1373,9000,March
6793,LIVER 4000,PIECE,2,3000,5085,915,6000,March
6795,KATOGO 2000,PIECE,2,2500,4237,763,5000,March
6851,PIZZA 16'' BEEF,PIECE,2,35000,59322,10678,70000,March
6948,NIVEA DOULBLE EFFECT 48HRS,PIECE,2,11000,18644,3356,22000,March
6995,DOMS WAX CRAYONS ,PIECE,2,2500,4237,763,5000,March
6996,NATARAJ WAX CRAYONS 2500,PIECE,2,2500,4237,763,5000,March
6998,KADIO SCIENTIFIC CALCULATOR KD-82MS-B,PIECE,2,15000,25424,4576,30000,March
7003,M&G OFFICE SCISSORS 170MM,PIECE,2,4000,6780,1220,8000,March
7089,JAMIES WHITE SALT BREAD 500G,PIECE,2,3000,5085,915,6000,March
7153,INNOCENCE BODY SPRAY ,PIECE,2,12000,20339,3661,24000,March
7160,PAWPAW OIL 60ML,PIECE,2,6000,10169,1831,12000,March
7172,HIGHLAND TEA 50G,PIECE,2,2500,4237,763,5000,March
7175,JAMIES LIQUID SOAP 3LTR,PIECE,2,3000,5085,915,6000,March
7176,JAMIES LIQUID SOAP 20LTR,PIECE,2,30000,50847,9153,60000,March
7317,PRIVE CRAZY GIRL 250ML,PIECE,2,14000,23729,4271,28000,March
7330,SUMZ GONJA CRISP 400G,PIECE,2,12000,20339,3661,24000,March
7332,SWT-P 5KG,PIECE,2,41500,70339,12661,83000,March
7346,LED TOUCH,PIECE,2,4000,6780,1220,8000,March
7349,BODY SCRUBBER GLOVE,PIECE,2,2500,4237,763,5000,March
7364,SUMZ BAGGIA 100G,PIECE,2,3000,5085,915,6000,March
7373,VASELINE BLUESEAL BABY 240ML,PIECE,2,9500,16102,2898,19000,March
7426,JAMIES SWEET CAKE BREAD WHOLESALE 5000,PIECE,2,5000,8475,1525,10000,March
7429,TROPICAL HEAT PAPRIKA SPICE 100G,PIECE,2,6000,10169,1831,12000,March
7435,SAVANNAH PUNCH 2LTR 18000,PIECE,2,18000,30508,5492,36000,March
7505,ISLAND BREEZE A.F ROMANTIC ROSE AF 350ML,PIECE,2,6999,11863,2135,13998,March
7540,NUMA KARO 2KG 12000,PIECE,2,12000,20339,3661,24000,March
7557,MEGA SPAGHETTI,PIECE,2,4500,7627,1373,9000,March
7563,NIVEA FRESH NATURAL,PIECE,2,16000,27119,4881,32000,March
7579,PRETTY LAVENDER,PIECE,2,18000,30508,5492,36000,March
7590,WEETABIX SUPER SAVER 850G,PIECE,2,27000,45763,8237,54000,March
7645,SOFTCARE GOLD XL36,PIECE,2,25000,42373,7627,50000,March
7658,HANDSOME BOXER 18000,PIECE,2,18000,30508,5492,36000,March
7702,SUMZ FRIED PEAS CHILLI 80G,PIECE,2,2500,4237,763,5000,March
7719,SECRETS PADS ULTRA DAY&NIGHT PINK,PIECE,2,5500,9322,1678,11000,March
7730,SUMZ SIMSIM PANCAKES 80G,PIECE,2,3000,5085,915,6000,March
7732,SUMZ BAKED PEANUT BAR 80G,PIECE,2,2500,4237,763,5000,March
7742,RIHAM MILK&HONEY,PIECE,2,11000,18644,3356,22000,March
7743,TOY CAR 20000,PIECE,2,20000,33898,6102,40000,March
7762,PRINGLES PAPRIKA,PIECE,2,5500,9322,1678,11000,March
7767,PEPSODENT CHARCOAL WHITE 160G,PIECE,2,11000,18644,3356,22000,March
7769,SUMZ NUTRIBITE ENERGY BAR 80G,PIECE,2,2500,4237,763,5000,March
7772,SUMZ BBQ FLAVOUR 60G,PIECE,2,3000,5085,915,6000,March
7801,DOVE POMEGRADE 90G 5000,PIECE,2,5000,8475,1525,10000,March
7812,FLAMINGO LEMON&HONEY 200G,PIECE,2,3500,5932,1068,7000,March
6,20LTR JERRICAN,PIECE,3,10000,25424,4576,30000,March
12,7 DAYS BABY WIPES,PIECE,3,8500,21610,3890,25500,March
18,7DAYS PANT LINERS,PIECE,3,4000,10169,1831,12000,March
83,ALWAYS COTTON MAXITHICK,PIECE,3,3500,8898,1602,10500,March
112,AMARA MEN 200ML,PIECE,3,6000,15254,2746,18000,March
115,AMARA RAW SHEA 200ML,PIECE,3,5500,13983,2517,16500,March
126,AMERICAN GARDEN KETCHUP 340G,PIECE,3,7500,19068,3432,22500,March
212,ARIEL DOWNY 500G,PIECE,3,8000,20339,3661,24000,March
270,ART BOOK BIG,PIECE,3,4000,10169,1831,12000,March
271,ART BOOK SMALL,PIECE,3,2000,5085,915,6000,March
289,ASTRO'S CHOCOLATES,PIECE,3,1500,3814,686,4500,March
326,AXE BLACK,PIECE,3,13000,33051,5949,39000,March
354,B.D CANDLES 1500,PIECE,3,1500,3814,686,4500,March
442,BABY JUNIOR JELLY 200g,PIECE,3,6000,15254,2746,18000,March
447,BABY JUNIOR100g,PIECE,3,3500,8898,1602,10500,March
494,BABY WIPES NO 4,PIECE,3,6000,15254,2746,18000,March
523,BALLET ACTIVE VITAMIN 120MLS,PIECE,3,5000,12712,2288,15000,March
526,BALLET ALOE VERA 120MLS,PIECE,3,5000,12712,2288,15000,March
527,BALLET ALOE VERA JELLY 300MLS,PIECE,3,9500,24153,4347,28500,March
538,BALLET BUTTER BLEND 300ML,PIECE,3,9500,24153,4347,28500,March
672,BIRTHDAY HATS 3500,PIECE,3,3500,8898,1602,10500,March
683,BIYINZIKA CHICKENLEGS 1KGS,PIECE,3,19000,48305,8695,57000,March
718,BLUE BAND LOW SPREAD 250G,PIECE,3,4000,10169,1831,12000,March
808,BREAD CRUMBS 7000,PIECE,3,7000,17797,3203,21000,March
820,BRITANIA DIGESTIVE 1KG,PIECE,3,20000,50847,9153,60000,March
851,BROOMS 1000,PIECE,3,1000,2542,458,3000,March
852,BROOMS 2000,PIECE,3,2000,5085,915,6000,March
911,C.B MAGIC STRAWBERRY 1LTR,PIECE,3,19500,49576,8924,58500,March
937,CADBURY DAIRY MILK FRUIT&NUT 150G,PIECE,3,13000,33051,5949,39000,March
944,CADBURY DRINKING CHOCOLATE 125G,PIECE,3,8500,21610,3890,25500,March
966,CAKE WRAPPER 1000,PIECE,3,1000,2542,458,3000,March
1097,CHAPA NYOTA BROWN 600G,PIECE,3,4000,10169,1831,12000,March
1111,CHERRY COTTON BUDS,PIECE,3,2500,6356,1144,7500,March
1131,CHINA GREEN TEA 50G,PIECE,3,5000,12712,2288,15000,March
1213,CLOSEUP TRIPPLE FRESH 125G,PIECE,3,5000,12712,2288,15000,March
1290,COMPO PENS,PIECE,3,3000,7627,1373,9000,March
1306,CONTAINERS 3500,PIECE,3,3500,8898,1602,10500,March
1348,COW&GATE 3 NUTRIJUNIOR,PIECE,3,44000,111864,20136,132000,March
1349,COWBOY 500G,PIECE,3,7500,19068,3432,22500,March
1359,CREAMY EFFECT WIPES,PIECE,3,6000,15254,2746,18000,March
1396,CUSSONS BABY UNPERFUMED JELLY 100ML,PIECE,3,5500,13983,2517,16500,March
1443,D.L VANILLA 500ML,PIECE,3,9500,24153,4347,28500,March
1526,DENTAL FLOSS /PICKS,PIECE,3,2500,6356,1144,7500,March
1538,DESSERT NOTE BOOK 4000,PIECE,3,4500,11441,2059,13500,March
1559,DETTOL SENSITIVE 175G,PIECE,3,6500,16525,2975,19500,March
1653,DOLLS 2000,PIECE,3,2000,5085,915,6000,March
1780,DURU GLYCERINE,PIECE,3,5000,12712,2288,15000,March
1788,DURU OCEAN BREEZE SOAP,PIECE,3,14000,35593,6407,42000,March
1819,EAST AFRICAN ORGANIC HONEY 250G,PIECE,3,8000,20339,3661,24000,March
1825,ECO STYLING GEL 236ML,PIECE,3,11000,27966,5034,33000,March
1869,ELEGANT BLACK A.F,PIECE,3,7000,17797,3203,21000,March
1973,FA AQUA 50MLS,PIECE,3,6500,16525,2975,19500,March
1977,FA FIGI,PIECE,3,6500,16525,2975,19500,March
2152,FOOD COLOUR EGG YELLOW,PIECE,3,1000,2542,458,3000,March
2375,GLUE STICK 21G,PIECE,3,2500,6356,1144,7500,March
2479,HACO RULER,PIECE,3,2000,5085,915,6000,March
2481,HAIR BANS 2000,PIECE,3,1000,2542,458,3000,March
2483,HAIR BANS RIBBON,PIECE,3,1500,3814,686,4500,March
2518,HARPIC ORIGINAL PLUS,PIECE,3,15000,38136,6864,45000,March
2538,HERMELA GUEST SOAP,PIECE,3,3500,8898,1602,10500,March
2595,HOT FRESH 20ML,PIECE,3,2500,6356,1144,7500,March
2833,JIK REGULAR 750MLS,PIECE,3,14000,35593,6407,42000,March
2942,KABODY PURE MILLET 1KG,PIECE,3,6000,15254,2746,18000,March
2954,KAKIRA SUGAR 5KG,PIECE,3,32700,83136,14964,98100,March
2989,KAZIRE RED TONIC 350MLS,PIECE,3,2000,5085,915,6000,March
3133,KIWI BLACK 80G,PIECE,3,8000,20339,3661,24000,March
3153,KNICKERS 4000,PIECE,3,4000,10169,1831,12000,March
3160,KNIFE 4000 KM7095,PIECE,3,5000,12712,2288,15000,March
3236,KYOGERO HERBAL JELLY 250G,PIECE,3,7500,19068,3432,22500,March
3456,LUX VESTS,PIECE,3,16000,40678,7322,48000,March
3478,M&G MATHEMATICAL SET,PIECE,3,5000,12712,2288,15000,March
3548,MAGANJO PURE MILLET 1KG,PIECE,3,6500,16525,2975,19500,March
3653,MELEX SIMSIM 170G 2000,PIECE,3,2000,5085,915,6000,March
3809,MOPPER 7000,PIECE,3,7000,17797,3203,21000,March
3848,MOSQUITO NETS 15000,PIECE,3,15000,38136,6864,45000,March
3875,MOVIT BABYJELLY 50g,PIECE,3,1500,3814,686,4500,March
3894,MOVIT FAMILY SOAP ROSE 125G,PIECE,3,2500,6356,1144,7500,March
3895,MOVIT FAMILY SOAP ROSE 230G,PIECE,3,4000,10169,1831,12000,March
3994,NACET 500 PCS,PIECE,3,500,1271,229,1500,March
4052,NEVIA PEARL&BEAUTY ROLLON,PIECE,3,11000,27966,5034,33000,March
4138,NIVEA BLACK&WHITE SPRAY,PIECE,3,16000,40678,7322,48000,March
4166,NIVEA MEN MAXIMUM HYDRATION 200ML,PIECE,3,15000,38136,6864,45000,March
4214,NTALE 100G,PIECE,3,4000,10169,1831,12000,March
4223,NUMA SOYA RICE 1KG,PIECE,3,7000,17797,3203,21000,March
4241,NUTRO DIGESTIVE LIGHT,PIECE,3,6500,16525,2975,19500,March
4249,NUTRO VANILLA FLAVOURED,PIECE,3,6500,16525,2975,19500,March
4293,ODONIL DISINFECTANT,PIECE,3,7000,17797,3203,21000,March
4295,OFFICE GLUE 90G,PIECE,3,2000,5085,915,6000,March
4319,OLITALIA EXTRA VIRGIN OLIVEOIL 100ML,PIECE,3,15000,38136,6864,45000,March
4367,ORCHID VALLEY GUAVA 1LTR,PIECE,3,7500,19068,3432,22500,March
4554,PETANG TOMATO SAUCE 700G,PIECE,3,7500,19068,3432,22500,March
4599,PICK N PEEL TROPICAL MIX 250ML,PIECE,3,2500,6356,1144,7500,March
4653,PLUTO ADVANCED AA,PIECE,3,6000,15254,2746,18000,March
4667,POPPER 7000,PIECE,3,7000,17797,3203,21000,March
4791,PUCELLE JOYFUL SUMMER,PIECE,3,5000,12712,2288,15000,March
4943,RIHAM BUTTER COOKIES BISCUIT 1KG,PIECE,3,18000,45763,8237,54000,March
5081,SAMONA HERBAL SOAP 100G,PIECE,3,4000,10169,1831,12000,March
5168,SCHOOL SOCKS BLUE&WHITE ORIGINAL 7500,PIECE,3,7500,19068,3432,22500,March
5222,SENSODYNE MULTI CARE 75MLS,PIECE,3,14000,35593,6407,42000,March
5268,SHENKE LOTUS SCENT,PIECE,3,8000,20339,3661,24000,March
5282,SHIVA HONEY 400G,PIECE,3,13000,33051,5949,39000,March
5289,SHOE BRUSHES 1500,PIECE,3,1500,3814,686,4500,March
5300,SHOWE TO SHOWER MENV EXTREME ICE,PIECE,3,6000,15254,2746,18000,March
5331,SHUYA 240 MM,PIECE,3,6000,15254,2746,18000,March
5332,SHUYA 280MM,PIECE,3,6000,15254,2746,18000,March
5425,SKINDOCTOR HERBAL 120G,PIECE,3,3500,8898,1602,10500,March
5497,SOAP DISH KENPOLY 1000,PIECE,3,2000,5085,915,6000,March
5515,SOFT BROOM 15000,PIECE,3,15000,38136,6864,45000,March
5530,SOFTCARE L40,PIECE,3,25000,63559,11441,75000,March
5568,SOY SAUCE LIGHT 150G,PIECE,3,5000,12712,2288,15000,March
5667,GOLDER STICK NOTES,PIECE,3,2000,5085,915,6000,March
5784,SUNLIGHT LAVENDER 1KG,PIECE,3,11000,27966,5034,33000,March
5821,SUN-SIP STRAWBERRY 2LTR,PIECE,3,11000,27966,5034,33000,March
5978,TEMMY'S CORNFLAKES 1KG,PIECE,3,30000,76271,13729,90000,March
6000,TIANS MALLOW 138G,PIECE,3,10000,25424,4576,30000,March
6045,TOILET BLUE BLOCKS 4PCS,PIECE,3,7500,19068,3432,22500,March
6069,TOOTHPICK NATURAL,PIECE,3,2500,6356,1144,7500,March
6185,TROPICAL HEAT BEEF MASALA 100G,PIECE,3,5000,12712,2288,15000,March
6208,TROPICAL HEAT PAPRIKA,PIECE,3,3500,8898,1602,10500,March
6215,TROPICAL HEAT TEA MASALA 100G,PIECE,3,10000,25424,4576,30000,March
6301,UGACHICK WINGS 500G,PIECE,3,13000,33051,5949,39000,March
6304,UGANDA SAFARI TEA 100G,PIECE,3,3500,8898,1602,10500,March
6305,UGANDA SAFARI TEA 250G,PIECE,3,7000,17797,3203,21000,March
6318,UMBRELLAS 8000,PIECE,3,8000,20339,3661,24000,March
6458,VICTAN SINGLE VEST,PIECE,3,5000,12712,2288,15000,March
6573,WHITE VINEGAR,PIECE,3,2500,6356,1144,7500,March
6606,WRAPPERS 500,PIECE,3,500,1271,229,1500,March
6619,YARRISON UNDER SHIRT 30000,PIECE,3,35000,88983,16017,105000,March
6675,ZESTA STRAWBERRY JAM 300GM,PIECE,3,7500,19068,3432,22500,March
6707,VASELINE BLUESEAL MEN COOLING 95ML,PIECE,3,5000,12712,2288,15000,March
6708,VASELINE BLUESEAL BABY 95ML,PIECE,3,5000,12712,2288,15000,March
6742,DOVE EVENTONE 50ML 10000,PIECE,3,10000,25424,4576,30000,March
6766,BIRTHDAY CANDLE 1500,PIECE,3,1500,3814,686,4500,March
6782,CHICKEN STEW 8000,PIECE,3,6667,16949,3051,20000,March
6817,BALLET BABY SOAP ALOEVERA,PIECE,3,4000,10169,1831,12000,March
6993,DOMS WAX CRAYONS BIG,PIECE,3,5000,12712,2288,15000,March
7093,PEPTANG TOMATO KETCHUP 700G,PIECE,3,12000,30508,5492,36000,March
7140,SUMZ CORN CRAX 350G,PIECE,3,5000,12712,2288,15000,March
7324,OYAL COCOX,PIECE,3,1500,3814,686,4500,March
7339,SOFTCARE GOLD S48,PIECE,3,25000,63559,11441,75000,March
7381,RIGGS HERO BODY SPRAY 250ML,PIECE,3,16000,40678,7322,48000,March
7387,HB PENCILS,PIECE,3,1500,3814,686,4500,March
7401,NUTRO DIGESTIVE ORIGINAL 400G,PIECE,3,13000,33051,5949,39000,March
7405,SUMZ FRIED SOYA BEANS 100G,PIECE,3,2500,6356,1144,7500,March
7406,COLGATE TOOTHBRUSH 6+,PIECE,3,6000,15254,2746,18000,March
7419,Sandals,PIECE,3,8002,20344,3662,24006,March
7432,FRESCO BODY OIL 100ML 4000,PIECE,3,4000,10169,1831,12000,March
7467,C.B SALTED CARAMEL ALMOND 500ML,PIECE,3,23000,58475,10525,69000,March
7513,ELMALEKA PASTA RINGS 400G,PIECE,3,3500,8898,1602,10500,March
7544,DOLLS 5000,PIECE,3,5000,12712,2288,15000,March
7636,NISA LAVENDER HAND&BODY LOTION 50ML,PIECE,3,3000,7627,1373,9000,March
7693,HAND BRUSH 2500,PIECE,3,2500,6356,1144,7500,March
7695,PIAO PIAO EXTRA LENGTH PADS,PIECE,3,3500,8898,1602,10500,March
7760,LOVE CUP AND BEAR 10000,PIECE,3,10000,25424,4576,30000,March
7765,PRINGLES PAPRIKA 165G,PIECE,3,12000,30508,5492,36000,March
7773,SUMZ SALT&VINEGAR 60G,PIECE,3,3000,7627,1373,9000,March
7775,SUMZ TASTY TOMATO 60G,PIECE,3,3000,7627,1373,9000,March
7787,BROOKSIDE MILK BOX 28000,PIECE,3,28000,71186,12814,84000,March
7788,SUMZ CORN CRAX CHILLI LEMON 160G,PIECE,3,2500,6356,1144,7500,March
7826,JAMIES CINNAMON BREAD 500G,PIECE,3,3500,8898,1602,10500,March
58,AFRICANA TEA BAGS 50,PIECE,4,5000,16949,3051,20000,March
92,ALWAYS ULTRA V.P,PIECE,4,6500,22034,3966,26000,March
95,ALWAYS VALUE PACK LONG,PIECE,4,6500,22034,3966,26000,March
105,AMARA COCOA BUTTER LOTION 400ML,PIECE,4,8500,28814,5186,34000,March
275,ART PENCILS 4B,PIECE,4,1000,3390,610,4000,March
311,AUNT PORRIDGE 1KG,PIECE,4,14000,47458,8542,56000,March
529,BALLET BABY JELLY 300MLS,PIECE,4,9500,32203,5797,38000,March
578,BAR COCONUTY CHOCOLATE,PIECE,4,1500,5085,915,6000,March
649,BI-CARBONATE SODA,PIECE,4,1000,3390,610,4000,March
769,BOTTLES 15000,PIECE,4,15000,50847,9153,60000,March
781,BOUNTY CHOCOLATE,PIECE,4,4000,13559,2441,16000,March
862,BUCKET 11000,PIECE,4,11000,37288,6712,44000,March
1011,CAR TOYS 3000,PIECE,4,3000,10169,1831,12000,March
1012,CAR TOYS 4000,PIECE,4,4000,13559,2441,16000,March
1095,CHAPA BAKING POWDER,PIECE,4,1500,5085,915,6000,March
1128,CHILDREN'S UNDERWEAR 20000,PIECE,4,20000,67797,12203,80000,March
1164,CLASSIC 96 PAGES,PIECE,4,2000,6780,1220,8000,March
1182,CLEOS HOT SAUCE 125G,PIECE,4,3500,11864,2136,14000,March
1244,COLGATE 0-2YEARS,PIECE,4,4000,13559,2441,16000,March
1261,COLGATE MAXIMUM CAVITY 140G,PIECE,4,7500,25424,4576,30000,March
1264,COLGATE NATURAL EXTRACT 75MLS,PIECE,4,9000,30508,5492,36000,March
1268,COLGATE TOTAL12 75MLS,PIECE,4,11000,37288,6712,44000,March
1434,D.L PINACOLANDA 500ML,PIECE,4,10000,33898,6102,40000,March
1447,D.L VAN-STRAW 500ML,PIECE,4,9500,32203,5797,38000,March
1468,DAITY AMIRALDOUBLE CHOCOLATE,PIECE,4,4500,15254,2746,18000,March
1525,DENTAL FLOSS,PIECE,4,2500,8475,1525,10000,March
1540,DETTOL ACTIVE 175G,PIECE,4,6500,22034,3966,26000,March
1547,DETTOL FRESH 175G,PIECE,4,6500,22034,3966,26000,March
1551,DETTOL HERBAL 175G,PIECE,4,6500,22034,3966,26000,March
1700,DOVE FRESH TOUCH 100G,PIECE,4,4000,13559,2441,16000,March
1759,DRINKING CHOCOLATE 225G,PIECE,4,13000,44068,7932,52000,March
1771,DURACELL AAA PLUS,PIECE,4,8000,27119,4881,32000,March
1939,F.D MANGO 100G,PIECE,4,1000,3390,610,4000,March
1983,FA MEN ATTRACTION FORCE,PIECE,4,6500,22034,3966,26000,March
2178,FORTUNE GOLD 500ML,PIECE,4,5250,17797,3203,21000,March
2284,GARDEN TEA BAGS 100G,PIECE,4,6500,22034,3966,26000,March
2294,GEISHA MORINGA OIL 125G,PIECE,4,4000,13559,2441,16000,March
2299,GEISHA SHEA AND ALMOND BUTTER SOAP 225G,PIECE,4,5500,18644,3356,22000,March
2726,JAMIES CAKES @60K,PIECE,4,61250,207627,37373,245000,March
2934,KABODY COMPOSITE FLOUR,PIECE,4,6000,20339,3661,24000,March
2939,KABODY OATS SOYA RICE 1KG,PIECE,4,6500,22034,3966,26000,March
3091,KIDS WATCH 10000,PIECE,4,10000,33898,6102,40000,March
3128,KITCHEN TOWELS,PIECE,4,4000,13559,2441,16000,March
3131,KIWI 20G,PIECE,4,3000,10169,1831,12000,March
3203,KOOKSY VANILLA CHOCOLATE 250ML,PIECE,4,3500,11864,2136,14000,March
3208,KOOKSY VANILLA STRAWBERRY 250ML,PIECE,4,3500,11864,2136,14000,March
3212,KOPIKO 3 IN 1 COFFEE,PIECE,4,2000,6780,1220,8000,March
3400,LMZ HERBAL 55G,PIECE,4,3000,10169,1831,12000,March
3468,M&G FLEXIBLE RULER,PIECE,4,2500,8475,1525,10000,March
3538,MAGANJO CORNFLAKES,PIECE,4,10000,33898,6102,40000,March
3550,MAGANJO RICE FLOUR 1KG,PIECE,4,7500,25424,4576,30000,March
3552,MAGANJO SOYA MILLET,PIECE,4,6500,22034,3966,26000,March
3563,MAGIC 500G BUCKET,PIECE,4,6500,22034,3966,26000,March
3575,MAKE UP FACIAL WIPES,PIECE,4,3500,11864,2136,14000,March
3634,MELAMINE PLATES 5000,PIECE,4,5000,16949,3051,20000,March
3855,MOTH BALLS 4000,PIECE,4,7000,23729,4271,28000,March
3892,MOVIT FAMILY SOAP COCONUT 230G,PIECE,4,4000,13559,2441,16000,March
3946,MUKISA MANDAZI 1000,PIECE,4,1500,5085,915,6000,March
4023,NATARAJ PENCILS 6000,PIECE,4,6000,20339,3661,24000,March
4043,NESCAFE CLASSIC 100G,PIECE,4,17000,57627,10373,68000,March
4137,NIVEA BLACK&WHITE ROLLON,PIECE,4,11000,37288,6712,44000,March
4162,NIVEA MEN FRESH ACTIVE 50ML,PIECE,4,11000,37288,6712,44000,March
4191,NOMI BUCKET 1KG,PIECE,4,12500,42373,7627,50000,March
4215,NTALE 25G,PIECE,4,2000,6780,1220,8000,March
4222,NUMA RICE FLOUR 1KG,PIECE,4,7500,25424,4576,30000,March
4224,NUMA SOYARICE WITH ENKEJJE 1KG,PIECE,4,7500,25424,4576,30000,March
4226,NUMA SUPER RICE 1KG,PIECE,4,8500,28814,5186,34000,March
4235,NUTRO CHOC CREAM WAFERS,PIECE,4,6500,22034,3966,26000,March
4239,NUTRO CREAM WAFERS 3,PIECE,4,6500,22034,3966,26000,March
4240,NUTRO DIGESTIVE,PIECE,4,6500,22034,3966,26000,March
4335,OMO BLEACH COLOUR SAFE 700ML.,PIECE,4,9000,30508,5492,36000,March
4363,ORAL-B TOOTHBRUSH,PIECE,4,3500,11864,2136,14000,March
4368,ORCHID VALLEY MANGO 1LTR6161101061483,PIECE,4,7500,25424,4576,30000,March
4445,PAMPER 3 H.C,PIECE,4,40000,135593,24407,160000,March
4463,PAMPERS WIPES COMPLETE CLEAN,PIECE,4,13500,45763,8237,54000,March
4594,PICH n PEEL TROPICAL MIX 1LTR,PIECE,4,9500,32203,5797,38000,March
4705,PRADIP VANILLA CLEAR FLAVOURING,PIECE,4,5000,16949,3051,20000,March
4716,PRESTIGE 1KG,PIECE,4,14000,47458,8542,56000,March
4737,PRINGLES CHEESY CHEESE 165G,PIECE,4,12000,40678,7322,48000,March
4743,PRINGLES ORIGINAL 40G,PIECE,4,5500,18644,3356,22000,March
4805,PUFF HOLDERS 500,PIECE,4,500,1695,305,2000,March
4890,RECEIPT BOOKS NORMAL,PIECE,4,3000,10169,1831,12000,March
5025,ROYCO CUBES BEEF,PIECE,4,4000,13559,2441,16000,March
5167,SCHOOL SOCKS BLUE&WHITE 4000,PIECE,4,4000,13559,2441,16000,March
5176,SCISSORS 1500,PIECE,4,1500,5085,915,6000,March
5284,SHIVA HONEY 80G,PIECE,4,4001,13563,2441,16004,March
5307,SHOWER TO SHOWER SPRING RAIN,PIECE,4,6000,20339,3661,24000,March
5308,SHOWER TOSHOWER FRESH MORNING,PIECE,4,6000,20339,3661,24000,March
5334,SHUYA PANT LINERS,PIECE,4,6000,20339,3661,24000,March
5531,SOFTCARE M42 GOLD,PIECE,4,25000,84746,15254,100000,March
5536,SOFTCARE PAMPERS S15,PIECE,4,7500,25424,4576,30000,March
5610,SPONGE 3000,PIECE,4,3000,10169,1831,12000,March
5611,SPONGE 4000,PIECE,4,4000,13559,2441,16000,March
5631,SQUEEZERS DOULBLE 10000,PIECE,4,10000,33898,6102,40000,March
5738,SUMZ CREAMY PEANUT BUTTER 420G,PIECE,4,8000,27119,4881,32000,March
5758,SUMZ POTATO CRISPS TASTY TOMATO12G,PIECE,4,600,2034,366,2400,March
5760,SUMZ PUMPKIN SEEDS 70G,PIECE,4,3000,10169,1831,12000,March
5771,SUN SIP MANGO 2LTR,PIECE,4,11000,37288,6712,44000,March
5812,SUN--SIP APPLE 2LTR,PIECE,4,11000,37288,6712,44000,March
5852,SUPREME BAKING FLOUR,PIECE,4,9000,30508,5492,36000,March
5979,TEMMY'S CORNFLAKES 250G,PIECE,4,9000,30508,5492,36000,March
6127,TORCHES 1500,PIECE,4,1500,5085,915,6000,March
6217,TROPICAL HEAT TURMERIC 100G,PIECE,4,7000,23729,4271,28000,March
6281,UBISCO MILK&HONEY 108PKTS,PIECE,4,10000,33898,6102,40000,March
6299,UGACHICK SUPA 1KG,PIECE,4,22000,74576,13424,88000,March
6300,UGACHICK THIGHS 500G,PIECE,4,13000,44068,7932,52000,March
6411,VASELINE COCOAGLOW LOTION 400G radiant,PIECE,4,14500,49153,8847,58000,March
6422,VASELINE MEN COOLING JELLY 240ML,PIECE,4,9500,32203,5797,38000,March
6516,WATER BUBBLES 700,PIECE,4,700,2373,427,2800,March
6548,WEETABIX OATIBIX 1KG,PIECE,4,18500,62712,11288,74000,March
6674,ZESTA STRAWBERRY JAM,PIECE,4,10500,35593,6407,42000,March
7004,KIDS BOXERS 7000,PIECE,4,7000,23729,4271,28000,March
7025,FACE TOWELS 6000,PIECE,4,6000,20339,3661,24000,March
7101,JAMIES DADDIES TIN 17000,PIECE,4,17000,57627,10373,68000,March
7147,JAMIES COOKIES 800G TIN 17000,PIECE,4,17000,57627,10373,68000,March
7308,COTTON EAR SWABS 4000,PIECE,4,4000,13559,2441,16000,March
7321,ECLAIRS 300,PIECE,4,300,1017,183,1200,March
7333,MEN BOXERS,PIECE,4,15000,50847,9153,60000,March
7367,D.L SOY NON-DAIRY ICECREAM VANILLA 500ML,PIECE,4,10000,33898,6102,40000,March
7606,BEYOGLU BISCUITO,PIECE,4,1500,5085,915,6000,March
7614,DUSTER 2500,PIECE,4,2500,8475,1525,10000,March
7750,TOYS 4000,PIECE,4,4000,13559,2441,16000,March
7816,FRUIT VILLE STRAWBERRY BANANA 500ML,PIECE,4,3500,11864,2136,14000,March
81,ALWAYS COTTON EXTRA LONG,PIECE,5,3000,12712,2288,15000,March
528,BALLET BABY JELLY 120MLS,PIECE,5,5000,21186,3814,25000,March
542,BALLET REGULAR,PIECE,5,3500,14831,2669,17500,March
570,BAMBOO TOOTHPICK 2500,PIECE,5,2500,10593,1907,12500,March
627,BEIKU BABY SOOTHERS,PIECE,5,2500,10593,1907,12500,March
689,BIYINZIKA SUPA 1KG,PIECE,5,20000,84746,15254,100000,March
690,BIYINZIKA THIGHS 500G,PIECE,5,10000,42373,7627,50000,March
891,BUSHENYI HONEY 5OOG,PIECE,5,9000,38136,6864,45000,March
942,CADBURY DREAM WHITE BISCUITS,PIECE,5,8000,33898,6102,40000,March
1017,CARAMBOLA BLACK SPOT,PIECE,5,6000,25424,4576,30000,March
1093,CHAMPION A4 200PAGES,PIECE,5,4000,16949,3051,20000,March
1191,CLERE MEN ICE 100G,PIECE,5,2000,8475,1525,10000,March
1202,CLIMAX TROPICAL FRUITS 50G,PIECE,5,2500,10593,1907,12500,March
1248,COLGATE DEEP CLEAN,PIECE,5,1500,6356,1144,7500,March
1263,COLGATE MAXIMUM CAVITY 70G,PIECE,5,4500,19068,3432,22500,March
1266,COLGATE TOOTHBRUSH 1500,PIECE,5,1500,6356,1144,7500,March
1357,CREAMBELL STRAWBERRY VAN 500ML,PIECE,5,10000,42373,7627,50000,March
1446,D.L VAN-STRAW 1LTR,PIECE,5,18000,76271,13729,90000,March
1453,DABUR NEEM TOOTHPASTE 150G,PIECE,5,6000,25424,4576,30000,March
1466,DAIRYLAND PEACH MELBA 500ML,PIECE,5,10000,42373,7627,50000,March
1474,DAITY SAFFRON ICE CREAM,PIECE,5,5500,23305,4195,27500,March
1543,DETTOL COOL 175G,PIECE,5,6500,27542,4958,32500,March
1544,DETTOL EVENTONE 175G,PIECE,5,6500,27542,4958,32500,March
1550,DETTOL HERBAL 105G,PIECE,5,4500,19068,3432,22500,March
1668,DOMS GEOMETRY SET,PIECE,5,8500,36017,6483,42500,March
1687,DOUBLE A REAM,PIECE,5,29000,122881,22119,145000,March
1722,DOVE PINK 100G,PIECE,5,4000,16949,3051,20000,March
1937,F.D FLAVOURED CHOCOLATE,PIECE,5,4000,16949,3051,20000,March
1974,FA CARRIEAN LEMON,PIECE,5,6500,27542,4958,32500,March
2071,FIDODIDO CHOCOLATE 250ML,PIECE,5,4000,16949,3051,20000,March
2087,FIDODIDO STRAW-VANI 250ML,PIECE,5,4000,16949,3051,20000,March
2088,FIDODIDO STRAW-VANI 500ML,PIECE,5,5000,21186,3814,25000,March
2093,FIDODIDO VANILLA 500ML,PIECE,5,5000,21186,3814,25000,March
2209,FRESH UP TOOTHPASTE,PIECE,5,2000,8475,1525,10000,March
2315,GIFT BAG 4500,PIECE,5,4500,19068,3432,22500,March
2530,HEINZ KETCHUP 300G,PIECE,5,8000,33898,6102,40000,March
2636,IBON ELVAN SWEETS,PIECE,5,200,847,153,1000,March
2676,INDOCAFE CAPPUCCINO CREAMY,PIECE,5,3000,12712,2288,15000,March
2830,JIK COLOURS 250MLS,PIECE,5,7000,29661,5339,35000,March
2947,KABODY WHITE OATS WITH RICE,PIECE,5,6000,25424,4576,30000,March
2966,KANGAROO BLACK SHOE CREAM,PIECE,5,2000,8475,1525,10000,March
3093,KIDS WATCHES 5000 GODLER,PIECE,5,5000,21186,3814,25000,March
3115,KIRUNGI MULONDO EXTRA 280ML,PIECE,5,1000,4237,763,5000,March
3134,KIWI CREME BLACK 100MLS,PIECE,5,4000,16949,3051,20000,March
3143,KIWI SHOE POLISH 32G,PIECE,5,5000,21186,3814,25000,March
3239,KYOGERO HERBAL SOAP 120G,PIECE,5,3500,14831,2669,17500,March
3293,LATO MILK 250G,PIECE,5,12000,50847,9153,60000,March
3304,LATO PEACH&CARAMEL 250G,PIECE,5,3000,12712,2288,15000,March
3376,LIFEBUOY TOTAL10 175G,PIECE,5,5000,21186,3814,25000,March
3499,M&G WHITE BOARD MARKER,PIECE,5,1500,6356,1144,7500,March
3533,MAGANJO BABY SOYA 1KG,PIECE,5,6500,27542,4958,32500,March
3607,MARIKA ICING SUGAR 500G,PIECE,5,4000,16949,3051,20000,March
3609,MARS CHOCOLATE,PIECE,5,3500,14831,2669,17500,March
3628,MAYONNAISE MEDIUM 473ML,PIECE,5,25000,105932,19068,125000,March
3654,MELEX SIMSIM 85G 1000,PIECE,5,1000,4237,763,5000,March
3696,MILKMAN CHOCOLATE 500,PIECE,5,500,2119,381,2500,March
3909,MOVIT HERBAL JELLY 50G,PIECE,5,1500,6356,1144,7500,March
4021,NATARAJ COLOR PENCILS,PIECE,5,7500,31780,5720,37500,March
4143,NIVEA DRY IMPACT ROLLON,PIECE,5,11000,46610,8390,55000,March
4198,NOTE BOOK 4000,PIECE,5,4000,16949,3051,20000,March
4252,NUTRO WAFERS VANILLA,PIECE,5,3500,14831,2669,17500,March
4284,OATIBIX 500G,PIECE,5,12000,50847,9153,60000,March
4365,ORCHID VALLEY APPLE 1LTR,PIECE,5,7500,31780,5720,37500,March
4540,PEPSODENT CAVITY FIGHTER 150G,PIECE,5,5000,21186,3814,25000,March
4577,PICFARE 192 PAGES 6000,PIECE,5,6000,25424,4576,30000,March
4712,PREMIUM QUALITY TISSUE,PIECE,5,7500,31780,5720,37500,March
4767,PROTEX CLASSIC 150G,PIECE,5,6500,27542,4958,32500,March
4992,ROKI OIL 500ML,PIECE,5,5000,21186,3814,25000,March
5267,SHENKE LEMON SCENT,PIECE,5,8000,33898,6102,40000,March
5270,SHENKE MOSQUITO COIL LOW SMOKE,PIECE,5,6000,25424,4576,30000,March
5314,SHOWERTOSHOWER FRESH DAWN,PIECE,5,6000,25424,4576,30000,March
5364,SIMBA SCOURER,PIECE,5,2000,8475,1525,10000,March
5382,SIMKA VANILLA 500MLS,PIECE,5,4500,19068,3432,22500,March
5697,STREPSILS ORIGINAL,PIECE,5,1000,4237,763,5000,March
5733,SUMZ CHOCOLATE COOKIES 200G,PIECE,5,4000,16949,3051,20000,March
5765,SUMZ SIMSIM BALLS 100G,PIECE,5,2500,10593,1907,12500,March
5796,SUNLIGHT TROPICAL 1KG,PIECE,5,11000,46610,8390,55000,March
5822,SUNSIP STRAWBERRY 3LTR,PIECE,5,16000,67797,12203,80000,March
6192,TROPICAL HEAT CORIANDER 50G,PIECE,5,4500,19068,3432,22500,March
6210,TROPICAL HEAT PILAU MASALA 50G,PIECE,5,6000,25424,4576,30000,March
6290,UGACHICK DRUMSTICK WHOLE 500G,PIECE,5,13000,55085,9915,65000,March
6307,UGANDA TEA BAGS,PIECE,5,5500,23305,4195,27500,March
6544,WEETABIX CORNFLAKES 500G,PIECE,5,22000,93220,16780,110000,March
6666,ZESTA 500G,PIECE,5,10500,44492,8008,52500,March
6787,VEGETABLE RICE 3500,PIECE,5,4020,17034,3066,20100,March
7077,VASELINE BLUESEAL ALOEVERA 95ML,PIECE,5,5000,21186,3814,25000,March
7388,HIKMA YELLOW BAGIYA 4000,PIECE,5,4000,16949,3051,20000,March
7512,ELMALEKA PASTA ELBOW 400G,PIECE,5,3500,14831,2669,17500,March
7547,TOYS 15000,PIECE,5,10000,42373,7627,50000,March
7588,SUMZ CASHEW NUTS 75G,PIECE,5,7500,31780,5720,37500,March
7611,SUMZ ROASTED SESAME 80G,PIECE,5,2500,10593,1907,12500,March
7643,KAXUE KIDS TOOTHBRUSH,PIECE,5,2500,10593,1907,12500,March
7687,NOTE BOOK 6500,PIECE,5,6500,27542,4958,32500,March
7688,YAKET TAMARIND FRUIT DRINK 500ML,PIECE,5,1000,4237,763,5000,March
7694,PIAO PIAO SANITRAT PADS,PIECE,5,3500,14831,2669,17500,March
7705,JAMIES CAKE SLICE@8000,PIECE,5,8000,33898,6102,40000,March
7748,BAKEMATE LOVE 1500,PIECE,5,1500,6356,1144,7500,March
9,500MLS DISPOSABLE GLASSES,PIECE,6,6000,30508,5492,36000,March
14,7 DAYS WIPES,PIECE,6,5000,25424,4576,30000,March
84,Always dreamzz,PIECE,6,3500,17797,3203,21000,March
93,ALWAYS V.P EXTRA LONG,PIECE,6,6500,33051,5949,39000,March
113,AMARA MEN 400ML,PIECE,6,8500,43220,7780,51000,March
157,ANKIT BOURBON,PIECE,6,5000,25424,4576,30000,March
716,BLUE BAND 500G,PIECE,6,10000,50847,9153,60000,March
935,CADBURY DAIRY MILK CHOCOLATE 150G,PIECE,6,13000,66102,11898,78000,March
943,CADBURY DREAM WHITE CREAMY 80G,PIECE,6,8000,40678,7322,48000,March
949,CADBURY RUM&RAISIN 80G,PIECE,6,8000,40678,7322,48000,March
950,CADBURY TOP DECK 150G,PIECE,6,13000,66102,11898,78000,March
1037,CASHO CALC,PIECE,6,15000,76271,13729,90000,March
1054,CB MAGIC STRAW 500ML,PIECE,6,10000,50847,9153,60000,March
1067,CERELAC 6MONTHS,PIECE,6,27000,137288,24712,162000,March
1270,COLGATE TRIPPLE ACTION 70G,PIECE,6,3500,17797,3203,21000,March
1277,COMB 1500,PIECE,6,1500,7627,1373,9000,March
1373,CUPS 1000,PIECE,6,1000,5085,915,6000,March
1389,CUSSON SOAP MILD&GENTLE,PIECE,6,3500,17797,3203,21000,March
1429,D.L MEGA CONE VANILLA,PIECE,6,3500,17797,3203,21000,March
1437,D.L VAN.STRAW 250ML,PIECE,6,5000,25424,4576,30000,March
1440,D.L VAN-CHOC 500ML,PIECE,6,9500,48305,8695,57000,March
1472,DAITY DARK'N'DARK ICE CREAM,PIECE,6,5000,25424,4576,30000,March
1477,DAITY VANILLA ICECREAM,PIECE,6,5500,27966,5034,33000,March
1512,DELUXE ALUMINIUM FOIL,PIECE,6,6500,33051,5949,39000,March
1539,DETTOL 125MLS,PIECE,6,9000,45763,8237,54000,March
1557,DETTOL ORIGINAL 100G,PIECE,6,4500,22881,4119,27000,March
1602,DISPOSABLE PLATES 9 ROUND,PIECE,6,6500,33051,5949,39000,March
1915,ERASER RUBBER BIG,PIECE,6,1000,5085,915,6000,March
2480,HACO RULER ORIGINAL,PIECE,6,2000,10169,1831,12000,March
2651,IMPERIAL LEATHER 4*175,PIECE,6,13000,66102,11898,78000,March
2657,IMPERIAL LEATHER MEN 175G,PIECE,6,4500,22881,4119,27000,March
2768,JCJ HAND WRITING BOOK 2000,PIECE,6,2000,10169,1831,12000,March
2804,JESA TOFFEE YOGHURT 500G,PIECE,6,3700,18814,3386,22200,March
2916,JUMBO BLUE SWIRL 175ML,PIECE,6,4000,20339,3661,24000,March
2924,JUNSHENG COTTON SWABS,PIECE,6,2000,10169,1831,12000,March
2946,KABODY SOYA RICE 1KG,PIECE,6,6500,33051,5949,39000,March
2986,KAZIRE LEMON TEA,PIECE,6,2000,10169,1831,12000,March
2987,KAZIRE ORANGE,PIECE,6,2000,10169,1831,12000,March
3051,KEY HOLDERS 3500,PIECE,6,3500,17797,3203,21000,March
3084,KIDS TOOTH BRUSH 5000,PIECE,6,5000,25424,4576,30000,March
3535,MAGANJO BABY SOYA WITH MILK 500G,PIECE,6,8500,43220,7780,51000,March
3539,MAGANJO ENERGY BOOSTER 1KG,PIECE,6,6500,33051,5949,39000,March
3663,MEN BOXERS 10000,PIECE,6,10000,50847,9153,60000,March
3761,MOCACINE SOCKS 2500,PIECE,6,2500,12712,2288,15000,March
3972,MUSAWO SOAP 120G,PIECE,6,1500,7627,1373,9000,March
4030,NATURAL SPONGE 2000,PIECE,6,2000,10169,1831,12000,March
4082,NICE TOOTHBRUSH,PIECE,6,600,3051,549,3600,March
4219,NUMA BUSHERA 2KG,PIECE,6,12000,61017,10983,72000,March
4333,OMO 40G FRESH,PIECE,6,500,2542,458,3000,March
4341,OMO BLEACH REGULAR 70ML,PIECE,6,1200,6102,1098,7200,March
4346,OMO FAST ACTION 500G,PIECE,6,7500,38136,6864,45000,March
4414,OWEN'S G-NUTS 1000,PIECE,6,1000,5085,915,6000,March
4541,PEPSODENT HERBAL 65G,PIECE,6,2500,12712,2288,15000,March
4742,PRINGLES ORIGINAL 165G BURSTING,PIECE,6,11000,55932,10068,66000,March
4777,PROTEX HERBAL 150G,PIECE,6,6500,33051,5949,39000,March
4778,PROTEX HERBAL 90G,PIECE,6,4000,20339,3661,24000,March
5021,ROYCO CHICKEN 200G,PIECE,6,6000,30508,5492,36000,March
5024,ROYCO CUBE CHICKEN FLAVOUR,PIECE,6,5000,25424,4576,30000,March
5053,SAFARI TEA 50G,PIECE,6,1500,7627,1373,9000,March
5174,SCHOOL STOCKINGS WHITE,PIECE,6,4167,21186,3814,25000,March
5272,SHENKE MOSQUITO REPELLANT,PIECE,6,16000,81356,14644,96000,March
5333,SHUYA 330MM,PIECE,6,6000,30508,5492,36000,March
5381,SIMKA VANILLA 300MLS,PIECE,6,3500,17797,3203,21000,March
5594,SPLASH BOX 42000,BOX,6,45000,228814,41186,270000,March
5696,STRAWS 2500,PIECE,6,2500,12712,2288,15000,March
5724,SULFO GLYCERINE COLORLESS,PIECE,6,2000,10169,1831,12000,March
5786,SUNLIGHT LAVENDER 500G,PIECE,6,5500,27966,5034,33000,March
5910,SWT-P RICE 1KG YELLOW,PIECE,6,8000,40678,7322,48000,March
6068,TOOTHPICK 1000,PIECE,6,1000,5085,915,6000,March
6129,TOREN CHOCOLATE CLASSIC,PIECE,6,5000,25424,4576,30000,March
6187,TROPICAL HEAT BLACK PEPPER 50G,PIECE,6,5500,27966,5034,33000,March
6188,TROPICAL HEAT CHICKEN MASALA 100G,PIECE,6,5000,25424,4576,30000,March
6218,TROPICAL HEAT TURMERIC 50G,PIECE,6,3500,17797,3203,21000,March
6404,VASELINE BLUESEAL MEN FRESH 100ML,PIECE,6,5000,25424,4576,30000,March
6474,VINEGAR WHITE 700MLS,PIECE,6,2500,12712,2288,15000,March
6537,WEETABIX 450G,PIECE,6,15500,78814,14186,93000,March
6543,WEETABIX CORNFLAKES 250G,PIECE,6,15000,76271,13729,90000,March
6677,ZESTA TOMATO KETCHUP 700G,PIECE,6,12000,61017,10983,72000,March
6709,VASELINE BLUESEAL JELLY ORIGINAL 95ML,PIECE,6,5000,25424,4576,30000,March
6736,JESA STRAWBERRY 450G,PIECE,6,6000,30508,5492,36000,March
6882,SUMZ FRIED PEAS,PIECE,6,2500,12712,2288,15000,March
6885,JAGO SCRUB 110G,PIECE,6,4000,20339,3661,24000,March
6921,ZENDEN PLASTIC PLAYING CARDS ,PIECE,6,5000,25424,4576,30000,March
6988,ELITE BALL PENS 500,PIECE,6,500,2542,458,3000,March
7065,BRITANIA SWEET MEAL BISCUITS,PIECE,6,2500,12712,2288,15000,March
7146,JAMIES COOKIES TIN 500G 10000,PIECE,6,10000,50847,9153,60000,March
7363,SUMZ PUMPKIN SEEDS 100G,PIECE,6,5000,25424,4576,30000,March
7777,DAIMA MILK STRAWBERRY 250ML,PIECE,6,2500,12712,2288,15000,March
7802,DOVE HYPOLLERGENIC 90G 5000,PIECE,6,5000,25424,4576,30000,March
7827,PEPSI HAMPERS 11000,PIECE,6,11000,55932,10068,66000,March
313,AUNT PORRIDGE 6MONTHS,PIECE,7,14000,83051,14949,98000,March
440,BABY JUNIOR 50G,PIECE,7,1500,8898,1602,10500,March
455,BABY NIPPLES BIG 1000,PIECE,7,1000,5932,1068,7000,March
667,BIRTHDAY CROWNS 5000,PIECE,7,5000,29661,5339,35000,March
729,BLUE TOILET BLOCKS DOUBLE,PIECE,7,5000,29661,5339,35000,March
1427,D.L MAXIMO CARAMEL NUTS,PIECE,7,3500,20763,3737,24500,March
1433,D.L NEOPOLITAN 500MLS,PIECE,7,9500,56356,10144,66500,March
1441,D.L VANILLA 1LTR,PIECE,7,18000,106780,19220,126000,March
1444,D.L VANILLA CREAM 120MLS,PIECE,7,2000,11864,2136,14000,March
1471,DAITY CAPPUCCINO VANILLA ICE CREAM,PIECE,7,5500,32627,5873,38500,March
1568,DEXE BLACK HAIR SHAMPOO,PIECE,7,2000,11864,2136,14000,March
1823,ECLAIRS,PIECE,7,200,1186,214,1400,March
1908,ENVELOPE A4,PIECE,7,500,2966,534,3500,March
2154,FOOD COLOUR ORANGE,PIECE,7,1000,5932,1068,7000,March
2311,GIFT BAG 2500,PIECE,7,2500,14831,2669,17500,March
2496,HANKIES 1500,PIECE,7,1500,8898,1602,10500,March
2789,JESA FRUIT STRAWBERRY 500G,PIECE,7,6000,35593,6407,42000,March
3096,KILL IT 150MLS,PIECE,7,11000,65254,11746,77000,March
3116,KIRUNGI PINEAPPLE 250MLS,PIECE,7,1000,5932,1068,7000,March
3152,KNICKERS 3500,PIECE,7,3500,20763,3737,24500,March
3213,KOPIKO BLANCA CREAMY,PIECE,7,2000,11864,2136,14000,March
3294,LATO MILK 400G,PIECE,7,19000,112712,20288,133000,March
3867,MOUSE &RAT TRAPS GREEN,PIECE,7,3000,17797,3203,21000,March
3917,MOVIT JELLY 85ML,PIECE,7,2000,11864,2136,14000,March
3964,MUSA'S COOKIES 180G,PIECE,7,3000,17797,3203,21000,March
4190,NOMI 250G BUCKET,PIECE,7,4000,23729,4271,28000,March
4342,OMO COMFORT 1KG,PIECE,7,13000,77119,13881,91000,March
4444,PAMPER 2 L.C,PIECE,7,9000,53390,9610,63000,March
4542,PEPSODENT HERBAL TRIPPLE140G,PIECE,7,5000,29661,5339,35000,March
4552,PERMANENT MAKER,PIECE,7,1000,5932,1068,7000,March
4706,PRADIP VANILLA ESSENCE,PIECE,7,5000,29661,5339,35000,March
4903,RELAX TP,PIECE,7,1500,8898,1602,10500,March
5018,ROYCO BEEF 500G,PIECE,7,12000,71186,12814,84000,March
5223,SENSODYNE MULTICARE 40MLS,PIECE,7,7000,41525,7475,49000,March
5259,SHARPENER SMALL,PIECE,7,500,2966,534,3500,March
5481,SNICKERS CHOCOLATE,PIECE,7,3500,20763,3737,24500,March
5482,SNOW SPRAYS 4500,PIECE,7,5000,29661,5339,35000,March
6427,VASELINE MEN JELLY FRESH 240ML,PIECE,7,9500,56356,10144,66500,March
6598,WISDOM SMOKERS TOOTHBRUSH,PIECE,7,2500,14831,2669,17500,March
6607,WRAPPING PAPER 1000,PIECE,7,1000,5932,1068,7000,March
6665,ZESTA 300 G,PIECE,7,7500,44492,8008,52500,March
6676,ZESTA TOMATO KETCHUP,PIECE,7,7000,41525,7475,49000,March
6794,KATOGO 2500,PIECE,7,2700,16017,2883,18900,March
7078,VASELINE BLUESEAL ALOEVERA 240ML,PIECE,7,9500,56356,10144,66500,March
7284,SUMZ SALT& VIEGAR,PIECE,7,600,3559,641,4200,March
7306,MAVAL GIRL PANTY LINERS,PIECE,7,2500,14831,2669,17500,March
7524,TOYS 2000,PIECE,7,2000,11864,2136,14000,March
7642,KAXUE TOOTH BRUSH,PIECE,7,2500,14831,2669,17500,March
7779,DAIMA MANGO 500ML,PIECE,7,3000,17797,3203,21000,March
7824,BANANA JUICE 5000,PIECE,7,5000,29661,5339,35000,March
55,AFIA WHITE GUAVA,PIECE,8,3000,20339,3661,24000,March
279,ASANTEE PAPAYA SOAP,PIECE,8,6500,44068,7932,52000,March
339,AXESS AQUA,PIECE,8,8000,54237,9763,64000,March
731,BLUEBAND LOW FAT 100G,PIECE,8,2000,13559,2441,16000,March
790,BOX FILES 6000,PIECE,8,7000,47458,8542,56000,March
917,C.B ROYAL MANGO 120ML,PIECE,8,2500,16949,3051,20000,March
918,C.B ROYAL MANGO 200ML,PIECE,8,4500,30508,5492,36000,March
981,CAMERA NIPPLES L,PIECE,8,1500,10169,1831,12000,March
1094,CHAMPION A4 96 PAGES,PIECE,8,2000,13559,2441,16000,March
1198,CLIMAX CITRUS FRUITS 50G,PIECE,8,2500,16949,3051,20000,March
1212,CLOSEUP TRIPLEFRESH 60G,PIECE,8,3000,20339,3661,24000,March
1247,COLGATE CHILDREN 50MLS,PIECE,8,4500,30508,5492,36000,March
1450,DABUR HERBAL CLOVE 150G,PIECE,8,6000,40678,7322,48000,March
1462,DAIRY MILK TOP DECK 80G,PIECE,8,8000,54237,9763,64000,March
1560,DETTOL SKINCARE 175G,PIECE,8,6500,44068,7932,52000,March
1785,DURU NATURAL CARE,PIECE,8,4500,30508,5492,36000,March
1945,F.D MIXED BERRIES 250G,PIECE,8,2500,16949,3051,20000,March
2113,FLOWERS 2000,PIECE,8,2000,13559,2441,16000,March
2176,FORTUNE GOLD 1LTR,PIECE,8,10000,67797,12203,80000,March
2724,JAMIES CAKES @ 40K,PIECE,8,40000,271186,48814,320000,March
2813,JESA VANILLA YOGHURT 500G,PIECE,8,3700,25085,4515,29600,March
2921,JUMBO STRAWBERRY RIPPLE 175ML,PIECE,8,4000,27119,4881,32000,March
3151,KNICKERS 3000,PIECE,8,3000,20339,3661,24000,March
3378,LIGHTERS,PIECE,8,1000,6780,1220,8000,March
3402,LONDON FACIAL WIPES,PIECE,8,3500,23729,4271,28000,March
3560,MAGIC 1KG SACHET,PIECE,8,8500,57627,10373,68000,March
3625,MAYONNAISE 237ML,PIECE,8,19000,128814,23186,152000,March
3655,MELEX SIMSIM BALLS 1000,PIECE,8,1000,6780,1220,8000,March
3722,MINUTE MAID APPLE 400ML,PIECE,8,2500,16949,3051,20000,March
3956,MUKWANO OIL 500ML JERRYCAN,PIECE,8,5000,33898,6102,40000,March
3997,NAIL CUTTER 2500,PIECE,8,2500,16949,3051,20000,March
4001,NANA HERBAL MOUTH 60MLS,PIECE,8,7500,50847,9153,60000,March
4046,NESCAFE CLASSIC 50G,PIECE,8,11250,76271,13729,90000,March
4199,NOTE BOOK 5500,PIECE,8,5500,37288,6712,44000,March
4576,PIAO PIAO TP,PIECE,8,1500,10169,1831,12000,March
4990,ROKI OIL 1LTR,PIECE,8,10000,67797,12203,80000,March
5049,SAFA TOMATO PASTE 400G,PIECE,8,6000,40678,7322,48000,March
5095,SANTA LUCIA LUMACA,PIECE,8,5000,33898,6102,40000,March
5273,SHENKE MOSQUITO REPELLANT DOUBLE 20000,PIECE,8,20000,135593,24407,160000,March
5567,SOY SAUCE DARK 500G,PIECE,8,10000,67797,12203,80000,March
5817,SUN-SIP COCOPINE 3LTR,PIECE,8,16000,108475,19525,128000,March
6102,TOP UP 700G,PIECE,8,3500,23729,4271,28000,March
6710,VASELINE BLUESEAL COCOA BUTTER 95ML,PIECE,8,5000,33898,6102,40000,March
6796,JESA FRUIT BLUEBERRY 150G,PIECE,8,2500,16949,3051,20000,March
7120,JAMIES DADDIES 500G 10000,PIECE,8,10000,67797,12203,80000,March
7174,JAMIES LIQUID SOAP 5LTR 10000,PIECE,8,10000,67797,12203,80000,March
7361,SUMZ DADDIES 300G,PIECE,8,5000,33898,6102,40000,March
7553,TOYS 3000,PIECE,8,3000,20339,3661,24000,March
7619,NICE BISCUITS ,PIECE,8,1500,10169,1831,12000,March
7644,FANEST CHICKEN SAUSAGES 500G,PIECE,8,20000,135593,24407,160000,March
7697,BODY SCRUBBER GLOVE 5000,PIECE,8,5000,33898,6102,40000,March
7707,JAMIES COOKIES@20000,PIECE,8,20000,135593,24407,160000,March
7733,SUMZ MATOOKE CRISPS BBQ 20G,PIECE,8,600,4068,732,4800,March
7,300MLS DISPOSABLE GLASSES,PIECE,9,5000,38136,6864,45000,March
686,BIYINZIKA MIXED PORTIONS 2KG,PIECE,9,37000,282203,50797,333000,March
939,CADBURY DAIRY MILK MINT CRISP 80G,PIECE,9,8000,61017,10983,72000,March
1045,CB CHOC-VANILLA 120MLS,PIECE,9,2500,19068,3432,22500,March
1262,COLGATE MAXIMUM CAVITY 35G,PIECE,9,2500,19068,3432,22500,March
1464,DAIRY TOP YOGHURT STRAWBERRY 250G,PIECE,9,1000,7627,1373,9000,March
1527,DENTEX TOOTHBRUSH SOFT,PIECE,9,3500,26695,4805,31500,March
2174,FORTUNE BUTTO 1LTR,PIECE,9,8500,64831,11669,76500,March
2286,GEISHA ALOE VERA&HONEY,PIECE,9,4000,30508,5492,36000,March
2289,GEISHA COCONUT MILK 200G,PIECE,9,4000,30508,5492,36000,March
2303,GEISHA TRADITIONAL BLACK SOAP 125G,PIECE,9,4000,30508,5492,36000,March
2725,JAMIES CAKES @50k,PIECE,9,50556,385593,69407,455000,March
2786,JESA FRUIT PEACH&PASSION 175,PIECE,9,2500,19068,3432,22500,March
2831,JIK REGULAR 250MLS,PIECE,9,6500,49576,8924,58500,March
3098,KILLIT 400MLS,PIECE,9,18000,137288,24712,162000,March
3156,KNICKERS 7000,PIECE,9,7000,53390,9610,63000,March
3290,LATO FLAVOURED BOX 23000,BOX,9,23000,175424,31576,207000,March
3945,MUKISA MANDAZI,PIECE,9,3000,22881,4119,27000,March
3995,NACET BLADES 2500 PKT,PIECE,9,2500,19068,3432,22500,March
4123,NISA LEMON HAIR REMOVAL CREME 20ML,PIECE,9,2000,15254,2746,18000,March
4195,NOTE BOOK 2000,PIECE,9,2000,15254,2746,18000,March
4343,OMO COMFORT 500G,PIECE,9,7500,57203,10297,67500,March
4516,PELIKAN RUBBER,PIECE,9,1000,7627,1373,9000,March
4589,PICFARE PENCILS PIECES 300,PIECE,9,300,2288,412,2700,March
4696,POULTRY VIENNAS 500G,PIECE,9,20222,154237,27763,182000,March
4948,RIHAM CREAM CHOCOLATE,PIECE,9,1200,9153,1647,10800,March
5020,ROYCO BEEF 60G,PIECE,9,1200,9153,1647,10800,March
5324,SHREEJI GRAPH BOOK 96,PIECE,9,3000,22881,4119,27000,March
5624,SPRING FILE 3000,PIECE,9,3000,22881,4119,27000,March
5759,SUMZ PUMPKIN SEEDS 50G,PIECE,9,2500,19068,3432,22500,March
5766,SUMZ TANGY LEMON CRISPS 30G,PIECE,9,1500,11441,2059,13500,March
5795,SUNLIGHT SPRING SENSATIONS 500G,PIECE,9,5500,41949,7551,49500,March
5802,SUNSEED OIL 1LTRS,PIECE,9,12000,91525,16475,108000,March
6216,TROPICAL HEAT TEA MASALA 45G,PIECE,9,5000,38136,6864,45000,March
6288,U-FRESH MANGO,PIECE,9,700,5339,961,6300,March
6469,VIM LAVENDER 500G,PIECE,9,5000,38136,6864,45000,March
6535,WEETABIX 225G,PIECE,9,8500,64831,11669,76500,March
7379,SUMZ COATED PEANUTS PLAINMASALA 150G,PIECE,9,3000,22881,4119,27000,March
7395,HIKMA HARD CORNS 2500,PIECE,9,2000,15254,2746,18000,March
7552,TOYS 5000,PIECE,9,5000,38136,6864,45000,March
10,5LTR JERRICAN 3000,PIECE,10,4000,33898,6102,40000,March
537,BALLET BUTTER BLEND 120MLS,PIECE,10,4500,38136,6864,45000,March
671,BIRTHDAY HATS 2500,PIECE,10,2500,21186,3814,25000,March
901,C.B CHOCOLATE CHOCO CHIP 120ML,PIECE,10,2500,21186,3814,25000,March
1201,CLIMAX FOREST FRUITS 50G,PIECE,10,2000,16949,3051,20000,March
1253,COLGATE HERBAL 230G,PIECE,10,9500,80508,14492,95000,March
1406,CUSSONS SOAP SOFT&SMOOTH,PIECE,10,3500,29661,5339,35000,March
1914,ERASER RUBBER,PIECE,10,500,4237,763,5000,March
1970,F.D VANILLA MILK 500MLS,PIECE,10,4000,33898,6102,40000,March
2002,FACE TOWEL 3000 WHITE,PIECE,10,3000,25424,4576,30000,March
2092,FIDODIDO VANILLA 220MLS,PIECE,10,2500,21186,3814,25000,March
2290,GEISHA COCONUTMILK 125G,PIECE,10,2500,21186,3814,25000,March
3119,KISUBI 85GM,PIECE,10,1500,12712,2288,15000,March
3130,KITUZI,PIECE,10,1000,8475,1525,10000,March
3553,MAGANJO SOYA RICE 1KGS,PIECE,10,7500,63559,11441,75000,March
4415,OWEN'S G-NUTS 2000,PIECE,10,2200,18644,3356,22000,March
4695,POULTRY VIENNAS 250G,PIECE,10,12300,104237,18763,123000,March
5746,SUMZ GINGER COOKIES,PIECE,10,4000,33898,6102,40000,March
6471,VIM LEMON FRESH 500G,PIECE,10,5000,42373,7627,50000,March
6848,PIZZA 16'' CHICKEN ,PIECE,10,35000,296610,53390,350000,March
6981,BAKEMATE LOVE CHOCOLATE ,PIECE,10,3500,29661,5339,35000,March
7102,JAMIES DADDIES TIN 20000,PIECE,10,20000,169492,30508,200000,March
7701,CLEAR BAGS 1500,PIECE,10,1500,12712,2288,15000,March
7783,MENTOS PEACH ORANGE,PIECE,10,2500,21186,3814,25000,March
4,180ML DISPOSABLE GLASSES,PIECE,11,3000,27966,5034,33000,March
91,ALWAYS ULTRA THIN,PIECE,11,3500,32627,5873,38500,March
353,B.D CANDLE NUMBERS,PIECE,11,1500,13983,2517,16500,March
902,C.B CHOCOLATE CHOCO CHIPS 200ML,PIECE,11,5000,46610,8390,55000,March
1096,CHAPA NYOTA BLUE 600G,PIECE,11,4000,37288,6712,44000,March
1259,COLGATE MAX-FRESH 130G,PIECE,11,6500,60593,10907,71500,March
1424,D.L FIESTA SALTED CARAMEL,PIECE,11,4000,37288,6712,44000,March
1428,D.L MAXIMO VAN-CHOCO FLAKES 175ML,PIECE,11,4000,37288,6712,44000,March
1486,DATES 3000,PIECE,11,3500,32627,5873,38500,March
1753,DOWNY VALLEY DEW 20ML,PIECE,11,700,6525,1175,7700,March
1999,FACE TOWEL 1000,PIECE,11,1000,9322,1678,11000,March
2288,GEISHA ALOEVERA &HONEY 125G,PIECE,11,2500,23305,4195,27500,March
2298,GEISHA ROSE&HONEY 225G,PIECE,11,4000,37288,6712,44000,March
2765,JAMIES TWISTED BREAD 1KG,PIECE,11,6000,55932,10068,66000,March
2797,JESA STRAW 250G YOGHURT,PIECE,11,2500,23305,4195,27500,March
3318,LATO VANILLA YOGHURT 250ML,PIECE,11,2500,23305,4195,27500,March
3566,MAGIC SACHET 45G,PIECE,11,500,4661,839,5500,March
3585,MAMIS PEANUT PASTE 500G,PIECE,11,8000,74576,13424,88000,March
4218,NUMA BUSHERA 1KG,PIECE,11,6500,60593,10907,71500,March
4450,PAMPER 4 L.C PANTS,PIECE,11,9000,83898,15102,99000,March
4718,PRESTIGE 500G,PIECE,11,7500,69915,12585,82500,March
4947,RIHAM COLA 320MLS,PIECE,11,1000,9322,1678,11000,March
5235,SESAME SNACKS,PIECE,11,5000,46610,8390,55000,March
5371,SIMKA CHOC-VANILLA 500ML,PIECE,11,4500,41949,7551,49500,March
5566,SOY SAUCE DARK 150G,PIECE,11,5000,46610,8390,55000,March
5730,SUMZ COATED PEANUT 50G,PIECE,11,1200,11186,2014,13200,March
6384,VALUE MAX PREP RAZOR,PIECE,11,3500,32627,5873,38500,March
6499,WATCH CELLS 500,PIECE,11,591,5508,992,6500,March
6936,JESA MIXED BERRY YOGHURT 500G,PIECE,11,3700,34492,6208,40700,March
7726,DABUR CHARCOAL 150G,PIECE,11,6500,60593,10907,71500,March
344,AZAM BAKING FLOUR 2KG,PIECE,12,8500,86441,15559,102000,March
613,BECCA COUNTERBOOK 5000,PIECE,12,4125,41949,7551,49500,March
845,BROOKSIDE PEAR CARAMEL,PIECE,12,5000,50847,9153,60000,March
1269,COLGATE TRIPLE ACTION 140G,PIECE,12,6500,66102,11898,78000,March
1475,DAITY STRAWBERRY VAN,PIECE,12,5500,55932,10068,66000,March
1856,EGGS TRAY,PIECE,12,14000,142373,25627,168000,March
1950,F.D PLAIN YOGHURT 450G,PIECE,12,3700,37627,6773,44400,March
2295,GEISHA MORINGA OIL 225G,PIECE,12,5500,55932,10068,66000,March
2414,GOOD DAY CHOCO CHIP,PIECE,12,5000,50847,9153,60000,March
2426,GORILLO'S BBQ BEEF 150G,PIECE,12,2500,25424,4576,30000,March
2428,GORILLO'S CHICKEN 150G,PIECE,12,2500,25424,4576,30000,March
3608,MARLOS CHOCOLATE,PIECE,12,2000,20339,3661,24000,March
3973,MUSAWO SOAP 240G,PIECE,12,3000,30508,5492,36000,March
4056,NEWFARM BANANA JUICE 500ML,PIECE,12,3500,35593,6407,42000,March
4247,NUTRO TEA BISCUIT,PIECE,12,3500,35593,6407,42000,March
4454,PAMPER 5 L.C PANTS,PIECE,12,9000,91525,16475,108000,March
5023,ROYCO CHICKEN 60G,PIECE,12,1200,12203,2197,14400,March
7015,JESA STRAWBERRY&CHOCOLATE 450G,PIECE,12,6000,61017,10983,72000,March
7476,MENTOS MINT 29G,PIECE,12,2500,25424,4576,30000,March
7621,MINTORE X PLUS 500,PIECE,12,500,5085,915,6000,March
841,BROOKSIDE FRUIT YOG VANILLA 450G,PIECE,13,5000,55085,9915,65000,March
913,C.B RIPPLES CHOCOLATE 200ML,PIECE,13,4000,44068,7932,52000,March
916,C.B RIPPLES STRAWBERRY 200ML,PIECE,13,4000,44068,7932,52000,March
1420,D.L CHOCO BOMB 70ML,PIECE,13,2500,27542,4958,32500,March
1558,DETTOL ORIGINAL 175G,PIECE,13,6500,71610,12890,84500,March
1942,F.D MANGO 450G,PIECE,13,3700,40763,7337,48100,March
4579,PICFARE 288PAGES 8500,PIECE,13,8000,88136,15864,104000,March
4597,PICK n PEEL MANGO 1LTR,PIECE,13,9500,104661,18839,123500,March
4711,PREDATOR ENERGY DRINK,PIECE,13,2000,22034,3966,26000,March
4951,RIHAM CREAMY CRUNCH STRAWBERRY,PIECE,13,3000,33051,5949,39000,March
5322,SHREEJI BOOKS 192PGS 6000,PIECE,13,6000,66102,11898,78000,March
5366,SIMKA CHOC- VAN 300ML,PIECE,13,3500,38559,6941,45500,March
5731,SUMZ COCONUT COOKIES,PIECE,13,4000,44068,7932,52000,March
6041,TOCEBA AAA,PIECE,13,700,7712,1388,9100,March
6534,WEETABIX 112G,PIECE,13,4500,49576,8924,58500,March
6564,WHISPPEX SHAVERS,PIECE,13,3000,33051,5949,39000,March
6650,YOUR CHOICE SAUSAGE 1KG,PIECE,13,30000,330508,59492,390000,March
6651,YOUR CHOICE SAUSAGES 500G,PIECE,13,17000,187288,33712,221000,March
637,BESSA MILLET MALT DRINK 330ML,PIECE,14,3000,35593,6407,42000,March
1421,D.L CHOCO NUT 70ML,PIECE,14,2500,29661,5339,35000,March
1461,DAIRY MILK PLAIN 80G,PIECE,14,8000,94915,17085,112000,March
2720,JAMIES BROWN SALT BREAD 500G,PIECE,14,3000,35593,6407,42000,March
3155,KNICKERS 6000,PIECE,14,6000,71186,12814,84000,March
3198,KOOKSY VANILLA 220ML,PIECE,14,2000,23729,4271,28000,March
3682,MESSAGE CARDS 500,PIECE,14,500,5932,1068,7000,March
3684,MIA GONJA 1000,PIECE,14,1000,11864,2136,14000,March
4245,NUTRO STRAW CREAM WAFERS,PIECE,14,3500,41525,7475,49000,March
4700,POWERPLAY 400MLS,PIECE,14,2000,23729,4271,28000,March
4963,RIHAM VANILLA CREAMYCRUNCH,PIECE,14,3000,35593,6407,42000,March
5214,SENSITIVE BABY WIPES,PIECE,14,7000,83051,14949,98000,March
5609,SPONGE 2000,PIECE,14,2000,23729,4271,28000,March
5660,STEEPO CHOCOLATE,PIECE,14,2000,23729,4271,28000,March
5735,SUMZ CORN CRAX 160G,PIECE,14,2500,29661,5339,35000,March
7703,TOYS 1000,PIECE,14,1000,11864,2136,14000,March
7813,PETIT BEURRE 78G,PIECE,14,1300,15424,2776,18200,March
6874,MUSHROOM STEW,PIECE,14.21,6868,82712,14888,97600,March
843,BROOKSIDE LEMON BISCUITS 450G,PIECE,15,5000,63559,11441,75000,March
890,BUSHENYI HONEY 250G,PIECE,15,6000,76271,13729,90000,March
1249,COLGATE DOUBLE ACTION,PIECE,15,4000,50847,9153,60000,March
1254,COLGATE HERBAL 35G,PIECE,15,2500,31780,5720,37500,March
1358,CREAMBELL STRAW-VAN 120ML,PIECE,15,2500,31780,5720,37500,March
2028,FANSICKERS COCOA CREAM,PIECE,15,2500,31780,5720,37500,March
2180,FORTUNE SPAGHETTI 250G,PIECE,15,2000,25424,4576,30000,March
2663,IMPERIAL LEATHER SOAP RED 175G,PIECE,15,4000,50847,9153,60000,March
2716,JAMAA WHITE WASHING BAR,PIECE,15,6000,76271,13729,90000,March
2730,JAMIES CROCKDILE BREAD 1KG,PIECE,15,6000,76271,13729,90000,March
3207,KOOKSY VANILLA STRAWBERRY 220ML,PIECE,15,2000,25424,4576,30000,March
3669,MEN SOCKS 3500,PIECE,15,3500,44492,8008,52500,March
5016,ROYCO BEEF 200G,PIECE,15,6000,76271,13729,90000,March
5377,SIMKA STRAW-VAN 500MLS,PIECE,15,4500,57203,10297,67500,March
5741,SUMZ CRISPS FRUIT CHUTNEY,PIECE,15,1500,19068,3432,22500,March
7810,EVERYDAY CREAM BISCUITS 80G,PIECE,15,1220,15508,2792,18300,March
1252,COLGATE HERBAL 140G,PIECE,16,7500,101695,18305,120000,March
1487,DATES 5000,PIECE,16,5500,74576,13424,88000,March
1959,F.D STRAWBERRY MILK 500MLS,PIECE,16,4000,54237,9763,64000,March
2175,FORTUNE BUTTO 500ML,PIECE,16,4500,61017,10983,72000,March
2235,FRUITVILLE MANGO 500ML,PIECE,16,3500,47458,8542,56000,March
2296,GEISHA ROSE&HONEY,PIECE,16,2500,33898,6102,40000,March
3305,LATO PEACH&CARAMEL FRUIT 450G,PIECE,16,5000,67797,12203,80000,March
3526,MACRO DENTAL FLOSS,PIECE,16,3000,40678,7322,48000,March
5181,SCOURING PADS 500,PIECE,16,500,6780,1220,8000,March
5521,SOFT CARE BABY WIPES,PIECE,16,7000,94915,17085,112000,March
5734,SUMZ CORN CRAX CHILLI80G,PIECE,16,1500,20339,3661,24000,March
5739,SUMZ CRISPS CHILLI 60G,PIECE,16,2500,33898,6102,40000,March
7137,JAMIES COOKIES 2000,PIECE,16,2000,27119,4881,32000,March
7494,FRUIT VILLE TROPICAL,PIECE,16,3500,47458,8542,56000,March
730,BLUE TOILET BLOCKS SINGLE50G,PIECE,17,2500,36017,6483,42500,March
892,BUSHENYI HONEY 90G,PIECE,17,3500,50424,9076,59500,March
915,C.B RIPPLES ORANGE 200ML,PIECE,17,4000,57627,10373,68000,March
1046,CB CLASSIC VANILLA 120MLS,PIECE,17,2500,36017,6483,42500,March
1265,COLGATE TOOTBRUSH,PIECE,17,2500,36017,6483,42500,March
1431,D.L MINI FIESTA CLASSIC 70MLS,PIECE,17,2500,36017,6483,42500,March
1511,DELLA CHOCOLATE,PIECE,17,3000,43220,7780,51000,March
1750,DOWNY FEEL LUX 20ML,PIECE,17,700,10085,1815,11900,March
1941,F.D MANGO 400G,PIECE,17,2500,36017,6483,42500,March
1964,F.D VANILLA 150G,PIECE,17,1800,25932,4668,30600,March
2291,GEISHA LEMON&HONEY,PIECE,17,4000,57627,10373,68000,March
3737,MIRINDA APPLE 2LTR,PIECE,17,4500,64831,11669,76500,March
3998,NAIL CUTTERS 1500,PIECE,17,1500,21610,3890,25500,March
4036,NEEK YOGHURT 500G 3500,PIECE,17,3500,50424,9076,59500,March
4131,NIVANA WATER 1.5L,PIECE,17,1500,21610,3890,25500,March
4896,RED BULL 250MLS,PIECE,17,7000,100847,18153,119000,March
349,AZAM MALT 500MLS,PIECE,18,3000,45763,8237,54000,March
1245,COLGATE CHARCOAL GENTLE CLEAN,PIECE,18,7500,114407,20593,135000,March
1246,COLGATE CHARCOAL TWIN TOOTHBRUSH,PIECE,18,4000,61017,10983,72000,March
1267,COLGATE TOOTHBRUSH CHARCOAL,PIECE,18,2500,38136,6864,45000,March
3202,KOOKSY VANILLA CHOCOLATE 220ML,PIECE,18,2000,30508,5492,36000,March
3472,M&G HELLO BEARS PEN ERASE,PIECE,18,2500,38136,6864,45000,March
3939,MR.ZECO SWEETS,PIECE,18,300,4576,824,5400,March
5355,SILVER PLATE 300,PIECE,18,300,4576,824,5400,March
5376,SIMKA STRAW-VAN 300MLS,PIECE,18,3500,53390,9610,63000,March
5597,SPLASH GUAVA 1LTR,PIECE,18,8000,122034,21966,144000,March
5736,SUMZ CORN CRAX 80G,PIECE,18,1500,22881,4119,27000,March
5844,SUPER GLUE,PIECE,18,1000,15254,2746,18000,March
49,AFIA APPLE 500ML,PIECE,19,3000,48305,8695,57000,March
52,AFIA MIXED FRUIT 500MLS,PIECE,19,3000,48305,8695,57000,March
1047,CB CLASSIC VANILLA 200MLS,PIECE,19,4000,64407,11593,76000,March
1255,COLGATE HERBAL 70G,PIECE,19,4500,72458,13042,85500,March
1288,COMPACT NAPKINS,PIECE,19,3000,48305,8695,57000,March
1356,CREAMBELL MAGIC STRAW120ML,PIECE,19,2500,40254,7246,47500,March
1931,EVERVESS,PIECE,19,1000,16102,2898,19000,March
1971,F.D YOGHURT MIXED BERRIES 450G,PIECE,19,3700,59576,10724,70300,March
2292,GEISHA LEMON&HONEY 125G,PIECE,19,2500,40254,7246,47500,March
2302,GEISHA TRADITIONAL BLACK SOAP,PIECE,19,5500,88559,15941,104500,March
2476,HABARI SALT BIG,PIECE,19,1000,16102,2898,19000,March
4364,ORANGES 2000,PIECE,19,2500,40254,7246,47500,March
5345,SILKEE DESIGNER SERVIETTES,PIECE,19,2500,40254,7246,47500,March
5763,SUMZ ROASTED NUTS 60G,PIECE,19,1500,24153,4347,28500,March
7378,SUMZ COATED PEANUTS CHILLI MASALA 150G,PIECE,19,3000,48305,8695,57000,March
7592,COLGATE CHARCOAL 210G 10000,PIECE,19,10000,161017,28983,190000,March
7770,PREDATOR ENERGY 350ML,PIECE,19,3000,48305,8695,57000,March
849,BROOKSIDE STRAWBERRIES 250G,PIECE,20,3000,50847,9153,60000,March
1953,F.D STRAWBERRY 150G,PIECE,20,1800,30508,5492,36000,March
1958,F.D STRAWBERRY FLAVOURED 250ML,PIECE,20,2000,33898,6102,40000,March
2026,FANAKA GUAVA 500ML,PIECE,20,3500,59322,10678,70000,March
2450,GRAPES 12000,PIECE,20,12000,203390,36610,240000,March
2952,KAKIRA SUGAR 2KG,PIECE,20,14000,237288,42712,280000,March
3458,LUXURY TOILET PAPER,PIECE,20,600,10169,1831,12000,March
3562,MAGIC 250G BUCKET,PIECE,20,4000,67797,12203,80000,March
3729,MINUTEMAID BERRY BLAST 1LTR,PIECE,20,5000,84746,15254,100000,March
4936,RIBENA 1LTR,PIECE,20,10000,169492,30508,200000,March
4950,RIHAM CREAMY CRUNCH CHOCOLATE,PIECE,20,3000,50847,9153,60000,March
5602,SPLASH MANGO 150ML,PIECE,20,1500,25424,4576,30000,March
7789,JAMIES DANISH BREAD@3500,PIECE,20,3500,59322,10678,70000,March
612,BECCA COUNTER BOOKS 6500,PIECE,21,6500,115678,20822,136500,March
914,C.B RIPPLES MIXED 200MLS,PIECE,21,4000,71186,12814,84000,March
2729,JAMIE'S COOKIE SCONES,PIECE,21,2000,35593,6407,42000,March
3433,LUCOZADE 1LTR,PIECE,21,10000,177966,32034,210000,March
4035,NEEK YOGHURT 300G 2000,PIECE,21,2500,44492,8008,52500,March
5477,SMILE PENS WAVE 500,PIECE,21,500,8898,1602,10500,March
5743,SUMZ CRUNCHY DADDIES 150G,PIECE,21,3000,53390,9610,63000,March
5750,SUMZ GONJA CRISPS 160G,PIECE,21,5500,97881,17619,115500,March
7486,APPLES PACKED 11000,PIECE,21,11000,195763,35237,231000,March
7648,COCKROACH KILLING BAIT 5G,PIECE,21,999,17784,3201,20985,March
636,BESSA MILLET DRINK 500MLS,PIECE,22,4500,83898,15102,99000,March
1445,D.L VAN-STRAW 120ML,PIECE,22,2000,37288,6712,44000,March
3214,KOPIKO BROWN COFFEE,PIECE,22,1500,27966,5034,33000,March
3656,MELEX SIMSIM BALLS 2000,PIECE,22,2000,37288,6712,44000,March
4034,NEEK YOGHURT 1LTR,PIECE,22,7000,130508,23492,154000,March
5380,SIMKA VANILLA 230MLS,PIECE,22,2000,37288,6712,44000,March
7163,SPIDERMAN SWEETS 700,PIECE,22,700,13051,2349,15400,March
1029,CARROT CAKE,PIECE,23,5000,97458,17542,115000,March
1949,F.D PLAIN YOGHURT 400G,PIECE,23,2500,48729,8771,57500,March
3673,MENTOS FRUIT,PIECE,23,2891,56356,10144,66500,March
5593,SPLASH APPLES 150ML,PIECE,23,1500,29237,5263,34500,March
5764,SUMZ SALT&VINEGAR 30G,PIECE,23,1500,29237,5263,34500,March
5876,SWEETS 1000,PIECE,23,1000,19492,3508,23000,March
7239,BEEF PILAU 20000,PIECE,23,4948,96441,17359,113800,March
7778,DAIMA MILK VANILLA 250ML,PIECE,23,2500,48729,8771,57500,March
254,AROMAT 75G,PIECE,24,5500,111864,20136,132000,March
832,BRITANIA SHORTCAKE BISCUITS,PIECE,24,2000,40678,7322,48000,March
846,BROOKSIDE PEAR CARAMEL 250G,PIECE,24,3000,61017,10983,72000,March
995,CANDLES 300,PIECE,24,300,6102,1098,7200,March
2825,JIB WATER 20LTRS REFILL,PIECE,24,8000,162712,29288,192000,March
2985,KAZIRE ALOEVERA,PIECE,24,1500,30508,5492,36000,March
3610,MARSHMALLOW DELICIOUS ASSORTED 15G,PIECE,24,2000,40678,7322,48000,March
3736,MIRINDA APPLE,PIECE,24,1500,30508,5492,36000,March
5090,SANTA LUCIA 250G,PIECE,24,2500,50847,9153,60000,March
5859,SWEET IVORY PCS,PIECE,24,100,2034,366,2400,March
7164,NUTRO ORANGE BISCUIT 1200,PIECE,24,1200,24407,4393,28800,March
2719,JAMIES BROWN SALT BREAD 1KG,PIECE,25,5500,116525,20975,137500,March
2811,JESA VANILLA YOGHURT 250G,PIECE,25,2500,52966,9534,62500,March
3217,KREST 500MLS,PIECE,25,1500,31780,5720,37500,March
3674,MENTOS GRAPE,PIECE,25,2500,52966,9534,62500,March
6642,YOJUS APPLE DRINK,PIECE,25,1000,21186,3814,25000,March
7808,PICNIK CHOCOLATE 10G,PIECE,25,1000,21186,3814,25000,March
346,AZAM EMBE MANGO,PIECE,26,1500,33051,5949,39000,March
648,BIC SHEVARS,PIECE,26,1000,22034,3966,26000,March
1291,COMSOFT FACIAL WIPES 1000,PIECE,26,1000,22034,3966,26000,March
1430,D.L MINI FIESTA CARAMEL,PIECE,26,2500,55085,9915,65000,March
1608,DIVINE 500MLS,PIECE,26,4000,88136,15864,104000,March
2803,JESA TOFFEE 250G,PIECE,26,2500,55085,9915,65000,March
4575,PIAO PIAO TP ORIGINAL,PIECE,26,2000,44068,7932,52000,March
7050,MARSHMALLOW PALAZI 1500,PIECE,26,2000,44068,7932,52000,March
3215,KOPIKO CAPPUCCINO CHOCO,PIECE,27,1500,34322,6178,40500,March
3335,LAVITA PINEAPPLE 320MLS,PIECE,27,1000,22881,4119,27000,March
3564,MAGIC 500G SACHET,PIECE,27,4500,102966,18534,121500,March
6643,YOJUS MANGO 150ML,PIECE,27,1000,22881,4119,27000,March
7139,SUMZ BBQ CRISPS 12G,PIECE,27,600,13729,2471,16200,March
836,BROOKSIDE FRUIT STRAWBERRIES,PIECE,28,5000,118644,21356,140000,March
5539,SOFTCARE SANITARY PADS,PIECE,28,3000,71186,12814,84000,March
7385,RIHAM X-ENERGY 320ML,PIECE,28,1500,35593,6407,42000,March
7404,MELEX SIMSIM BALLS 250G,PIECE,28,5000,118644,21356,140000,March
713,BLUE BAND 100G,PIECE,29,2500,61441,11059,72500,March
2342,GILLETTE BLUE2 PLUS,PIECE,29,2500,61441,11059,72500,March
3435,LUCOZADE 250MLS,PIECE,29,3000,73729,13271,87000,March
51,AFIA MANGO 500MLS,PIECE,30,3000,76271,13729,90000,March
1169,CLASSIC G.B.K WHOLE MILK 500ML,PIECE,30,2200,55932,10068,66000,March
1334,COVERTINA CHOCOLATE 500,PIECE,30,500,12712,2288,15000,March
2799,JESA STRAW YOGHURT 400G,PIECE,30,2500,63559,11441,75000,March
5091,SANTA LUCIA 450G,PIECE,30,5000,127119,22881,150000,March
5180,SCOURER 1000,PIECE,30,1000,25424,4576,30000,March
5591,SPLASH APPLE 1LTR,PIECE,30,8000,203390,36610,240000,March
5864,SWEET PEPSI,PIECE,30,100,2542,458,3000,March
6976,SUMZ POTATO CRIPS TASTY TOMATO 30G,PIECE,30,1500,45000,0,45000,March
86,ALWAYS EXTRA LONG,PIECE,31,3500,91949,16551,108500,March
2070,FIDODIDO CHOCOLATE 120ML,PIECE,31,1200,31525,5675,37200,March
348,AZAM MALT 300MLS,PIECE,32,1500,40678,7322,48000,March
2728,JAMIES COCONUT BREAD 500G,PIECE,32,3016,81780,14720,96500,March
2755,JAMIES SWEET CAKE BREAD 500G,PIECE,32,3000,81356,14644,96000,March
4208,NOVIDA 350MLS,PIECE,32,1000,27119,4881,32000,March
4953,RIHAM CREAMY STRAWBERRY,PIECE,32,1200,32542,5858,38400,March
5744,SUMZ DADDIES 75G 1000,PIECE,32,1500,40678,7322,48000,March
7296,BANANA JUICE 3000,PIECE,32,3000,81356,14644,96000,March
7745,CHOCOLATE 800,PIECE,32,800,21695,3905,25600,March
7815,7UP 330ML,PIECE,32,1000,27119,4881,32000,March
2682,INDOMIE BEEF NOODLES 120G,PIECE,33,2000,55932,10068,66000,March
3302,LATO MIXED BERRIES 250G,PIECE,33,3000,83898,15102,99000,March
3319,LATO VANILLA YOGHURT 500G,PIECE,33,3700,103475,18625,122100,March
3321,LATO YOG MIXED BERRIES 450G,PIECE,33,5000,139831,25169,165000,March
3323,LATO YOG STRAWBERRY 250G,PIECE,33,2500,69915,12585,82500,March
3742,MIRINDA ORANGE 2LTRS,PIECE,33,4500,125847,22653,148500,March
3744,MIRINDA ORANGE 500ML,PIECE,33,1500,41949,7551,49500,March
6101,TOP UP 400G,PIECE,33,2000,55932,10068,66000,March
1946,F.D MIXED BERRIES 400G,PIECE,34,2500,72034,12966,85000,March
6816,BLUE BAND 250G,PIECE,34,5000,144068,25932,170000,March
347,AZAM ENERGY DRINK 300MLS,PIECE,35,1500,44492,8008,52500,March
4236,NUTRO CHOCOLATE BISCUITS,PIECE,35,1200,35593,6407,42000,March
5604,SPLASH MANGO JUICE 1LTR,PIECE,35,8000,237288,42712,280000,March
7365,SUMZ BAGGIA 50G,PIECE,35,1500,44492,8008,52500,March
1289,COMPACT T.P,PIECE,36,1000,30508,5492,36000,March
1484,DATES 1000,PIECE,36,1000,30508,5492,36000,March
2498,HANKIES 3000,PIECE,36,3000,91525,16475,108000,March
5636,SQUISHY STRAWBERRY 200ML,PIECE,36,2000,61017,10983,72000,March
5717,SUGAR 1KG,PIECE,36,6500,198305,35695,234000,March
4615,PK CHEWING GUM 500,PIECE,37,500,15678,2822,18500,March
6612,YAKET 1.5LTR,PIECE,37,1500,47034,8466,55500,March
1969,F.D VANILLA FLAVOURED 250ML,PIECE,38,2000,64407,11593,76000,March
2060,FAY TP,PIECE,38,2000,64407,11593,76000,March
2812,JESA VANILLA YOGHURT 400G,PIECE,38,2500,80508,14492,95000,March
3315,LATO VANILLA 100G,PIECE,38,1200,38644,6956,45600,March
3944,MUKISA CAKE 2500,PIECE,38,2500,80508,14492,95000,March
4964,RIHAM WATER 1.5LTRS,PIECE,38,2000,64407,11593,76000,March
6894,SQUISHY JUICE APPLE,PIECE,38,2000,64407,11593,76000,March
7073,SUMZ TANGY LEMON CRISPS 12G,PIECE,38,600,19322,3478,22800,March
7279,JUICE 4000 500ml,PIECE,38,4000,128814,23186,152000,March
5379,SIMKA VANILLA 120MLS,PIECE,39,1000,33051,5949,39000,March
6876,"GREENS (NAKATI,DODO ETC)",PIECE,39.42,5884,196568,35382,231950,March
1936,F.D CHOCOLATE MILK 250MLS,PIECE,40,2000,67797,12203,80000,March
2089,FIDODIDO STRWABERRY 220ML,PIECE,40,2500,84746,15254,100000,March
5674,STONEY 500MLS,PIECE,40,1500,50847,9153,60000,March
6272,UBISCO CREAMS VANILLA,PIECE,40,1000,33898,6102,40000,March
1932,EVERVESS 500ML,PIECE,41,1500,52119,9381,61500,March
3306,LATO PLAIN YOGHURT 500G,PIECE,41,3700,128559,23141,151700,March
4945,RIHAM COFFEE MALT,PIECE,41,1500,52119,9381,61500,March
5625,SPRITE 2LTR,PIECE,41,5000,173729,31271,205000,March
5753,SUMZ POTATO CRISP BBQ 30G,PIECE,41,1500,52119,9381,61500,March
1485,DATES 2000,PIECE,42,2000,71186,12814,84000,March
1961,F.D UHT MILK 2000,PIECE,42,2000,71186,12814,84000,March
3723,MINUTE MAID BERRY BLAST 400MLS,PIECE,42,2500,88983,16017,105000,March
4350,ONER MANGO 1LTR,PIECE,42,5000,177966,32034,210000,March
5754,SUMZ POTATO CRISPS 180G,PIECE,42,5000,177966,32034,210000,March
7790,JAMIES CINNAMON BREAD,PIECE,42,5940,211441,38059,249500,March
3322,LATO YOG STRAWBERRY 100G,PIECE,43,1200,43729,7871,51600,March
3738,MIRINDA APPLE 330ML,PIECE,43,1000,36441,6559,43000,March
3739,MIRINDA FRUITY,PIECE,43,1500,54661,9839,64500,March
5749,SUMZ GONJA 90G CRISPS,PIECE,43,3000,109322,19678,129000,March
7425,JAMIES QUEEN CAKES WHOLESALE 2500,PIECE,43,2500,91102,16398,107500,March
7784,TOUCH AKY,PIECE,43,1000,36441,6559,43000,March
844,BROOKSIDE MILK 500ML,PIECE,44,2300,85763,15437,101200,March
3690,MIKOSHI GREEN TEA,PIECE,44,6000,223729,40271,264000,March
4535,PEPSI 2LTR,PIECE,44,4500,167797,30203,198000,March
4717,PRESTIGE 250G,PIECE,44,4500,167797,30203,198000,March
5050,SAFA TOMATO PASTE 70GM,PIECE,44,1500,55932,10068,66000,March
5627,SPRITE 500MLS,PIECE,44,1500,55932,10068,66000,March
2033,FANTA FRUIT BLAST 350ML,PIECE,45,1000,38136,6864,45000,March
5367,SIMKA CHOCO BAR 100MLS,PIECE,45,2500,95339,17161,112500,March
7173,D.L FIESTA WHITE 70ML,PIECE,45,3000,114407,20593,135000,March
7143,GRAVY SOUP 1000,PIECE,45.62,1000,38653,6957,45610,March
3194,KOOKSY VAN-CHOC 120MLS,PIECE,46,1000,38983,7017,46000,March
5672,STING RED RUSH,PIECE,46,2000,77966,14034,92000,March
1607,DIVINE 300MLS,PIECE,47,2500,99576,17924,117500,March
1935,EXOTIC 320MLS,PIECE,47,1000,39831,7169,47000,March
5592,SPLASH APPLE 250MLS,PIECE,47,2000,79661,14339,94000,March
7554,AFIA LEMON 500ML,PIECE,47,3000,119492,21508,141000,March
7706,JAMIES MILK BREAD 500G,PIECE,47,3500,139407,25093,164500,March
6871,POSHO KG,PIECE,47.46,5517,221915,39945,261860,March
3188,KOOKSY STRAWBERRY 120ML,PIECE,48,1000,40678,7322,48000,March
4024,NATARAJ PENS,PIECE,48,700,28475,5125,33600,March
5634,SQUISHY FRUIT DRINK 200ML,PIECE,48,2000,81356,14644,96000,March
5808,SUNSHINE CHICKEN FLAVOR,PIECE,48,500,20339,3661,24000,March
3285,LATO CHOCOLATE MILK 250MLS,PIECE,49,2000,83051,14949,98000,March
6280,UBISCO KREAMY CREAMS STRAWBERRY,PIECE,49,1000,41525,7475,49000,March
7647,SKY VIEW APPLE 320ML,PIECE,49,1000,41525,7475,49000,March
1968,F.D VANILLA 450G,PIECE,50,3700,156780,28220,185000,March
3296,LATO MILK CHOCOLATE 125ML FLAVOURED,PIECE,51,1000,43220,7780,51000,March
5435,SKY VIEW ORANGE 320ML,PIECE,51,1000,43220,7780,51000,March
5635,SQUISHY FRUIT DRINK MANGO 200ML,PIECE,51,2000,86441,15559,102000,March
5811,SUNSHINE TOMATO FLAVOR,PIECE,51,500,21610,3890,25500,March
6271,UBISCO CREAMS CHOCOLATE,PIECE,51,1000,43220,7780,51000,March
7165,ONER APPLE DRINK 1LTR,PIECE,51,5000,216102,38898,255000,March
647,BIC PENS,PIECE,52,700,30847,5553,36400,March
6943,SUMZ POTATO CRISPS FRUIT CHUTNEY 12G,PIECE,52,600,26441,4759,31200,March
2684,INDOMIE NOODLES CHICKEN 120G,PIECE,53,2000,89831,16169,106000,March
4965,RIHAM WATER 600ML,PIECE,53,1000,44915,8085,53000,March
6859,ROLEX NORMAL 2EGGS,PIECE,54,2500,114407,20593,135000,March
7112,PUMPKIN SLICE 1000,PIECE,55,1000,46610,8390,55000,March
6572,WHITE STAR SOAP 1KG,PIECE,57,7000,338136,60864,399000,March
7656,JAMIES MANDAZ 1000,PIECE,57,1000,48305,8695,57000,March
1910,ENVELOPES 200,PIECE,58,200,9831,1769,11600,March
2234,FRUITVILLE GUAVA 500ML,PIECE,58,3500,172034,30966,203000,March
4534,PEPSI,PIECE,58,1500,73729,13271,87000,March
7397,JAMIES SWEET YELLOW 500G WHOLE SALE 2500,PIECE,58,2500,122881,22119,145000,March
3311,LATO STRAWBERRY YOGHURT 500G,PIECE,59,3700,185000,33300,218300,March
4537,PEPSI MAX,PIECE,59,1000,50000,9000,59000,March
7771,SUMZ HONEY BUTTER FLAVOUR 12G,PIECE,59,600,30000,5400,35400,March
4209,NOVIDA 500MLS,PIECE,60,1500,76271,13729,90000,March
6464,VIGOS HAZELNUT CHOCOLATE 800,PIECE,61,800,41356,7444,48800,March
3061,KICK SNACKS TOMATO FLAVOUR 15G,PIECE,63,500,26695,4805,31500,March
4956,RIHAM EXOTIC TAMARIND,PIECE,63,1000,53390,9610,63000,March
6310,UKWAJU,PIECE,63,1500,80085,14415,94500,March
2950,KAKIRA SUGAR 1KG,PIECE,65,7000,385593,69407,455000,March
3284,LATO CHOCO PWDER MILK 15G,PIECE,65,500,27542,4958,32500,March
3326,LATO YOGHURT STRAWBERRY 400G,PIECE,65,2500,137712,24788,162500,March
3740,MIRINDA FRUITY 2LTR,PIECE,65,4500,247881,44619,292500,March
4937,RIBENA 250MLS,PIECE,65,3000,165254,29746,195000,March
5633,SQUISHY BLUE RASBERRY 200ML,PIECE,65,2000,110169,19831,130000,March
7431,JAMIES MARBLE CAKE 10000,PIECE,65,10000,550847,99153,650000,March
6971,SWEET POTATOES BOILED 1000,PIECE,66,1000,55932,10068,66000,March
1966,F.D VANILLA 250G,PIECE,67,2500,141949,25551,167500,March
5433,SKY VIEW FRUITII 320ML,PIECE,67,1000,56780,10220,67000,March
5882,SWEETS 700 BIG FIVE,PIECE,67,700,39746,7154,46900,March
1957,F.D STRAWBERRY 450G,PIECE,68,3700,213220,38380,251600,March
2805,JESA UHT FINO,PIECE,68,2000,115254,20746,136000,March
3324,LATO YOGHURT 400G VANILLA,PIECE,68,2500,144068,25932,170000,March
5879,SWEETS 300,PIECE,68,300,17288,3112,20400,March
824,BRITANIA MILK BISCUIT,PIECE,69,500,29237,5263,34500,March
3863,MOUNTAIN DEW 2LTR,PIECE,70,4500,266949,48051,315000,March
4045,NESCAFE CLASSIC 2G,PIECE,70,500,29661,5339,35000,March
5671,STING,PIECE,70,2000,118644,21356,140000,March
7130,JAMIES MUFFINS 2000,PIECE,70,2000,118644,21356,140000,March
1960,F.D UHT 200ML MILK,PIECE,71,1000,60169,10831,71000,March
2739,JAMIES HOT DOG BUNS 6PCS,PIECE,72,4000,244068,43932,288000,March
4248,NUTRO VANILLA 30G,PIECE,73,1200,74237,13363,87600,March
7374,JAMIES WHOLE SALE SWEET YELLOW 5000,PIECE,73,5000,309322,55678,365000,March
5436,SKYVIEW 320MLS,PIECE,74,1000,62712,11288,74000,March
1955,F.D STRAWBERRY 250G,PIECE,75,2500,158898,28602,187500,March
5369,SIMKA CHOC-VAN 230MLS,PIECE,75,2000,127119,22881,150000,March
1134,CHOCOLATE 500,PIECE,76,500,32203,5797,38000,March
2029,FANTA 2LTRS ORANGE,PIECE,78,5000,330508,59492,390000,March
3862,MOUNTAIN DEW,PIECE,79,1500,100424,18076,118500,March
7144,JAMIES DOUGHNUT BIG CHOCOLATE 2500,PIECE,79,2500,167373,30127,197500,March
2085,FIDODIDO STRAW-VAN 120MLS,PIECE,80,1200,81356,14644,96000,March
2727,JAMIES COCONUT BREAD 1KG,PIECE,80,5500,372881,67119,440000,March
4616,PK CHEWING GUM BIG,PIECE,80,1000,67797,12203,80000,March
7587,ONER TAMARIND 300ML,PIECE,80,1500,101695,18305,120000,March
5354,SILVER PLATE 1000,PIECE,81,1000,68644,12356,81000,March
7396,JAMIES SWEET WHITE WHOLESALE 500G 2500,PIECE,81,2500,171610,30890,202500,March
4888,REBEX RICH MILK STICK BISCUITS,PIECE,82,1200,83390,15010,98400,March
3743,MIRINDA ORANGE 330ML,PIECE,83,1000,70339,12661,83000,March
5626,SPRITE 350MLS,PIECE,83,1000,70339,12661,83000,March
5810,SUNSHINE PLAIN FLAVOR,PIECE,84,500,35593,6407,42000,March
1855,EGGS PIECES,PIECE,85,500,36017,6483,42500,March
3310,LATO STRAWBERRY MILK 250MLS,PIECE,87,2000,147458,26542,174000,March
3299,LATO MILK PWDER STRAWBERRY 15G,PIECE,90,500,38136,6864,45000,March
3721,MINUTE MAID 1LTRS,PIECE,92,5000,389831,70169,460000,March
4984,ROCK BOOM 320MLS,PIECE,92,2000,155932,28068,184000,March
6695,JAMIES CAKE SLICE @6k,PIECE,96,6000,488136,87864,576000,March
7278,JUICE 2000 300ML,PIECE,97,2000,164407,29593,194000,March
2754,JAMIES SWEET CAKE BREAD 1KG,PIECE,99,5500,461441,83059,544500,March
5809,SUNSHINE ONION FLAVOR,PIECE,99,500,41949,7551,49500,March
4349,ONER BERRIES JUICE DRINK,PIECE,100,2500,211864,38136,250000,March
7410,ONER TAMARIND 500ML,PIECE,101,2500,213983,38517,252500,March
2758,JAMIES SWEET WHITE BUNS 12PCS,PIECE,104,3500,308475,55525,364000,March
826,BRITANIA MUNCHIES BISCUITS,PIECE,106,500,44915,8085,53000,March
7704,JAMIES MILK BREAD 5500,PIECE,107,6000,544068,97932,642000,March
1963,F.D VANILLA 100G,PIECE,109,1200,110847,19953,130800,March
5748,SUMZ GONJA 40G,PIECE,109,1500,138559,24941,163500,March
2736,JAMIES COOKIES 4000,PIECE,110,4000,372881,67119,440000,March
7398,JAMIES SWEET BROWN 500G WHOLE SALE 2500,PIECE,110,2500,233051,41949,275000,March
2032,FANTA 500MLS,PIECE,111,1500,141102,25398,166500,March
3317,LATO VANILLA MILK 250MLS,PIECE,111,2000,188136,33864,222000,March
6776,KEBAB 3000,PIECE,111,3000,282203,50797,333000,March
3327,LATO YOGHURT VANILLA 200G,PIECE,114,1000,96610,17390,114000,March
1221,COCACOLA 2LTRS,PIECE,115,5000,487288,87712,575000,March
3361,LEMON CAKES 1000,PIECE,116,1200,117966,21234,139200,March
5603,SPLASH MANGO 250MLS,PIECE,116,2000,196610,35390,232000,March
1967,F.D VANILLA 400G,PIECE,118,2500,250000,45000,295000,March
2681,INDOMIE BEEF 70G,PIECE,120,1200,122034,21966,144000,March
6799,SPRING ROLLS VEGETABLE 1000,PIECE,120,1000,101695,18305,120000,March
1223,COCACOLA 500MLS,PIECE,121,1500,153814,27686,181500,March
2752,JAMIES SWEET BROWN BREAD 500G,PIECE,121,3000,307627,55373,363000,March
3864,MOUNTAIN DEW 300MLS,PIECE,121,1000,102542,18458,121000,March
5356,SILVER PLATE 500,PIECE,123,500,52119,9381,61500,March
7142,JAMIES MARBLE CAKE 3000,PIECE,127,3000,322881,58119,381000,March
3316,LATO VANILLA 125ML MILK,PIECE,128,1000,108475,19525,128000,March
6841,PIZZA CHICKEN SLICE BIG ,PIECE,128,6000,650847,117153,768000,March
2427,GORILLO'S BBQ BEEF 24G,PIECE,130,500,55085,9915,65000,March
5757,SUMZ POTATO CRISPS 90G,PIECE,132,3000,335593,60407,396000,March
4536,PEPSI 330ML,PIECE,133,1000,112712,20288,133000,March
2203,FRESH DAIRY MILK UHT 500ML,PIECE,134,2000,227119,40881,268000,March
2763,JAMIES SWEET YELLOW BUNS 6PCS,PIECE,134,3500,397458,71542,469000,March
2683,INDOMIE NOODLES 70G,PIECE,142,1200,144407,25993,170400,March
3309,LATO STRAWBERRY MILK 125MLS,PIECE,142,1000,120339,21661,142000,March
5375,SIMKA STRAW-VAN 230MLS,PIECE,142,2000,240678,43322,284000,March
1956,F.D STRAWBERRY 400G,PIECE,143,2500,302966,54534,357500,March
4960,RIHAM ONER APPLE 300ML,PIECE,148,1500,188136,33864,222000,March
2514,HARMONY POT WATER 1LTR,PIECE,149,2000,252542,45458,298000,March
5878,SWEETS 200,PIECE,149,200,25254,4546,29800,March
1952,F.D STRAWBERRY 100G,PIECE,150,1200,152542,27458,180000,March
6808,CRACKERS 1500,PIECE,150,2000,254237,45763,300000,March
2792,JESA MILK 1LTR,PIECE,155,3600,472881,85119,558000,March
3741,MIRINDA FRUITY 330MLS,PIECE,157,1000,133051,23949,157000,March
2761,JAMIES SWEET YELLOW BREAD 500G,PIECE,162,3000,411864,74136,486000,March
6784,LIVER STEW 8000,PIECE,164.04,7330,1019068,183432,1202500,March
2748,JAMIES QUEEN CAKES 6PCS 3000,PIECE,166,3500,492373,88627,581000,March
4351,ONER MANGO 500MLS,PIECE,166,2500,351695,63305,415000,March
3325,LATO YOGHURT SRAWBERRY 200G,PIECE,170,1000,144068,25932,170000,March
2740,JAMIES MANDAZ 8PCS,PIECE,174,3000,442373,79627,522000,March
2759,JAMIES SWEET WHITE BUNS 6PCS,PIECE,175,3500,519068,93432,612500,March
4961,RIHAM ONER MANGO 300ml,PIECE,177,1500,225000,40500,265500,March
2718,JAMIES BROWN BUNS 6PCS,PIECE,181,3500,536864,96636,633500,March
7650,JAMIES SWEET WHITE BUNS @4000,PIECE,183,4000,620339,111661,732000,March
4347,ONER APPLE JUICE DRINK,PIECE,185,2500,391949,70551,462500,March
1286,COMFORT T.P 1000,PIECE,188,1000,159322,28678,188000,March
7375,JAMIES WHOLE SALE SWEET BROWN 5000,PIECE,190,5000,805085,144915,950000,March
563,BALOON 300,PIECE,193,300,49068,8832,57900,March
3725,Minute maid mango,PIECE,195,2500,413136,74364,487500,March
2431,GORILLO'S CHILLI TOMATO 24G,PIECE,196,500,83051,14949,98000,March
2734,JAMIES DOUGH NUTS HUGE,PIECE,196,2000,332203,59797,392000,March
6813,GRILLED CHICKEN 7000,PIECE,196,7000,1162712,209288,1372000,March
5368,SIMKA CHOC-VAN 120MLS,PIECE,200,1000,169492,30508,200000,March
4348,ONER BERRIES 300ML,PIECE,201,1500,255508,45992,301500,March
5807,SUNSHINE BEEF FLAVOR,PIECE,202,500,85593,15407,101000,March
6775,CHAPS 3000,PIECE,207,3000,526271,94729,621000,March
5756,SUMZ POTATO CRISPS 40G,PIECE,209,1500,265678,47822,313500,March
6613,YAKET 550ML,PIECE,210,500,88983,16017,105000,March
7370,JAMIES SCONES WHOLESALE 1000,PIECE,210,1000,177966,32034,210000,March
2757,JAMIES SWEET WHITE BREAD 500,PIECE,219,3000,556780,100220,657000,March
6970,YAM SLICE 1000,PIECE,223,1000,188983,34017,223000,March
2031,FANTA 330MLS,PIECE,229,1000,194068,34932,229000,March
2513,HARMONY POT WATER,PIECE,238,1000,201695,36305,238000,March
3298,LATO MILK POWDER 15G,PIECE,241,500,102119,18381,120500,March
3060,KICK SNACKS CHICKEN,PIECE,244,500,103390,18610,122000,March
5043,RWENZORI WATER 500ML,PIECE,251,1000,212712,38288,251000,March
7430,JAMIES SWEET YELLOW BUNS WHOLESALE 2500,PIECE,263,2500,557203,100297,657500,March
5347,SILKEE JUMBO TP,PIECE,265,2000,449153,80847,530000,March
182,APPLES GREEN,PIECE,278,1500,353390,63610,417000,March
6773,VEGETABLE SAMOSA 1000,PIECE,279,1000,236441,42559,279000,March
1222,COCACOLA 350MLS,PIECE,281,1000,238136,42864,281000,March
5755,SUMZ POTATO CRISPS 20G,PIECE,282,600,143390,25810,169200,March
5881,SWEETS 500,PIECE,291,500,123305,22195,145500,March
5374,SIMKA STRAW-VAN 120MLS,PIECE,293,1000,248305,44695,293000,March
6807,BEAN STEW 2000,PIECE,298.84,2002,507136,91284,598420,March
6820,BEEF SAMOSA 1500,PIECE,303,1500,385169,69331,454500,March
6840,GONJA FRIED 1000,PIECE,305,1000,258475,46525,305000,March
7376,JAMIES WHOLE SALE SWEET WHITE 5000,PIECE,307,5000,1300847,234153,1535000,March
2751,JAMIES SWEET BROWN BREAD1KG,PIECE,310,5500,1444915,260085,1705000,March
7497,JAMIES SWEET BUNS BROWN 6PCS WHOLESALE,PIECE,316,2500,669492,120508,790000,March
6779,PILAO PLAIN 10000,PIECE,322.76,10000,2735254,492346,3227600,March
2429,GORILLO'S CHICKEN 24G,PIECE,326,500,138136,24864,163000,March
6868,SPAGHETI 2500,PIECE,328.6,2470,687881,123819,811700,March
4128,NIVANA 500MLS,PIECE,329,500,139407,25093,164500,March
6790,KATOGO 4000,PIECE,331,3960,1110805,199945,1310750,March
6781,VEGETABLE RICE 7000,PIECE,365.89,6801,2108983,379617,2488600,March
5036,RWENZORI 1.5LTRS,PIECE,371,2000,628814,113186,742000,March
7727,JAMIES SWEET WHITE BUNS WHOLESALE,PIECE,376,2500,940000,0,940000,March
7026,CHICKEN STEW 4000,PIECE,378,4000,1281356,230644,1512000,March
5875,SWEETS 100,PIECE,407,100,34492,6208,40700,March
6889,EGGS BOILED 500,PIECE,425,500,180085,32415,212500,March
2760,JAMIES SWEET YELLOW BREAD 1KG,PIECE,426,5500,1985593,357407,2343000,March
2744,JAMIES MUFFINS,PIECE,447,1500,568220,102280,670500,March
2756,JAMIES SWEET WHITE BREAD 1KG,PIECE,467,5500,2176695,391805,2568500,March
6792,CHIPS 2500,PIECE,498.84,2516,1063475,191425,1254900,March
2735,JAMIES DOUGH NUTS SMALL 4000,PIECE,670,3000,1703390,306610,2010000,March
6805,PANCAKES 500,PIECE,683,500,289407,52093,341500,March
6812,BEEF STEW 6000,PIECE,709,2017,1211864,218136,1430000,March
183,APPLES RED,PIECE,789,1500,1002966,180534,1183500,March
2793,JESA MILK 500ML,PIECE,1311,1800,1999831,359969,2359800,March
6788,BEEF SAUSAGES 1000,PIECE,1602,1000,1357627,244373,1602000,March
6821,CHAPATI 1000,PIECE,2935,1000,2487288,447712,2935000,March
6870,FRIED RICE,PIECE,0.27,15000,3432,618,4050,April
18,7DAYS PANT LINERS,PIECE,1,4000,3390,610,4000,April
35,ACTIVE MAN SPRAY,PIECE,1,10000,8475,1525,10000,April
56,AFRICANA TEA BAGS 100,PIECE,1,8500,7203,1297,8500,April
58,AFRICANA TEA BAGS 50,PIECE,1,5000,4237,763,5000,April
60,AFROCARE BODY LOTION 400ML,PIECE,1,6000,5085,915,6000,April
71,ALLIANCE LIVEN COFFEE,PIECE,1,3500,2966,534,3500,April
83,ALWAYS COTTON MAXITHICK,PIECE,1,3000,2542,458,3000,April
85,ALWAYS DREAMZZZ VALUE PACK,PIECE,1,6500,5508,992,6500,April
88,ALWAYS LONG,PIECE,1,3500,2966,534,3500,April
110,AMARA HYDRATING GLYCERINE 200ML,PIECE,1,6000,5085,915,6000,April
111,AMARA HYDRATING GLYCERINE 400ML LOTION,PIECE,1,8500,7203,1297,8500,April
120,AMARO MOSQUITO REPELLENT,PIECE,1,4000,3390,610,4000,April
125,AMERICAN GARDEN KETCHUP 340G,PIECE,1,7500,6356,1144,7500,April
127,AMERICAN GARDEN KETCHUP 425G,PIECE,1,13500,11441,2059,13500,April
131,AMERICAN GARDEN MUSTARD 14OZ,PIECE,1,15000,12712,2288,15000,April
154,AMRAF HIGH STREET MIST,PIECE,1,14000,11864,2136,14000,April
195,AQUAFRESH HERBAL 50ML,PIECE,1,5000,4237,763,5000,April
196,AQUAVERA ELA MORE 250ML,PIECE,1,13000,11017,1983,13000,April
211,ARIEL DOWNY 1KG,PIECE,1,15500,13136,2364,15500,April
214,ARIEL LAVENDER 1KG,PIECE,1,15500,13136,2364,15500,April
218,ARMAF AIR FRESHNER SPRING,PIECE,1,10000,8475,1525,10000,April
235,ARMAF SHADES FOR MEN,PIECE,1,16000,13559,2441,16000,April
240,ARMAF TAG-HIM SPRAY,PIECE,1,15000,12712,2288,15000,April
276,ART PENCILS 5B,PIECE,1,1000,847,153,1000,April
299,ATIS CREAM CHOCOLATE,PIECE,1,500,424,76,500,April
312,AUNT PORRIDGE 2KG,PIECE,1,28000,23729,4271,28000,April
331,AXE DARK TEMPTATION,PIECE,1,12000,10169,1831,12000,April
382,BABY BLANKETS 35000 OS,PIECE,1,35000,29661,5339,35000,April
383,BABY BOTTLE 092 6000,PIECE,1,6000,5085,915,6000,April
417,BABY CUPS 6000,PIECE,1,6000,5085,915,6000,April
418,BABY CUPS 7000,PIECE,1,7000,5932,1068,7000,April
421,BABY DOLL LONG 50000,PIECE,1,50000,42373,7627,50000,April
431,BABY FEEDING CUPS 7000,PIECE,1,7000,5932,1068,7000,April
498,BABY&ME BABY CREAM,PIECE,1,4000,3390,610,4000,April
499,BABY&ME BABY LOTION,PIECE,1,7000,5932,1068,7000,April
501,BABY&ME JELLY 120ML,PIECE,1,3000,2542,458,3000,April
534,BALLET BABY OIL ALMOND 240ML,PIECE,1,14000,11864,2136,14000,April
538,BALLET BUTTER BLEND 300ML,PIECE,1,9500,8051,1449,9500,April
543,BALLET SHEA BUTTER SOAP,PIECE,1,3500,2966,534,3500,April
562,BALLS SOFT 1000,PIECE,1,2000,1695,305,2000,April
610,BEAUTY DOLL 12000,PIECE,1,12000,10169,1831,12000,April
613,BECCA COUNTERBOOK 5000,PIECE,1,3500,2966,534,3500,April
618,BED SHEET 25000,PIECE,1,25000,21186,3814,25000,April
658,BIKERS 7000,PIECE,1,8000,6780,1220,8000,April
664,BIRTHDAY CANDLES 3500,PIECE,1,4000,3390,610,4000,April
681,BIYINZIKA CHICKEN GIZZARDS 500G,PIECE,1,11000,9322,1678,11000,April
688,BIYINZIKA STANDARD1.2KG,PIECE,1,25000,21186,3814,25000,April
705,BLESSED KISUBI TEA 350G,PIECE,1,12000,10169,1831,12000,April
717,BLUE BAND LOW FAT,PIECE,1,6500,5508,992,6500,April
725,BLUE LAGOON PASSION SPLASH,PIECE,1,17000,14407,2593,17000,April
734,BNC MOSQUITO COIL,PIECE,1,4500,3814,686,4500,April
766,BOTTLES 17000,PIECE,1,17000,14407,2593,17000,April
769,BOTTLES 15000,PIECE,1,15000,12712,2288,15000,April
776,BOTTLES 7000,PIECE,1,7000,5932,1068,7000,April
781,BOUNTY CHOCOLATE,PIECE,1,4000,3390,610,4000,April
815,BRITANIA ASSORTED 1KG,PIECE,1,20000,16949,3051,20000,April
822,BRITANIA GINGER 1KG,PIECE,1,20000,16949,3051,20000,April
846,BROOKSIDE PEAR CARAMEL 250G,PIECE,1,3000,2542,458,3000,April
851,BROOMS 1000,PIECE,1,1000,847,153,1000,April
862,BUCKET 11000,PIECE,1,11000,9322,1678,11000,April
866,BUCKET 7000,PIECE,1,7000,5932,1068,7000,April
875,BUCKETS ELITE 6000,PIECE,1,6000,5085,915,6000,April
887,BUILDING BLOCKS 35000 BARBIE PRINCESS,PIECE,1,35000,29661,5339,35000,April
937,CADBURY DAIRY MILK FRUIT&NUT 150G,PIECE,1,13000,11017,1983,13000,April
965,CAKE TOPPER 5000,PIECE,1,5000,4237,763,5000,April
966,CAKE WRAPPER 1000,PIECE,1,1000,847,153,1000,April
981,CAMERA NIPPLES L,PIECE,1,1500,1271,229,1500,April
1016,CAR TOYS 7000,PIECE,1,7000,5932,1068,7000,April
1022,CARO LIGHT OIL 50ML,PIECE,1,4500,3814,686,4500,April
1038,CASIO 401/991MS CALCULATOR,PIECE,1,45000,38136,6864,45000,April
1044,CB BUTTERSCOTCH 1LTR,PIECE,1,24000,20339,3661,24000,April
1059,CELOTAPE BIGGER 1OOOO,PIECE,1,10000,8475,1525,10000,April
1063,CELOTAPE MEDIUM,PIECE,1,5000,4237,763,5000,April
1067,CERELAC 6MONTHS,PIECE,1,27000,22881,4119,27000,April
1097,CHAPA NYOTA BROWN 600G,PIECE,1,4000,3390,610,4000,April
1128,CHILDREN'S UNDERWEAR 20000,PIECE,1,20000,16949,3051,20000,April
1163,CLAIRMEN CREAM 120ML,PIECE,1,7000,5932,1068,7000,April
1172,CLASSIC SHORTHAND NOTEBOOK,PIECE,1,2000,1695,305,2000,April
1186,CLERE BABY JELLY 100G,PIECE,1,3000,2542,458,3000,April
1191,CLERE MEN ICE 100G,PIECE,1,2000,1695,305,2000,April
1193,CLERE PETROLEUM JELLY 250G,PIECE,1,6000,5085,915,6000,April
1195,CLIMAX BERRIES 170G,PIECE,1,6000,5085,915,6000,April
1197,CLIMAX CITRUS FRUITS 170G,PIECE,1,6000,5085,915,6000,April
1213,CLOSEUP TRIPPLE FRESH 125G,PIECE,1,5000,4237,763,5000,April
1215,CLUB DE NUIT MAN SPLASH,PIECE,1,14000,11864,2136,14000,April
1299,CONTAINER WITH BOTTLE 20000,PIECE,1,20000,16949,3051,20000,April
1349,COWBOY 500G,PIECE,1,7500,6356,1144,7500,April
1363,CROWN PERFUME LOVELY,PIECE,1,12000,10169,1831,12000,April
1372,CUP GIFT 17000,PIECE,1,17000,14407,2593,17000,April
1392,CUSSONS BABY OIL BLUE 200MLS,PIECE,1,16000,13559,2441,16000,April
1393,CUSSONS BABY OIL PINK 200MLS,PIECE,1,16000,13559,2441,16000,April
1411,CUTE GIRL DOLL 10K,PIECE,1,10000,8475,1525,10000,April
1426,D.L MAXIMO BISCOTTI 175ML,PIECE,1,4000,3390,610,4000,April
1433,D.L NEOPOLITAN 500MLS,PIECE,1,9500,8051,1449,9500,April
1434,D.L PINACOLANDA 500ML,PIECE,1,10000,8475,1525,10000,April
1446,D.L VAN-STRAW 1LTR,PIECE,1,18000,15254,2746,18000,April
1472,DAITY DARK'N'DARK ICE CREAM,PIECE,1,5000,4237,763,5000,April
1475,DAITY STRAWBERRY VAN,PIECE,1,5500,4661,839,5500,April
1498,DEAR BODY SUMMER FRESHES,PIECE,1,16000,13559,2441,16000,April
1501,DEAR BODY TUESDAY BODY MIST,PIECE,1,16000,13559,2441,16000,April
1539,DETTOL 125MLS,PIECE,1,9000,7627,1373,9000,April
1548,DETTOL FRESH 90G,PIECE,1,4500,3814,686,4500,April
1553,DETTOL LIQUID 250 MLS,PIECE,1,15000,12712,2288,15000,April
1554,DETTOL LIQUID 500ML,PIECE,1,23000,19492,3508,23000,April
1595,DISPOSABLE FORKS 2500,PIECE,1,4000,3390,610,4000,April
1634,DOLBY SPRAY,PIECE,1,12000,10169,1831,12000,April
1641,DOLL 25000,PIECE,1,25000,21186,3814,25000,April
1652,DOLLS 12000,PIECE,1,12000,10169,1831,12000,April
1654,"DOLLS 30000 DAN,FROZN FROST",PIECE,1,30000,25424,4576,30000,April
1656,DOLLS BABY 35000,PIECE,1,35000,29661,5339,35000,April
1666,DOMS COLOUR PENCILS LONG,PIECE,1,7000,5932,1068,7000,April
1667,DOMS COLOUR PENCILS SHORT,PIECE,1,4000,3390,610,4000,April
1687,DOUBLE A REAM,PIECE,1,29000,24576,4424,29000,April
1722,DOVE PINK 100G,PIECE,1,4000,3390,610,4000,April
1723,DOVE PINK ROSA SOAP 135G,PIECE,1,6000,5085,915,6000,April
1751,DOWNY FEEL LUXURIOUS 280ML,PIECE,1,11000,9322,1678,11000,April
1754,DOWNY VALLEY DEW 300ML,PIECE,1,11000,9322,1678,11000,April
1755,DP LED LIGHT TORCH 9029C,PIECE,1,25000,21186,3814,25000,April
1779,DURU FRESH SENSATION 4PCS,PIECE,1,16000,13559,2441,16000,April
1783,DURU MISKET 4PCS,PIECE,1,16000,13559,2441,16000,April
1784,DURU MOUNTAINAIR SOAP,PIECE,1,14000,11864,2136,14000,April
1788,DURU OCEAN BREEZE SOAP,PIECE,1,14000,11864,2136,14000,April
1823,ECLAIRS,PIECE,1,200,169,31,200,April
1833,ED PINK PEA SPLASH,PIECE,1,16000,13559,2441,16000,April
1836,EDEN APRICOT SCRUB 227G,PIECE,1,15000,12712,2288,15000,April
1837,EDEN APRICOT SCRUB 454G,PIECE,1,22000,18644,3356,22000,April
1861,ELEGANCE COCOA BUTTER,PIECE,1,6000,5085,915,6000,April
1890,ELGON BLEND 250G,PIECE,1,14000,11864,2136,14000,April
1891,ELGON BLEND COFFEE 100G,PIECE,1,7000,5932,1068,7000,April
1913,EPIDERM CREME 15G,PIECE,1,2500,2119,381,2500,April
1932,EVERVESS 500ML,PIECE,1,1500,1271,229,1500,April
1934,EXCEL GLUCOSE 250G,PIECE,1,6500,5508,992,6500,April
1974,FA CARRIEAN LEMON,PIECE,1,6500,5508,992,6500,April
1983,FA MEN ATTRACTION FORCE,PIECE,1,6500,5508,992,6500,April
1987,FA MYSTIC MOMENTS,PIECE,1,6500,5508,992,6500,April
1992,FA SPORT RECHARGE 72H,PIECE,1,6000,5085,915,6000,April
1993,FA SPORT ROLLON 50 ML,PIECE,1,6500,5508,992,6500,April
1995,FA WHITENING & CARE,PIECE,1,6500,5508,992,6500,April
2042,FAX FRUIT COCKTAIL,PIECE,1,8000,6780,1220,8000,April
2093,FIDODIDO VANILLA 500ML,PIECE,1,5000,4237,763,5000,April
2106,FLASKS 3.2LTRS 35000,PIECE,1,35000,29661,5339,35000,April
2112,FLOWERS 1500,PIECE,1,1500,1271,229,1500,April
2118,FOGG ABSOLUTE ROLLON,PIECE,1,8500,7203,1297,8500,April
2120,FOGG BOLD ROLLON 50MLS,PIECE,1,8500,7203,1297,8500,April
2123,FOGG ELEGANCE ROLLON,PIECE,1,8500,7203,1297,8500,April
2136,FOGG ROYAL SPRAY,PIECE,1,18000,15254,2746,18000,April
2137,FOGG SPLENDID ROLLON,PIECE,1,8500,7203,1297,8500,April
2152,FOOD COLOUR EGG YELLOW,PIECE,1,1000,847,153,1000,April
2155,FOOD COLOUR PINK,PIECE,1,1000,847,153,1000,April
2160,FOOD JAR 1.2LTR LUNCH BOX,PIECE,1,28000,23729,4271,28000,April
2184,FOUNTAIN PENS 2000,PIECE,1,2000,1695,305,2000,April
2186,FRACK BOWL CLEANER,PIECE,1,5000,4237,763,5000,April
2201,FRESH DAIRY FINO BOX 25000,BOX,1,25000,21186,3814,25000,April
2276,GARDEN FRESH 50G,PIECE,1,2000,1695,305,2000,April
2277,GARDEN FRESH TEA 100G,PIECE,1,4000,3390,610,4000,April
2283,GARDEN TEA 50G,PIECE,1,2500,2119,381,2500,April
2294,GEISHA MORINGA OIL 125G,PIECE,1,4000,3390,610,4000,April
2307,GENIUS SHORTHAND BOOK,PIECE,1,2000,1695,305,2000,April
2316,GIFT BAG BIG 4500,PIECE,1,4500,3814,686,4500,April
2372,GLOW BODY MILK 250G,PIECE,1,5000,4237,763,5000,April
2393,GOLDEN CLING FILM 25000,PIECE,1,25000,21186,3814,25000,April
2459,GROSWIWI FEEDING BOTTLE 30000,PIECE,1,35000,29661,5339,35000,April
2461,GUINEA SHOE CREME BROWN,PIECE,1,3500,2966,534,3500,April
2474,GUN TOYS 8000,PIECE,1,8000,6780,1220,8000,April
2489,HAND SCRUBBING BRUSH 2000,PIECE,1,2000,1695,305,2000,April
2495,HANKIE 1000,PIECE,1,1000,847,153,1000,April
2501,HANYAN EAR BUDS,PIECE,1,2000,1695,305,2000,April
2516,HARPIC MARINE,PIECE,1,15000,12712,2288,15000,April
2520,HARPIC POWER PLUS 500ML,PIECE,1,15000,12712,2288,15000,April
2528,HEINZ BAKED BEANS 415G,PIECE,1,8000,6780,1220,8000,April
2550,HIGHLAND TEA BAGS 50PCS,PIECE,1,5000,4237,763,5000,April
2587,HOOKS HANGERS 8000,PIECE,1,8000,6780,1220,8000,April
2591,HORSE STAMP PAD BLUE NO-2,PIECE,1,2500,2119,381,2500,April
2595,HOT FRESH 20ML,PIECE,1,2500,2119,381,2500,April
2623,HUGGIES S.4 H.C,PIECE,1,45000,38136,6864,45000,April
2628,HUGGIES WIPES NATURAL CARE,PIECE,1,9000,7627,1373,9000,April
2674,INDOCAFE 100G,PIECE,1,17000,14407,2593,17000,April
2710,JAGO AFTERSHAVE 300MLS,PIECE,1,7500,6356,1144,7500,April
2723,JAMIES CAKES @30k,PIECE,1,35000,29661,5339,35000,April
2738,JAMIES HALF CAKES,PIECE,1,1000,847,153,1000,April
2776,JERRYCAN 20LTR 9000,PIECE,1,10000,8475,1525,10000,April
2780,JESA CHOCOLATE FLAVOURED MILK 200ML,PIECE,1,1500,1271,229,1500,April
2783,JESA FLAVOURED MILK BOX,BOX,1,30000,25424,4576,30000,April
2786,JESA FRUIT PEACH&PASSION 175,PIECE,1,2500,2119,381,2500,April
2791,JESA LONGLIFE UHT BOX,BOX,1,38000,32203,5797,38000,April
2820,JIAAI BOTTLE B901-3,PIECE,1,7500,6356,1144,7500,April
2833,JIK REGULAR 750MLS,PIECE,1,14000,11864,2136,14000,April
2856,JOHN WEST SARDINES,PIECE,1,11000,9322,1678,11000,April
2924,JUNSHENG COTTON SWABS,PIECE,1,2000,1695,305,2000,April
2933,KABODY COCONUT MILK 1KG,PIECE,1,6500,5508,992,6500,April
2936,KABODY MILLET SOYA PORRIDGE,PIECE,1,6500,5508,992,6500,April
2937,KABODY MUKENE SOYA RICE1KG,PIECE,1,6000,5085,915,6000,April
2944,KABODY RICE FLOUR 1KG,PIECE,1,6500,5508,992,6500,April
2946,KABODY SOYA RICE 1KG,PIECE,1,6500,5508,992,6500,April
2970,KAPA GLYCERINE 50ML,PIECE,1,2000,1695,305,2000,April
2992,KELLOGS CORNFLAKES 500g,PIECE,1,27000,22881,4119,27000,April
3051,KEY HOLDERS 3500,PIECE,1,3500,2966,534,3500,April
3054,KIBIMBA RICE IKG,PIECE,1,8000,6780,1220,8000,April
3082,KIDS SOCKS 5000,PIECE,1,5000,4237,763,5000,April
3126,KITCHEN SET TOYS,PIECE,1,20000,16949,3051,20000,April
3128,KITCHEN TOWELS,PIECE,1,4000,3390,610,4000,April
3136,KIWI DARK TAN 25ML,PIECE,1,2500,2119,381,2500,April
3149,KNICKERS 1500,PIECE,1,1500,1271,229,1500,April
3153,KNICKERS 4000,PIECE,1,4000,3390,610,4000,April
3154,KNICKERS 5000,PIECE,1,5000,4237,763,5000,April
3155,KNICKERS 6000,PIECE,1,6000,5085,915,6000,April
3158,KNICKERS 9000,PIECE,1,9000,7627,1373,9000,April
3159,KNIFE 3000,PIECE,1,3000,2542,458,3000,April
3205,KOOKSY VANILLA MANGO 250ML,PIECE,1,3500,2966,534,3500,April
3233,KYOGERO BETTER BODY OIL 1OOML,PIECE,1,7000,5932,1068,7000,April
3246,LA BELLE JELLY 250G,PIECE,1,6000,5085,915,6000,April
3260,LABELLE HAIR FOOD 150G,PIECE,1,5000,4237,763,5000,April
3277,LANZO COCONUT SHEA SOAP,PIECE,1,3500,2966,534,3500,April
3362,LEMON CLEAR 125G,PIECE,1,7000,5932,1068,7000,April
3406,LORD CROWN PERFUME,PIECE,1,10000,8475,1525,10000,April
3434,LUCOZADE 250ML,PIECE,1,3000,2542,458,3000,April
3449,LUSHANJIU DIET TEA,PIECE,1,16000,13559,2441,16000,April
3470,M&G GLUE STICK 2500,PIECE,1,2500,2119,381,2500,April
3524,MACDO TOMATO SAUCE 5LTR,PIECE,1,10000,8475,1525,10000,April
3546,MAGANJO POSHO 5KG,PIECE,1,20000,16949,3051,20000,April
3549,MAGANJO PURE MILLET 2KG,PIECE,1,12000,10169,1831,12000,April
3586,MANAGEMENT FILE 2000,PIECE,1,2000,1695,305,2000,April
3588,MANILA PAPERS 1000,PIECE,1,1000,847,153,1000,April
3622,CAR TOY 15000,PIECE,1,15000,12712,2288,15000,April
3623,MAXI LIGHT CREAM 325,PIECE,1,12000,10169,1831,12000,April
3628,MAYONNAISE MEDIUM 473ML,PIECE,1,25000,21186,3814,25000,April
3654,MELEX SIMSIM 85G 1000,PIECE,1,1000,847,153,1000,April
3669,MEN SOCKS 3500,PIECE,1,3500,2966,534,3500,April
3671,MENTHO PLUS,PIECE,1,2000,1695,305,2000,April
3709,MILO 100G,PIECE,1,11000,9322,1678,11000,April
3814,MOPPERS 17000,PIECE,1,17000,14407,2593,17000,April
3841,MORTEIN LEMON 300ML,PIECE,1,22000,18644,3356,22000,April
3858,MOTHERS PRIDE MILK BREAD 1KG,PIECE,1,5500,4661,839,5500,April
3893,MOVIT FAMILY SOAP LEMON V.P,PIECE,1,7000,5932,1068,7000,April
3913,MOVIT JELLY 200G,PIECE,1,5000,4237,763,5000,April
3940,MUGIMU HERBAL,PIECE,1,4000,3390,610,4000,April
3947,MUKWANO BASIN 6000,PIECE,1,6000,5085,915,6000,April
3954,MUKWANO OIL 1LTR JERRYCAN,PIECE,1,10000,8475,1525,10000,April
3994,NACET 500 PCS,PIECE,1,500,424,76,500,April
4000,NAN OPTIPRO 1 400G,PIECE,1,62000,52542,9458,62000,April
4023,NATARAJ PENCILS 6000,PIECE,1,6000,5085,915,6000,April
4027,NATARAJ SETS,PIECE,1,10000,8475,1525,10000,April
4039,NEEM BODYMILK CREAM 250G,PIECE,1,5000,4237,763,5000,April
4047,NESCAFE CLASSIC SACHETS 1.6G,PIECE,1,500,424,76,500,April
4052,NEVIA PEARL&BEAUTY ROLLON,PIECE,1,11000,9322,1678,11000,April
4053,NEW FASHION RUBBER BANDS,PIECE,1,1000,847,153,1000,April
4054,NEW FASHION RUBBER BANDS 1500,PIECE,1,1500,1271,229,1500,April
4056,NEWFARM BANANA JUICE 500ML,PIECE,1,3500,2966,534,3500,April
4141,NIVEA DEEP AMAZONIA,PIECE,1,11000,9322,1678,11000,April
4148,NIVEA FRESH NATURAL ROLLON,PIECE,1,11000,9322,1678,11000,April
4176,NIVEA PEARL&BEAUTY 150ML,PIECE,1,16000,13559,2441,16000,April
4195,NOTE BOOK 2000,PIECE,1,2000,1695,305,2000,April
4196,NOTE BOOK 3000,PIECE,1,3000,2542,458,3000,April
4202,NOTE BOOK SPIRAL 9000,PIECE,1,9000,7627,1373,9000,April
4214,NTALE 100G,PIECE,1,4500,3814,686,4500,April
4220,NUMA KARO 1KG,PIECE,1,6500,5508,992,6500,April
4226,NUMA SUPER RICE 1KG,PIECE,1,8500,7203,1297,8500,April
4228,NUMA SUPER RICE 5KG,PIECE,1,41000,34746,6254,41000,April
4249,NUTRO VANILLA FLAVOURED,PIECE,1,6500,5508,992,6500,April
4295,OFFICE GLUE 90G,PIECE,1,2000,1695,305,2000,April
4312,OLD SPICE PURE SPORT63G,PIECE,1,20000,16949,3051,20000,April
4328,OLIVE OIL ORS SPRAY 472ML,PIECE,1,15000,12712,2288,15000,April
4335,OMO BLEACH COLOUR SAFE 700ML.,PIECE,1,9000,7627,1373,9000,April
4336,OMO BLEACH LEMON,PIECE,1,8000,6780,1220,8000,April
4337,OMO BLEACH MULTI -PURPOSE,PIECE,1,4000,3390,610,4000,April
4340,OMO BLEACH REGULAR 250ML,PIECE,1,3500,2966,534,3500,April
4345,OMO FAST ACTION 3.5KG,PIECE,1,40000,33898,6102,40000,April
4365,ORCHID VALLEY APPLE 1LTR,PIECE,1,7500,6356,1144,7500,April
4383,ORGANIC COCOABUTTER&SHEA BUTTER,PIECE,1,22000,18644,3356,22000,April
4392,ORGANIC HONEY 250G 7000,PIECE,1,7000,5932,1068,7000,April
4459,PAMPER S.6 JUMBO 48DIAP,PIECE,1,73000,61864,11136,73000,April
4477,PANT PEG QIYUSHI 22000,PIECE,1,25000,21186,3814,25000,April
4484,PAPERLINE EXERCISE BK,PIECE,1,4000,3390,610,4000,April
4493,PARADISE ISLAND BODY SPLASH,PIECE,1,15000,12712,2288,15000,April
4500,PASSION WOODY OUD,PIECE,1,17000,14407,2593,17000,April
4514,PELICAN INK,PIECE,1,7500,6356,1144,7500,April
4515,PELIKAN COLOR PENCILS,PIECE,1,8000,6780,1220,8000,April
4525,PENCIL PIECES,PIECE,1,200,169,31,200,April
4552,PERMANENT MAKER,PIECE,1,1000,847,153,1000,April
4554,PETANG TOMATO SAUCE 700G,PIECE,1,7500,6356,1144,7500,April
4578,PICFARE 2 QUIRE,PIECE,1,5000,4237,763,5000,April
4579,PICFARE 288PAGES 8500,PIECE,1,8000,6780,1220,8000,April
4580,PICFARE 4 QUIRE 10000,PIECE,1,10000,8475,1525,10000,April
4591,PICFARE RULED PAPER SMALL,PIECE,1,11000,9322,1678,11000,April
4593,PICFARE SQUARE BKS 96PGS,PIECE,1,1500,1271,229,1500,April
4622,PLASTIC FOOD WRAP,PIECE,1,6500,5508,992,6500,April
4659,POLICE FAMOUS CAR,PIECE,1,12000,10169,1831,12000,April
4665,POPPER 4500,PIECE,1,4500,3814,686,4500,April
4676,POTATO BOTTLE BRUSH,PIECE,1,8000,6780,1220,8000,April
4701,PRADIP CHOCOLATE ESSENCE,PIECE,1,5500,4661,839,5500,April
4716,PRESTIGE 1KG,PIECE,1,14000,11864,2136,14000,April
4722,PRIDE DISH WASHING PASTE LIME 400G,PIECE,1,10000,8475,1525,10000,April
4733,PRINCESS ULTRA THIN,PIECE,1,3000,2542,458,3000,April
4735,PRINGLES BBQ 40G,PIECE,1,5500,4661,839,5500,April
4740,PRINGLES KETCHUP 165G,PIECE,1,11000,9322,1678,11000,April
4764,PROCTOR&ALLAN CORNFLAKES 250G,PIECE,1,14000,11864,2136,14000,April
4767,PROTEX CLASSIC 150G,PIECE,1,6500,5508,992,6500,April
4787,PUCELLE FOR MY HEART,PIECE,1,7500,6356,1144,7500,April
4795,PUCELLE SPARKLING LOVE 75ML,PIECE,1,5000,4237,763,5000,April
4796,PUCELLE SWEET FANTACY 75ML,PIECE,1,5000,4237,763,5000,April
4840,RADIANT HAIR VITALIZER 100G,PIECE,1,5000,4237,763,5000,April
4843,RADIANT OLIVE OIL SPRAY 250MLS,PIECE,1,11000,9322,1678,11000,April
4850,RAHA COCOA 200G,PIECE,1,14000,11864,2136,14000,April
4852,RAHA DRINKING CHOCOLATE 200G,PIECE,1,10000,8475,1525,10000,April
4890,RECEIPT BOOKS NORMAL,PIECE,1,3000,2542,458,3000,April
4901,REDCOCK RICE 5KG,PIECE,1,60000,50847,9153,60000,April
4903,RELAX TP,PIECE,1,1500,1271,229,1500,April
4913,REVLON NATURAL HONEY600ML,PIECE,1,17000,14407,2593,17000,April
4955,RIHAM DIGESTIVE TIN,PIECE,1,18000,15254,2746,18000,April
4958,RIHAM GINGER TIN,PIECE,1,18000,15254,2746,18000,April
4976,RIOLA LUNCH BOX,PIECE,1,6000,5085,915,6000,April
5013,ROYAL POUR HOMME BLACK,PIECE,1,12000,10169,1831,12000,April
5018,ROYCO BEEF 500G,PIECE,1,12000,10169,1831,12000,April
5059,SAF-INSTANT YEAST 500G,PIECE,1,16000,13559,2441,16000,April
5072,SALT SHAKERS 4000,PIECE,1,4000,3390,610,4000,April
5073,SAMONA EGG YELLOW SHAMPO1LTR,PIECE,1,6000,5085,915,6000,April
5077,SAMONA HERBAL JELLY 100G,PIECE,1,4000,3390,610,4000,April
5087,SANDALS 6000,PIECE,1,6000,5085,915,6000,April
5150,SAVANNAH ORANGE 5LTRS,PIECE,1,33000,27966,5034,33000,April
5255,SHAKERS 4000,PIECE,1,4000,3390,610,4000,April
5274,SHENKE ORANGE,PIECE,1,8000,6780,1220,8000,April
5275,SHENKE REPELLANT ORDOLESS,PIECE,1,8000,6780,1220,8000,April
5282,SHIVA HONEY 400G,PIECE,1,13000,11017,1983,13000,April
5284,SHIVA HONEY 80G,PIECE,1,4000,3390,610,4000,April
5292,SHOE BRUSHES 3500,PIECE,1,3500,2966,534,3500,April
5308,SHOWER TOSHOWER FRESH MORNING,PIECE,1,6000,5085,915,6000,April
5315,SHOWERTOSHOWER FRESH POWDER,PIECE,1,6000,5085,915,6000,April
5318,SHREEJI A4 200PAGES,PIECE,1,2500,2119,381,2500,April
5323,SHREEJI GRAPH BOOK 48PGSS,PIECE,1,1500,1271,229,1500,April
5361,SIMBA MBILI 200G,PIECE,1,9500,8051,1449,9500,April
5363,SIMBA MBILI 50G,PIECE,1,5500,4661,839,5500,April
5394,SKALA PAPAYA CREAM 200G,PIECE,1,4000,3390,610,4000,April
5395,SKALA PAPAYA LOTION,PIECE,1,6000,5085,915,6000,April
5402,SKIN CARE 250G,PIECE,1,6500,5508,992,6500,April
5425,SKINDOCTOR HERBAL 120G,PIECE,1,3500,2966,534,3500,April
5483,SNOWMAN MAKERS,PIECE,1,1000,847,153,1000,April
5514,SOFT BROOM 10000,PIECE,1,10000,8475,1525,10000,April
5515,SOFT BROOM 15000,PIECE,1,15000,12712,2288,15000,April
5528,SOFTCARE BABY PANTS M44,PIECE,1,27000,22881,4119,27000,April
5531,SOFTCARE M42 GOLD,PIECE,1,25000,21186,3814,25000,April
5559,SOSOFT FRESH 750ML,PIECE,1,11000,9322,1678,11000,April
5589,SPIRAL NOTE BOOK 70S,PIECE,1,4500,3814,686,4500,April
5619,SPOONS 5000,PIECE,1,5000,4237,763,5000,April
5630,SQUEEZERS 5000,PIECE,1,5000,4237,763,5000,April
5651,STAR COFFEE 50G,PIECE,1,9000,7627,1373,9000,April
5656,STA-SOFT LAVENDER 750ML,PIECE,1,12000,10169,1831,12000,April
5658,STA-SOFT SPRING FRESH 750MLS,PIECE,1,12000,10169,1831,12000,April
5725,SULFO GLYCERINE PINK,PIECE,1,2000,1695,305,2000,April
5770,SUN SIP COCOPINE 5LTR,PIECE,1,24000,20339,3661,24000,April
5774,SUN SIP PASSION 5LTRS,PIECE,1,24000,20339,3661,24000,April
5782,SUNLIGHT DISHWASJING STRAWBERRY 400ML,PIECE,1,6500,5508,992,6500,April
5814,SUNSIP APPLE 5LTR,PIECE,1,24000,20339,3661,24000,April
5817,SUN-SIP COCOPINE 3LTR,PIECE,1,16000,13559,2441,16000,April
5822,SUNSIP STRAWBERRY 3LTR,PIECE,1,16000,13559,2441,16000,April
5867,SWEET.O GOAT MILK SHOWER GEL,PIECE,1,18000,15254,2746,18000,April
5891,SWEETY FITPANTZ LC L8,PIECE,1,9000,7627,1373,9000,April
5913,SWT-PB PAKISTAN 5KG BLUE,PIECE,1,43000,36441,6559,43000,April
5994,TENNIS BALLS 3PCS,PIECE,1,10000,8475,1525,10000,April
6011,TIGER HEAD AA,PIECE,1,1000,847,153,1000,April
6041,TOCEBA AAA,PIECE,1,700,593,107,700,April
6047,TOILET BRUSH 6000,PIECE,1,6000,5085,915,6000,April
6050,TOILET BRUSHES 12000,PIECE,1,12000,10169,1831,12000,April
6053,TOILET PUMPS,PIECE,1,7000,5932,1068,7000,April
6139,TOTO'S VESTLINE JELLY 500G,PIECE,1,10000,8475,1525,10000,April
6153,TOY MODEL REMOTE CAR 55000,PIECE,1,55000,46610,8390,55000,April
6201,TROPICAL HEAT GINGER 100G,PIECE,1,7000,5932,1068,7000,April
6203,TROPICAL HEAT MEAT TENDERISER50G,PIECE,1,4000,3390,610,4000,April
6214,TROPICAL HEAT ROSEMARYLEANES,PIECE,1,3500,2966,534,3500,April
6215,TROPICAL HEAT TEA MASALA 100G,PIECE,1,10000,8475,1525,10000,April
6217,TROPICAL HEAT TURMERIC 100G,PIECE,1,7000,5932,1068,7000,April
6219,TROPICAL HEAT WHITE PEPPER 50G,PIECE,1,8000,6780,1220,8000,April
6225,TROPIKAL SPICE ISLE A.F,PIECE,1,12000,10169,1831,12000,April
6239,TRUCK TOYS 12000,PIECE,1,12000,10169,1831,12000,April
6240,TRUCK TOYS 20000,PIECE,1,20000,16949,3051,20000,April
6292,UGACHICK FAMILY PACK 2KG,PIECE,1,42000,35593,6407,42000,April
6293,UGACHICK GIZZARDS 500G,PIECE,1,13000,11017,1983,13000,April
6298,UGACHICK STARDARD 1.2KG,PIECE,1,27000,22881,4119,27000,April
6299,UGACHICK SUPA 1KG,PIECE,1,22000,18644,3356,22000,April
6314,ULTRASONIC PEST REPELLER,PIECE,1,15000,12712,2288,15000,April
6317,UMBRELLAS 20000 POCKET,PIECE,1,20000,16949,3051,20000,April
6345,UTESIL SPONGE 1500,PIECE,1,1500,1271,229,1500,April
6347,UTESIL WASHER 3000,PIECE,1,3000,2542,458,3000,April
6398,VASELINE ALOESOOTHE LOTION 400ML,PIECE,1,14500,12288,2212,14500,April
6407,VASELINE COCOA GLOW 200ML,PIECE,1,8000,6780,1220,8000,April
6413,VASELINE DRY SKIN REPAIR LOTION 400ML,PIECE,1,15000,12712,2288,15000,April
6458,VICTAN SINGLE VEST,PIECE,1,5000,4237,763,5000,April
6470,VIM LEMON 1KG,PIECE,1,8000,6780,1220,8000,April
6496,WANDAZ PETROLEUM JELLY 250G,PIECE,1,6000,5085,915,6000,April
6497,WANDAZ PETROLEUM JELLY 500G,PIECE,1,11500,9746,1754,11500,April
6557,WELLICE SHOWER GEL OLIVE OIL 1LTR,PIECE,1,23000,19492,3508,23000,April
6558,WELLICE SHOWER GEL PAPAYAV,PIECE,1,23000,19492,3508,23000,April
6620,YARRISON VESTS 3PCS 27000,PIECE,1,27000,22881,4119,27000,April
6650,YOUR CHOICE SAUSAGE 1KG,PIECE,1,30000,25424,4576,30000,April
6666,ZESTA 500G,PIECE,1,10500,8898,1602,10500,April
6698,SOFINE GENLESE ROSE NOURISH 1L,PIECE,1,20000,16949,3051,20000,April
6793,LIVER 4000,PIECE,1,4000,3390,610,4000,April
6832,RANDA CROWN PERFUME,PIECE,1,12000,10169,1831,12000,April
6960,NAN GUEST BATHING SOAP,PIECE,1,4000,3390,610,4000,April
6965,AEROPLANE TOYS 12000,PIECE,1,12000,10169,1831,12000,April
6983,STRIKE COCONUT CHOCOLATE BAR,PIECE,1,1000,847,153,1000,April
6994,COLOUR PENCILS 3000,PIECE,1,3000,2542,458,3000,April
6995,DOMS WAX CRAYONS ,PIECE,1,2500,2119,381,2500,April
6996,NATARAJ WAX CRAYONS 2500,PIECE,1,2500,2119,381,2500,April
6997,PELIKAN HB PENCILS 12PCS,PIECE,1,6000,5085,915,6000,April
7002,M&G OFFICE SCISSORS 190MM,PIECE,1,6500,5508,992,6500,April
7003,M&G OFFICE SCISSORS 170MM,PIECE,1,4000,3390,610,4000,April
7009,VENUS VITAMIN E 200ML LOTION,PIECE,1,6000,5085,915,6000,April
7017,PRIVE EYE CANDY SPRAY,PIECE,1,11000,9322,1678,11000,April
7021,RIGGS LONDON POWER ,PIECE,1,16000,13559,2441,16000,April
7096,FRESH BITE TOMATO KETCHUP 1OOPCS,PIECE,1,12000,10169,1831,12000,April
7102,JAMIES DADDIES TIN 20000,PIECE,1,20000,16949,3051,20000,April
7110,SHOWER TO SHOWER MEN ,PIECE,1,6000,5085,915,6000,April
7115,CLAIRMEN CREAM 300ML,PIECE,1,14000,11864,2136,14000,April
7134,HUGGIES PANTS DRY COMFORT S.4,PIECE,1,32000,27119,4881,32000,April
7140,SUMZ CORN CRAX 350G,PIECE,1,5000,4237,763,5000,April
7153,INNOCENCE BODY SPRAY ,PIECE,1,12000,10169,1831,12000,April
7175,JAMIES LIQUID SOAP 3LTR,PIECE,1,3000,2542,458,3000,April
7216,CHICKEN BURGER 20000,PIECE,1,20000,16949,3051,20000,April
7254,VEGETABLE SAMOSA 3000,PIECE,1,3000,2542,458,3000,April
7280,Mukwano golden tea 250g,PIECE,1,5500,4661,839,5500,April
7289,TRIDENT CHEWING GUM,PIECE,1,6000,5085,915,6000,April
7297,CLERE PETROLEUM JELLY 50G,PIECE,1,2000,1695,305,2000,April
7319,ARMAF ENCHANTED ROMANCE AIR.F,PIECE,1,8000,6780,1220,8000,April
7328,MOSQUITO REPELLENT,PIECE,1,16000,13559,2441,16000,April
7332,SWT-P 5KG,PIECE,1,40000,33898,6102,40000,April
7333,MEN BOXERS,PIECE,1,15000,12712,2288,15000,April
7339,SOFTCARE GOLD S48,PIECE,1,25000,21186,3814,25000,April
7388,HIKMA YELLOW BAGIYA 4000,PIECE,1,4000,3390,610,4000,April
7395,HIKMA HARD CORNS 2500,PIECE,1,2000,1695,305,2000,April
7400,NUTRO DIGESTIVE LIGHT 400G,PIECE,1,13000,11017,1983,13000,April
7411,PAMPERS PANTS 6,PIECE,1,40000,33898,6102,40000,April
7416,DOVE CARING BATH ALMOND CREAM WITH HIBISCUS 500ML,PIECE,1,20000,16949,3051,20000,April
7429,TROPICAL HEAT PAPRIKA SPICE 100G,PIECE,1,6000,5085,915,6000,April
7473,ARTIN MASSAGE OIL OLIVE OIL 1LTR,PIECE,1,13000,11017,1983,13000,April
7476,MENTOS MINT 29G,PIECE,1,2500,2119,381,2500,April
7488,VERSMAN ACTIVE LOTION 400ML,PIECE,1,17000,14407,2593,17000,April
7500,KABODY BABY BODY IMMUNE BOOSTER,PIECE,1,7500,6356,1144,7500,April
7502,ISLAND BREEZE A.F LEMON 350ML,PIECE,1,7000,5932,1068,7000,April
7506,ISLAND BREEZE A.F SANDALWOOD 350ML,PIECE,1,7000,5932,1068,7000,April
7526,DOCTORS KIT DOLL 20000,PIECE,1,19998,16947,3051,19998,April
7527,BALLS 2000,PIECE,1,2000,1695,305,2000,April
7541,MEN SOCKS 5500,PIECE,1,5500,4661,839,5500,April
7543,DOLLS3000,PIECE,1,3000,2542,458,3000,April
7544,DOLLS 5000,PIECE,1,5000,4237,763,5000,April
7577,COSMO GREEN APPLE,PIECE,1,18000,15254,2746,18000,April
7580,COSMO ALOEVERA 100%,PIECE,1,13000,11017,1983,13000,April
7581,GULF ORCHID INTO THE NIGHT,PIECE,1,15000,12712,2288,15000,April
7607,LABELLE BABY JELLY 450G,PIECE,1,10000,8475,1525,10000,April
7619,NICE BISCUITS ,PIECE,1,1500,1271,229,1500,April
7626,NIVEA BLACK& WHITE SPY 150ML,PIECE,1,16000,13559,2441,16000,April
7627,NIVEA MEN FRESH OCEAN 150ML,PIECE,1,16000,13559,2441,16000,April
7628,NIVEA MEN FRESH ACTIVE 150ML,PIECE,1,16000,13559,2441,16000,April
7645,SOFTCARE GOLD XL36,PIECE,1,25000,21186,3814,25000,April
7696,KNIFE 5000,PIECE,1,5000,4237,763,5000,April
7712,REXONA COTTON DRY ROLL 50ML,PIECE,1,10000,8475,1525,10000,April
7713,REXONA INVISIBLE DRY BLACK+ WHITE 50ML,PIECE,1,10000,8475,1525,10000,April
7719,SECRETS PADS ULTRA DAY&NIGHT PINK,PIECE,1,5500,4661,839,5500,April
7732,SUMZ BAKED PEANUT BAR 80G,PIECE,1,2500,2119,381,2500,April
7735,JAMIES MARBLE CAKE @8000,PIECE,1,8500,7203,1297,8500,April
7762,PRINGLES PAPRIKA,PIECE,1,5500,4661,839,5500,April
7765,PRINGLES PAPRIKA 165G,PIECE,1,12000,10169,1831,12000,April
7767,PEPSODENT CHARCOAL WHITE 160G,PIECE,1,11000,9322,1678,11000,April
7768,SOAP DISH 5000,PIECE,1,5000,4237,763,5000,April
7776,SUMZ FRUIT CHUTNEY 60G,PIECE,1,3000,2542,458,3000,April
7781,DOVE RESTORING CARE LOTION 400ML,PIECE,1,20000,16949,3051,20000,April
7786,MEN UNDER WEAR 25000,PIECE,1,25000,21186,3814,25000,April
7787,BROOKSIDE MILK BOX 28000,PIECE,1,28000,23729,4271,28000,April
7793,TOY 6000,PIECE,1,6000,5085,915,6000,April
7798,NISA PAPAYA 200ML 8000,PIECE,1,8000,6780,1220,8000,April
7804,FACE MASK COFFEE 120ML 10000,PIECE,1,10000,8475,1525,10000,April
7823,DOVE REFRESHING 500ML,PIECE,1,22000,18644,3356,22000,April
7838,AMERICAN APPLE CIDER VINEGAR 473ML,PIECE,1,10000,8475,1525,10000,April
7839,RIGGS CHIEF 250ML,PIECE,1,16000,13559,2441,16000,April
7844,DOVE GO FRESH 250ML,PIECE,1,21000,17797,3203,21000,April
7848,HOBBY BLACK BERRY 400ML,PIECE,1,7500,6356,1144,7500,April
7849,ELEGANT LEGEND AF 300ML,PIECE,1,7000,5932,1068,7000,April
7850,ELEGANT LUXURIOUS GOLD,PIECE,1,7000,5932,1068,7000,April
7857,MOOISTE CHOCOLATE,PIECE,1,2500,2119,381,2500,April
7864,ORCHID VALLEY APPLE 250ML,PIECE,1,2000,1695,305,2000,April
6,20LTR JERRICAN,PIECE,2,10000,16949,3051,20000,April
63,AFROCARE PETROLEUM JELLY,PIECE,2,4500,7627,1373,9000,April
84,Always dreamzz,PIECE,2,3500,5932,1068,7000,April
98,AMARA ALOEVERA 400ML,PIECE,2,8500,14407,2593,17000,April
103,AMARA COCOA BUTTER 200ML,PIECE,2,6000,10169,1831,12000,April
105,AMARA COCOA BUTTER LOTION 400ML,PIECE,2,8500,14407,2593,17000,April
116,AMARA RAW SHEA LOTION 400ML,PIECE,2,8500,14407,2593,17000,April
126,AMERICAN GARDEN KETCHUP 340G,PIECE,2,7500,12712,2288,15000,April
184,APPLES RED 1200,PIECE,2,1200,2034,366,2400,April
192,AQUAFRESH 50MLS,PIECE,2,5000,8475,1525,10000,April
213,ARIEL DOWNY LAVENDER500G,PIECE,2,8000,13559,2441,16000,April
215,ARIEL ORIGINAL 1KG,PIECE,2,15500,26271,4729,31000,April
270,ART BOOK BIG,PIECE,2,4000,6780,1220,8000,April
275,ART PENCILS 4B,PIECE,2,1000,1695,305,2000,April
326,AXE BLACK,PIECE,2,13000,22034,3966,26000,April
341,AXION LEMON 400G,PIECE,2,9500,16102,2898,19000,April
343,AXION PASTE LIME,PIECE,2,6000,10169,1831,12000,April
350,B.D BALOON CHART,PIECE,2,4000,6780,1220,8000,April
419,BABY CUPS 8000,PIECE,2,8000,13559,2441,16000,April
427,BABY FEEDING BOTTLE 6000,PIECE,2,6000,10169,1831,12000,April
429,BABY FEEDING BOTTLES 3000,PIECE,2,3000,5085,915,6000,April
444,BABY JUNIOR JELLY 500G,PIECE,2,11000,18644,3356,22000,April
447,BABY JUNIOR100g,PIECE,2,3500,5932,1068,7000,April
497,BABY& ME BABYJELLY 240ML,PIECE,2,5000,8475,1525,10000,April
523,BALLET ACTIVE VITAMIN 120MLS,PIECE,2,5000,8475,1525,10000,April
525,BALLET ALMOMD OIL 125ML,PIECE,2,9500,16102,2898,19000,April
566,BALOONS FULL PACKET,PIECE,2,15000,25424,4576,30000,April
577,BANNERS 7000,PIECE,2,7000,11864,2136,14000,April
627,BEIKU BABY SOOTHERS,PIECE,2,2500,4237,763,5000,April
671,BIRTHDAY HATS 2500,PIECE,2,2500,4237,763,5000,April
714,BLUE BAND 1KG,PIECE,2,19000,32203,5797,38000,April
817,BRITANIA BUTTER 1KG,PIECE,2,20000,33898,6102,40000,April
845,BROOKSIDE PEAR CARAMEL,PIECE,2,5000,8475,1525,10000,April
889,BUL STAR SOAP 600G,PIECE,2,4000,6780,1220,8000,April
944,CADBURY DRINKING CHOCOLATE 125G,PIECE,2,8500,14407,2593,17000,April
945,CADBURY DRINKING CHOCOLATE 450G,PIECE,2,22000,37288,6712,44000,April
1009,CAR TOYS 8000,PIECE,2,8000,13559,2441,16000,April
1037,CASHO CALC,PIECE,2,15000,25424,4576,30000,April
1058,CELOTAPE 2000,PIECE,2,2500,4237,763,5000,April
1060,CELOTAPE BLACK,PIECE,2,1500,2542,458,3000,April
1062,CELOTAPE BROWN SMALL,PIECE,2,3000,5085,915,6000,April
1068,CERELAC 7MONTHS MIXEDFRUITS,PIECE,2,27000,45763,8237,54000,April
1201,CLIMAX FOREST FRUITS 50G,PIECE,2,2000,3390,610,4000,April
1239,COCOPULP CREME 100ML,PIECE,2,7500,12712,2288,15000,April
1264,COLGATE NATURAL EXTRACT 75MLS,PIECE,2,9000,15254,2746,18000,April
1274,COLORES NEW ELITE COLOURS BIG,PIECE,2,2000,3390,610,4000,April
1290,COMPO PENS,PIECE,2,3000,5085,915,6000,April
1306,CONTAINERS 3500,PIECE,2,3500,5932,1068,7000,April
1344,COW & GATE 2,PIECE,2,44000,74576,13424,88000,April
1352,CRANE BOOK PC 1000,PIECE,2,1000,1695,305,2000,April
1384,CUPS STALLION 3000,PIECE,2,3000,5085,915,6000,April
1394,CUSSONS BABY PERFUMED JELLY 200ML,PIECE,2,12000,20339,3661,24000,April
1400,CUSSONS OIL PINK 100MLS,PIECE,2,9000,15254,2746,18000,April
1412,CUTTERS 1000,PIECE,2,1000,1695,305,2000,April
1451,DABUR HERBAL MINT&LEMON,PIECE,2,6500,11017,1983,13000,April
1538,DESSERT NOTE BOOK 4000,PIECE,2,4500,7627,1373,9000,April
1551,DETTOL HERBAL 175G,PIECE,2,6500,11017,1983,13000,April
1559,DETTOL SENSITIVE 175G,PIECE,2,6500,11017,1983,13000,April
1597,DISPOSABLE GLASSES 150ML,PIECE,2,2500,4237,763,5000,April
1640,DOLL 20000,PIECE,2,20000,33898,6102,40000,April
1653,DOLLS 2000,PIECE,2,2000,3390,610,4000,April
1659,DOLLS MOTHER 6000,PIECE,2,6000,10169,1831,12000,April
1662,DOLPHIN MONDI PAPERS,PIECE,2,27000,45763,8237,54000,April
1700,DOVE FRESH TOUCH 100G,PIECE,2,4000,6780,1220,8000,April
1758,DREAM PANT LINERS,PIECE,2,2500,4237,763,5000,April
1759,DRINKING CHOCOLATE 225G,PIECE,2,13000,22034,3966,26000,April
1770,DURACELL AAA,PIECE,2,7000,11864,2136,14000,April
1774,DURU DOLCE ALMOND,PIECE,2,4500,7627,1373,9000,April
1780,DURU GLYCERINE,PIECE,2,5000,8475,1525,10000,April
1786,DURU NATURAL OLIVE 720G,PIECE,2,18000,30508,5492,36000,April
1869,ELEGANT BLACK A.F,PIECE,2,7000,11864,2136,14000,April
1877,ELEGANT JASMINE A.F,PIECE,2,7000,11864,2136,14000,April
1910,ENVELOPES 200,PIECE,2,200,339,61,400,April
2003,FACE TOWELS 3500,PIECE,2,3500,5932,1068,7000,April
2064,FEELINGS SPRAY,PIECE,2,12000,20339,3661,24000,April
2071,FIDODIDO CHOCOLATE 250ML,PIECE,2,4000,6780,1220,8000,April
2073,FIDODIDO CHOCO-VANI 500ML,PIECE,2,5000,8475,1525,10000,April
2088,FIDODIDO STRAW-VANI 500ML,PIECE,2,5000,8475,1525,10000,April
2149,FOOD COLOUR BLACK,PIECE,2,1000,1695,305,2000,April
2169,FORKS 10000 6PCS,PIECE,2,10000,16949,3051,20000,April
2174,FORTUNE BUTTO 1LTR,PIECE,2,8500,14407,2593,17000,April
2176,FORTUNE GOLD 1LTR,PIECE,2,10000,16949,3051,20000,April
2268,GALAXY DISPOSABLE PLATES,PIECE,2,11000,18644,3356,22000,April
2281,GARDEN TEA 250,PIECE,2,14000,23729,4271,28000,April
2284,GARDEN TEA BAGS 100G,PIECE,2,6500,11017,1983,13000,April
2370,GLOVES 10000,PIECE,2,10000,16949,3051,20000,April
2454,GREEN POLYTHENE,PIECE,2,300,508,92,600,April
2479,HACO RULER,PIECE,2,2000,3390,610,4000,April
2594,HOSI PADLOCK 70MM,PIECE,2,40000,67797,12203,80000,April
2603,HP FACIAL WIPES,PIECE,2,3500,5932,1068,7000,April
2651,IMPERIAL LEATHER 4*175,PIECE,2,13000,22034,3966,26000,April
2658,IMPERIAL LEATHER MEN COOL 400L LOTION,PIECE,2,13000,22034,3966,26000,April
2666,IMPERIAL LEATHER SPORT 175G,PIECE,2,4500,7627,1373,9000,April
2673,INDO CAFE 50G,PIECE,2,10000,16949,3051,20000,April
2730,JAMIES CROCKDILE BREAD 1KG,PIECE,2,6000,10169,1831,12000,April
2769,JEE NAIL REMOVER,PIECE,2,1500,2542,458,3000,April
2781,JESA FINO BOX,BOX,2,24000,40678,7322,48000,April
2830,JIK COLOURS 250MLS,PIECE,2,7000,11864,2136,14000,April
2866,JOHNSON EXTRA GENTLE CARE SOAP,PIECE,2,7500,12712,2288,15000,April
2934,KABODY COMPOSITE FLOUR,PIECE,2,6000,10169,1831,12000,April
2941,KABODY PUMPKIN SEED 1KG,PIECE,2,6500,11017,1983,13000,April
2945,KABODY SOYA PORRIDGE,PIECE,2,6000,10169,1831,12000,April
2947,KABODY WHITE OATS WITH RICE,PIECE,2,6000,10169,1831,12000,April
2990,KAZIRE VIT FRUIT,PIECE,2,2000,3390,610,4000,April
2999,KENPOLY LUNCH BOX,PIECE,2,5000,8475,1525,10000,April
3055,KIBINGE COFFEE 100G,PIECE,2,7000,11864,2136,14000,April
3084,KIDS TOOTH BRUSH 5000,PIECE,2,5000,8475,1525,10000,April
3096,KILL IT 150MLS,PIECE,2,11000,18644,3356,22000,April
3143,KIWI SHOE POLISH 32G,PIECE,2,5000,8475,1525,10000,April
3151,KNICKERS 3000,PIECE,2,3000,5085,915,6000,April
3156,KNICKERS 7000,PIECE,2,7000,11864,2136,14000,April
3160,KNIFE 4000 KM7095,PIECE,2,5000,8475,1525,10000,April
3195,KOOKSY VAN-CHOC 500ML,PIECE,2,5000,8475,1525,10000,April
3198,KOOKSY VANILLA 220ML,PIECE,2,2000,3390,610,4000,April
3224,KUAKUA TOILET BLOCKS 6PCS,PIECE,2,10000,16949,3051,20000,April
3229,KUZA INDIAN HEMP 56G,PIECE,2,8000,13559,2441,16000,April
3275,LANZO ANTI-BACTERIAL SOAP,PIECE,2,4500,7627,1373,9000,April
3279,LANZO VANILLA SOAP,PIECE,2,3500,5932,1068,7000,April
3295,LATO MILK 900G,PIECE,2,47000,79661,14339,94000,April
3400,LMZ HERBAL 55G,PIECE,2,3000,5085,915,6000,April
3475,M&G INK CATRIDGE,PIECE,2,4000,6780,1220,8000,April
3478,M&G MATHEMATICAL SET,PIECE,2,5000,8475,1525,10000,April
3596,MANUSCRIPT,PIECE,2,20000,33898,6102,40000,April
3597,MANUSCRIPT 3Q BOOK,PIECE,2,16000,27119,4881,32000,April
3602,MARHABA AMLA OIL 160ML,PIECE,2,12000,20339,3661,24000,April
3618,MASSAGE OLIVE OIL,PIECE,2,15000,25424,4576,30000,April
3626,MAYONNAISE BIG 887ML,PIECE,2,30000,50847,9153,60000,April
3657,MELEX SIMSIM BALLS 500,PIECE,2,500,847,153,1000,April
3672,MENTHOXYL,PIECE,2,500,847,153,1000,April
3683,METALIC MOPPER 18000,PIECE,2,18000,30508,5492,36000,April
3750,MIRRORS 2500,PIECE,2,2500,4237,763,5000,April
3872,MOVIT BABY JELLY 70g,PIECE,2,2000,3390,610,4000,April
3875,MOVIT BABYJELLY 50g,PIECE,2,1500,2542,458,3000,April
3887,MOVIT FAMILY SOAP 230G,PIECE,2,4000,6780,1220,8000,April
3894,MOVIT FAMILY SOAP ROSE 125G,PIECE,2,2500,4237,763,5000,April
3895,MOVIT FAMILY SOAP ROSE 230G,PIECE,2,4000,6780,1220,8000,April
3903,MOVIT HAIR FOOD 70G,PIECE,2,3000,5085,915,6000,April
3906,MOVIT HERBAL JELLY 120G,PIECE,2,3500,5932,1068,7000,April
3907,MOVIT HERBAL JELLY 200G,PIECE,2,6000,10169,1831,12000,April
3909,MOVIT HERBAL JELLY 50G,PIECE,2,1500,2542,458,3000,April
3930,MOVIT SOAP LEMON 120G,PIECE,2,2500,4237,763,5000,April
3939,MR.ZECO SWEETS,PIECE,2,300,508,92,600,April
4019,NASA HAIR REMOVAL LEMON 50ML,PIECE,2,7000,11864,2136,14000,April
4021,NATARAJ COLOR PENCILS,PIECE,2,7500,12712,2288,15000,April
4043,NESCAFE CLASSIC 100G,PIECE,2,17000,28814,5186,34000,April
4044,NESCAFE CLASSIC 200G,PIECE,2,26000,44068,7932,52000,April
4051,NESTLE KITKAT,PIECE,2,3500,5932,1068,7000,April
4100,NIGINA 10000,PIECE,2,10000,16949,3051,20000,April
4119,NISA HAIR REMOVAL CUCUMBER 50ML,PIECE,2,7000,11864,2136,14000,April
4137,NIVEA BLACK&WHITE ROLLON,PIECE,2,11000,18644,3356,22000,April
4142,NIVEA DRY COMFORT ROLLON,PIECE,2,11000,18644,3356,22000,April
4158,NIVEA MEN DEEP ROLLON,PIECE,2,11000,18644,3356,22000,April
4162,NIVEA MEN FRESH ACTIVE 50ML,PIECE,2,11000,18644,3356,22000,April
4192,NOMI BUCKET 500G,PIECE,2,6500,11017,1983,13000,April
4201,NOTE BOOK SPIRAL 10000,PIECE,2,10000,16949,3051,20000,April
4239,NUTRO CREAM WAFERS 3,PIECE,2,6500,11017,1983,13000,April
4244,NUTRO ORANGE WAFFERS 150G,PIECE,2,6500,11017,1983,13000,April
4294,OFFICE GLUE 1KG,PIECE,2,7000,11864,2136,14000,April
4329,OLIVE OIL SPRAY 275ML,PIECE,2,12000,20339,3661,24000,April
4339,OMO BLEACH REGULAR,PIECE,2,8000,13559,2441,16000,April
4368,ORCHID VALLEY MANGO 1LTR6161101061483,PIECE,2,7500,12712,2288,15000,April
4372,ORCHID VALLEY TROPICAL 1LTR,PIECE,2,7500,12712,2288,15000,April
4416,OX FORD SETS 11000,PIECE,2,11000,18644,3356,22000,April
4434,PADLOCK 6000,PIECE,2,6000,10169,1831,12000,April
4442,PAMPER 2 H.C,PIECE,2,40000,67797,12203,80000,April
4445,PAMPER 3 H.C,PIECE,2,40000,67797,12203,80000,April
4446,PAMPER 3 JUMBO,PIECE,2,73000,123729,22271,146000,April
4464,PANASONIC AA,PIECE,2,2000,3390,610,4000,April
4467,PANASONIC C,PIECE,2,3500,5932,1068,7000,April
4470,PANCHAVATI,PIECE,2,3000,5085,915,6000,April
4499,PASSION STRAWBERRY,PIECE,2,16000,27119,4881,32000,April
4511,PEGS 5000,PIECE,2,5000,8475,1525,10000,April
4516,PELIKAN RUBBER,PIECE,2,1000,1695,305,2000,April
4517,PELIKAN RUBBERS 1000,PIECE,2,1000,1695,305,2000,April
4546,PEPTANG KETCHUP 400G,PIECE,2,7500,12712,2288,15000,April
4555,PETTI COT 5000,PIECE,2,5000,8475,1525,10000,April
4571,PIANO TOYS 1000,PIECE,2,10000,16949,3051,20000,April
4583,PICFARE 96PGS,PIECE,2,1000,1695,305,2000,April
4584,PICFARE BRONZE 144PGS,PIECE,2,3500,5932,1068,7000,April
4589,PICFARE PENCILS PIECES 300,PIECE,2,300,508,92,600,April
4705,PRADIP VANILLA CLEAR FLAVOURING,PIECE,2,5000,8475,1525,10000,April
4706,PRADIP VANILLA ESSENCE,PIECE,2,5000,8475,1525,10000,April
4711,PREDATOR ENERGY DRINK,PIECE,2,2000,3390,610,4000,April
4732,PRINCESS ULTRA PADS,PIECE,2,2700,4576,824,5400,April
4734,PRINGLES BARBEQUE 165G,PIECE,2,10000,16949,3051,20000,April
4739,PRINGLES HOT&SPICY 40G,PIECE,2,6000,10169,1831,12000,April
4778,PROTEX HERBAL 90G,PIECE,2,4000,6780,1220,8000,April
4783,PUCELLE BLISSFUL SENSE 75ML,PIECE,2,5000,8475,1525,10000,April
4802,PUFF HOLDERS 1500,PIECE,2,1500,2542,458,3000,April
4805,PUFF HOLDERS 500,PIECE,2,500,847,153,1000,April
4819,PVC CLING FILM 45CM,PIECE,2,18000,30508,5492,36000,April
4911,RETYPE WHITE WASH,PIECE,2,3000,5085,915,6000,April
4934,RIBBONS 2500,PIECE,2,2500,4237,763,5000,April
4935,RIBBONS 7500,PIECE,2,7500,12712,2288,15000,April
4947,RIHAM COLA 320MLS,PIECE,2,1000,1695,305,2000,April
4989,ROKI 5LTRS,PIECE,2,30000,50847,9153,60000,April
4990,ROKI OIL 1LTR,PIECE,2,10000,16949,3051,20000,April
5022,ROYCO CHICKEN 500G,PIECE,2,12000,20339,3661,24000,April
5049,SAFA TOMATO PASTE 400G,PIECE,2,6000,10169,1831,12000,April
5176,SCISSORS 1500,PIECE,2,1500,2542,458,3000,April
5189,SCRUBBING BRUSH LONG 5000,PIECE,2,6000,10169,1831,12000,April
5191,SCRUBBING HAND BRUSH 8000,PIECE,2,8500,14407,2593,17000,April
5270,SHENKE MOSQUITO COIL LOW SMOKE,PIECE,2,6000,10169,1831,12000,April
5291,SHOE BRUSHES 2500,PIECE,2,2500,4237,763,5000,April
5307,SHOWER TO SHOWER SPRING RAIN,PIECE,2,6000,10169,1831,12000,April
5324,SHREEJI GRAPH BOOK 96,PIECE,2,3000,5085,915,6000,April
5387,SKALA ALOEVERA CREAM 200G,PIECE,2,4000,6780,1220,8000,April
5388,SKALA ALOEVERA LOTION 400ML,PIECE,2,6000,10169,1831,12000,April
5389,SKALA CARROT BODY CREAM,PIECE,2,4000,6780,1220,8000,April
5426,SKINDOCTOR HERBAL 60G,PIECE,2,2000,3390,610,4000,April
5434,SKY VIEW FRUTII 320ML,PIECE,2,1000,1695,305,2000,April
5500,SOAP DISH MUKWANO,PIECE,2,3000,5085,915,6000,April
5538,SOFTCARE S48 GOLD,PIECE,2,25000,42373,7627,50000,April
5568,SOY SAUCE LIGHT 150G,PIECE,2,5000,8475,1525,10000,April
5574,SPARKLING CANDLES 8000,PIECE,2,7000,11864,2136,14000,April
5594,SPLASH BOX 42000,BOX,2,45000,76271,13729,90000,April
5624,SPRING FILE 3000,PIECE,2,3000,5085,915,6000,April
5631,SQUEEZERS DOULBLE 10000,PIECE,2,10000,16949,3051,20000,April
5649,STAR COFFEE 250G B. CHOICE,PIECE,2,10000,16949,3051,20000,April
5696,STRAWS 2500,PIECE,2,2500,4237,763,5000,April
5697,STREPSILS ORIGINAL,PIECE,2,1000,1695,305,2000,April
5724,SULFO GLYCERINE COLORLESS,PIECE,2,2000,3390,610,4000,April
5768,SUN L DISH WASHING LIQUID400 ML,PIECE,2,7000,11864,2136,14000,April
5784,SUNLIGHT LAVENDER 1KG,PIECE,2,11000,18644,3356,22000,April
5803,SUNSEED OIL 2LTRS,PIECE,2,21000,35593,6407,42000,April
5804,SUNSEED OIL 3LTRS,PIECE,2,28000,47458,8542,56000,April
5852,SUPREME BAKING FLOUR,PIECE,2,9000,15254,2746,18000,April
5952,TATE LYLE SUGAR 500G,PIECE,2,13000,22034,3966,26000,April
6045,TOILET BLUE BLOCKS 4PCS,PIECE,2,7500,12712,2288,15000,April
6049,TOILET BRUSH TEEPEE10000,PIECE,2,10000,16949,3051,20000,April
6138,TOTOS VESTLINE JELLY 200G,PIECE,2,5000,8475,1525,10000,April
6186,TROPICAL HEAT BLACK PEPPER 100G,PIECE,2,8500,14407,2593,17000,April
6197,TROPICAL HEAT FISH MASALA 100G,PIECE,2,5000,8475,1525,10000,April
6198,TROPICAL HEAT GARAM MASALA 50G,PIECE,2,5000,8475,1525,10000,April
6268,U.S.A BEAUTY SOAP BLACK,PIECE,2,6500,11017,1983,13000,April
6304,UGANDA SAFARI TEA 100G,PIECE,2,3500,5932,1068,7000,April
6385,VANILLA ED PASSION,PIECE,2,16000,27119,4881,32000,April
6397,VASELINE ALOESOOTHE 200ML,PIECE,2,8000,13559,2441,16000,April
6406,VASELINE BLUESEAL ORIGINAL 250ML,PIECE,2,9500,16102,2898,19000,April
6422,VASELINE MEN COOLING JELLY 240ML,PIECE,2,9500,16102,2898,19000,April
6471,VIM LEMON FRESH 500G,PIECE,2,5000,8475,1525,10000,April
6533,WEET CORNFLAKES 750G,PIECE,2,30000,50847,9153,60000,April
6544,WEETABIX CORNFLAKES 500G,PIECE,2,22000,37288,6712,44000,April
6665,ZESTA 300 G,PIECE,2,7500,12712,2288,15000,April
6674,ZESTA STRAWBERRY JAM,PIECE,2,10500,17797,3203,21000,April
6723,BRITANIA GINGER BISCUITS 1KG,PIECE,2,20000,33898,6102,40000,April
6724,US MUSTARD 227G-8000,PIECE,2,8000,13559,2441,16000,April
6765,BIRTHDAY CANDLE 2K,PIECE,2,2000,3390,610,4000,April
6766,BIRTHDAY CANDLE 1500,PIECE,2,1500,2542,458,3000,April
6770,SUNLIGHT SPRING 2KG,PIECE,2,20000,33898,6102,40000,April
6796,JESA FRUIT BLUEBERRY 150G,PIECE,2,2500,4237,763,5000,April
6880,STA-SOFT 20ML OCEAN&LAVENDER,PIECE,2,700,1186,214,1400,April
6922,MUSHROOM 2000,PIECE,2,2000,3390,610,4000,April
6940,JAMIES CAKE @100k,PIECE,2,100000,169492,30508,200000,April
6991,GOLDER WHITE BOARD MARKER ,PIECE,2,1500,2542,458,3000,April
7063,"AXE ICE CHILL, GOLD, ADRENALIN",PIECE,2,13000,22034,3966,26000,April
7093,PEPTANG TOMATO KETCHUP 700G,PIECE,2,12000,20339,3661,24000,April
7119,TREE CITY SHOWER GEL ROSE 2LTRS,PIECE,2,27000,45763,8237,54000,April
7244,PLAIN PILAU RICE 10000,PIECE,2,17500,29661,5339,35000,April
7277,DOUGHNUTS WHOLESALE 2500,PIECE,2,2500,4237,763,5000,April
7282,Downy vanilla&cashmere musk 880ml,PIECE,2,24000,40678,7322,48000,April
7324,OYAL COCOX,PIECE,2,1500,2542,458,3000,April
7330,SUMZ GONJA CRISP 400G,PIECE,2,12000,20339,3661,24000,April
7331,KAKIRA SUGAR 25KG,PIECE,2,6000,10169,1831,12000,April
7379,SUMZ COATED PEANUTS PLAINMASALA 150G,PIECE,2,3000,5085,915,6000,April
7387,HB PENCILS,PIECE,2,1500,2542,458,3000,April
7427,COLGATE CLEAN MINT 10500,PIECE,2,10500,17797,3203,21000,April
7432,FRESCO BODY OIL 100ML 4000,PIECE,2,4000,6780,1220,8000,April
7438,YARRISON KIDS VESTS18000,PIECE,2,18000,30508,5492,36000,April
7525,KIDS GLASSES 2500,PIECE,2,2500,4237,763,5000,April
7537,TOY GITA 10000,PIECE,2,10000,16949,3051,20000,April
7546,DOLLS 15000,PIECE,2,15000,25424,4576,30000,April
7552,TOYS 5000,PIECE,2,5000,8475,1525,10000,April
7563,NIVEA FRESH NATURAL,PIECE,2,16000,27119,4881,32000,April
7606,BEYOGLU BISCUITO,PIECE,2,1500,2542,458,3000,April
7611,SUMZ ROASTED SESAME 80G,PIECE,2,2500,4237,763,5000,April
7643,KAXUE KIDS TOOTHBRUSH,PIECE,2,2500,4237,763,5000,April
7644,FANEST CHICKEN SAUSAGES 500G,PIECE,2,20000,33898,6102,40000,April
7687,NOTE BOOK 6500,PIECE,2,6500,11017,1983,13000,April
7720,SECRETS PADS ULTRA OVER NIGHT BLUE,PIECE,2,5500,9322,1678,11000,April
7769,SUMZ NUTRIBITE ENERGY BAR 80G,PIECE,2,2500,4237,763,5000,April
7782,DOVE ESSENTIALCARE LOTION 400ML,PIECE,2,20000,33898,6102,40000,April
7784,TOUCH AKY,PIECE,2,1000,1695,305,2000,April
7807,CROWN PERFUME 4 MEN 12000,PIECE,2,12000,20339,3661,24000,April
7834,HURRICANE 500ML,PIECE,2,9000,15254,2746,18000,April
7835,HURRICANE OCEAN FRESH 500ML,PIECE,2,9000,15254,2746,18000,April
7840,AXE APOLLO,PIECE,2,13000,22034,3966,26000,April
6874,MUSHROOM STEW,PIECE,2.79,10000,23644,4256,27900,April
15,7DAYS ANTIBACTERIAL BABY WIPES,PIECE,3,8500,21610,3890,25500,April
16,7DAYS ANTIBACTERIAL WIPES,PIECE,3,5000,12712,2288,15000,April
62,AFROCARE PERFUMED GLYCERINE,PIECE,3,2500,6356,1144,7500,April
91,ALWAYS ULTRA THIN,PIECE,3,3500,8898,1602,10500,April
114,AMARA MEN COOLING,PIECE,3,6000,15254,2746,18000,April
186,APTAMIL 1 400G,PIECE,3,52000,132203,23797,156000,April
208,ARIEL COLOR 1KG,PIECE,3,15502,39412,7094,46506,April
209,Ariel color and style,PIECE,3,8000,20339,3661,24000,April
254,AROMAT 75G,PIECE,3,5500,13983,2517,16500,April
271,ART BOOK SMALL,PIECE,3,2000,5085,915,6000,April
279,ASANTEE PAPAYA SOAP,PIECE,3,6500,16525,2975,19500,April
455,BABY NIPPLES BIG 1000,PIECE,3,1333,3390,610,4000,April
529,BALLET BABY JELLY 300MLS,PIECE,3,9500,24153,4347,28500,April
571,BAMBOO TOOTHPICKS,PIECE,3,2500,6356,1144,7500,April
578,BAR COCONUTY CHOCOLATE,PIECE,3,1500,3814,686,4500,April
612,BECCA COUNTER BOOKS 6500,PIECE,3,6500,16525,2975,19500,April
639,BEST RULER 1000,PIECE,3,1000,2542,458,3000,April
692,BIYINZINKA LIVER 500G,PIECE,3,6000,15254,2746,18000,April
704,BLESSED KISUBI TEA 200G,PIECE,3,6000,15254,2746,18000,April
790,BOX FILES 6000,PIECE,3,7000,17797,3203,21000,April
820,BRITANIA DIGESTIVE 1KG,PIECE,3,20000,50847,9153,60000,April
852,BROOMS 2000,PIECE,3,2000,5085,915,6000,April
1064,CELOTAPE SMALL 1000,PIECE,3,1000,2542,458,3000,April
1066,CERELAC 12MONTHS 400G,PIECE,3,27000,68644,12356,81000,April
1187,CLERE BABY JELLY 250G,PIECE,3,5000,12712,2288,15000,April
1198,CLIMAX CITRUS FRUITS 50G,PIECE,3,2500,6356,1144,7500,April
1202,CLIMAX TROPICAL FRUITS 50G,PIECE,3,2500,6356,1144,7500,April
1257,COLGATE MAX FRESH 65G,PIECE,3,3500,8898,1602,10500,April
1262,COLGATE MAXIMUM CAVITY 35G,PIECE,3,2500,6356,1144,7500,April
1338,COVERTINA MILK CHOCOLATE,PIECE,3,3500,8898,1602,10500,April
1401,CUSSONS PERFUMED JELLY A&R 100ML,PIECE,3,5500,13983,2517,16500,April
1419,D.L BLUEBERRY SWIRL 500ML,PIECE,3,10000,25424,4576,30000,April
1427,D.L MAXIMO CARAMEL NUTS,PIECE,3,3500,8898,1602,10500,April
1440,D.L VAN-CHOC 500ML,PIECE,3,9500,24153,4347,28500,April
1441,D.L VANILLA 1LTR,PIECE,3,18000,45763,8237,54000,April
1457,DAIRIES 12000,PIECE,3,12000,30508,5492,36000,April
1468,DAITY AMIRALDOUBLE CHOCOLATE,PIECE,3,4500,11441,2059,13500,April
1471,DAITY CAPPUCCINO VANILLA ICE CREAM,PIECE,3,5500,13983,2517,16500,April
1532,DERBY CLUB HOUSE MIST,PIECE,3,16000,40678,7322,48000,April
1542,DETTOL COOL 105G,PIECE,3,4500,11441,2059,13500,April
1547,DETTOL FRESH 175G,PIECE,3,6500,16525,2975,19500,April
1550,DETTOL HERBAL 105G,PIECE,3,4500,11441,2059,13500,April
1569,DIANA LOTION 30ML,PIECE,3,4000,10169,1831,12000,April
1603,DISPOSABLE SPOON 4000,PIECE,3,4000,10169,1831,12000,April
1643,DOLL 4000,PIECE,3,4000,10169,1831,12000,April
1731,DOVE ROLL ON MIX,PIECE,3,11000,27966,5034,33000,April
1772,DURU CARING MILK,PIECE,3,4500,11441,2059,13500,April
1773,DURU CUCUMBER,PIECE,3,4500,11441,2059,13500,April
1814,EARBUDS 2500,PIECE,3,2500,6356,1144,7500,April
1818,EAST AFRICAN ORGANIC HONEY 100G,PIECE,3,3500,8898,1602,10500,April
1820,EAST AFRICAN ORGANIC HONEY 450G,PIECE,3,12000,30508,5492,36000,April
1874,ELEGANT FLORAL LEMON A.F,PIECE,3,7000,17797,3203,21000,April
1911,ENVELOPES 300,PIECE,3,300,763,137,900,April
1915,ERASER RUBBER BIG,PIECE,3,1000,2542,458,3000,April
1948,F.D PLAIN 250G,PIECE,3,2500,6356,1144,7500,April
2087,FIDODIDO STRAW-VANI 250ML,PIECE,3,4000,10169,1831,12000,April
2113,FLOWERS 2000,PIECE,3,2000,5085,915,6000,April
2114,FLYMEEGO VESTS 25000,PIECE,3,25000,63559,11441,75000,April
2280,GARDEN TEA 100G,PIECE,3,5000,12712,2288,15000,April
2315,GIFT BAG 4500,PIECE,3,4500,11441,2059,13500,April
2416,GOOD DOCTOR KIDS TOOTH,PIECE,3,1000,2542,458,3000,April
2518,HARPIC ORIGINAL PLUS,PIECE,3,15000,38136,6864,45000,April
2765,JAMIES TWISTED BREAD 1KG,PIECE,3,6000,15254,2746,18000,April
2801,JESA STRAWBERRY MILK 200MLS,PIECE,3,1500,3814,686,4500,April
2940,KABODY PUMPKIN PORRIDGE 1KG,PIECE,3,6000,15254,2746,18000,April
2942,KABODY PURE MILLET 1KG,PIECE,3,6000,15254,2746,18000,April
2943,KABODY QUICK PORRIDGE1KG,PIECE,3,6000,15254,2746,18000,April
3110,KIRINGI KAZI BOOSTER 280ML,PIECE,3,1000,2542,458,3000,April
3131,KIWI 20G,PIECE,3,3000,7627,1373,9000,April
3137,KIWI DARK TAN 32G,PIECE,3,4500,11441,2059,13500,April
3140,KIWI POLISH 12G,PIECE,3,2500,6356,1144,7500,April
3152,KNICKERS 3500,PIECE,3,3500,8898,1602,10500,April
3157,KNICKERS 8000,PIECE,3,8000,20339,3661,24000,April
3171,KOFA MATHEMATICAL SET,PIECE,3,4000,10169,1831,12000,April
3211,KOOKSY VAN-STRAW 500ML,PIECE,3,5000,12712,2288,15000,April
3213,KOPIKO BLANCA CREAMY,PIECE,3,2000,5085,915,6000,April
3244,LA BELLE BABY JELLY 55G,PIECE,3,2000,5085,915,6000,April
3380,LIMOUSINE,PIECE,3,1500,3814,686,4500,April
3473,M&G HIGHLIGHTER GREEN,PIECE,3,1500,3814,686,4500,April
3494,M&G STICK GLUE 3000,PIECE,3,3000,7627,1373,9000,April
3538,MAGANJO CORNFLAKES,PIECE,3,10000,25424,4576,30000,April
3760,MOCACINE SOCKS 2000,PIECE,3,2000,5085,915,6000,April
3761,MOCACINE SOCKS 2500,PIECE,3,2500,6356,1144,7500,April
3809,MOPPER 7000,PIECE,3,7000,17797,3203,21000,April
3945,MUKISA MANDAZI,PIECE,3,3000,7627,1373,9000,April
3985,MYSTIC AIRFRESHENER BEWITCHING ROSE,PIECE,3,7500,19068,3432,22500,April
3986,MYSTIC AIRFRESHNER LAVENDER 350ML,PIECE,3,7500,19068,3432,22500,April
4030,NATURAL SPONGE 2000,PIECE,3,2000,5085,915,6000,April
4143,NIVEA DRY IMPACT ROLLON,PIECE,3,11000,27966,5034,33000,April
4338,OMO BLEACH MULTI-PURPOSE 70ML,PIECE,3,1500,3814,686,4500,April
4342,OMO COMFORT 1KG,PIECE,3,13000,33051,5949,39000,April
4414,OWEN'S G-NUTS 1000,PIECE,3,1000,2542,458,3000,April
4415,OWEN'S G-NUTS 2000,PIECE,3,2200,5593,1007,6600,April
4447,PAMPER 3 L.C PANTS,PIECE,3,9000,22881,4119,27000,April
4463,PAMPERS WIPES COMPLETE CLEAN,PIECE,3,13500,34322,6178,40500,April
4540,PEPSODENT CAVITY FIGHTER 150G,PIECE,3,5000,12712,2288,15000,April
4663,POMEGRANATE ED PASSION,PIECE,3,16000,40678,7322,48000,April
4694,POULTRY VIENNAS 1KG,PIECE,3,36000,91525,16475,108000,April
4712,PREMIUM QUALITY TISSUE,PIECE,3,7500,19068,3432,22500,April
4746,PRINGLES SOUR CREAM 165G,PIECE,3,12000,30508,5492,36000,April
4820,QUAKER WHITE OATS,PIECE,3,13000,33051,5949,39000,April
4875,RAYAN BLACK PERFUME,PIECE,3,12000,30508,5492,36000,April
4897,RED COCK 2KG,PIECE,3,27000,68644,12356,81000,April
4991,ROKI OIL 3LTRS,PIECE,3,27000,68644,12356,81000,April
5028,RUBBER BAND 4000,PIECE,3,4333,11017,1983,13000,April
5030,RUBEE LOTION 59ML,PIECE,3,5000,12712,2288,15000,April
5063,SAF-LEVURE 125G,PIECE,3,8500,21610,3890,25500,April
5081,SAMONA HERBAL SOAP 100G,PIECE,3,4000,10169,1831,12000,April
5196,SCRUBING BRUSHES WHITE 9000,PIECE,3,9000,22881,4119,27000,April
5252,SHAKERS 1000,PIECE,3,1000,2542,458,3000,April
5259,SHARPENER SMALL,PIECE,3,500,1271,229,1500,April
5260,SHARPENERS,PIECE,3,1000,2542,458,3000,April
5267,SHENKE LEMON SCENT,PIECE,3,8000,20339,3661,24000,April
5268,SHENKE LOTUS SCENT,PIECE,3,8000,20339,3661,24000,April
5281,SHIVA HONEY 250G,PIECE,3,8000,20339,3661,24000,April
5287,SHOE BRUSH 5000,PIECE,3,5000,12712,2288,15000,April
5300,SHOWE TO SHOWER MENV EXTREME ICE,PIECE,3,6000,15254,2746,18000,April
5331,SHUYA 240 MM,PIECE,3,6000,15254,2746,18000,April
5334,SHUYA PANT LINERS,PIECE,3,6000,15254,2746,18000,April
5376,SIMKA STRAW-VAN 300MLS,PIECE,3,3500,8898,1602,10500,April
5508,SOFINE PURE OLIVE OIL 120ML,PIECE,3,7000,17797,3203,21000,April
5527,SOFTCARE BABY PANTS L40,PIECE,3,27000,68644,12356,81000,April
5558,SOSOFT BABY 750MLS,PIECE,3,11000,27966,5034,33000,April
5565,SOSOFT VANILLA 750MLS,PIECE,3,9000,22881,4119,27000,April
5611,SPONGE 4000,PIECE,3,4000,10169,1831,12000,April
5760,SUMZ PUMPKIN SEEDS 70G,PIECE,3,3000,7627,1373,9000,April
5794,SUNLIGHT SPRING IKG,PIECE,3,11000,27966,5034,33000,April
5877,SWEETS 1500 ICECREAMM LOLLIPOP,PIECE,3,1500,3814,686,4500,April
5909,SWT-1 RICE 1KG GREEN,PIECE,3,7500,19068,3432,22500,April
5962,TEEPEE BRUSH A25,PIECE,3,3500,8898,1602,10500,April
6185,TROPICAL HEAT BEEF MASALA 100G,PIECE,3,5000,12712,2288,15000,April
6190,TROPICAL HEAT CINNAMON 50G,PIECE,3,4500,11441,2059,13500,April
6191,TROPICAL HEAT CLOVE POWDER,PIECE,3,7500,19068,3432,22500,April
6210,TROPICAL HEAT PILAU MASALA 50G,PIECE,3,6000,15254,2746,18000,April
6218,TROPICAL HEAT TURMERIC 50G,PIECE,3,3500,8898,1602,10500,April
6301,UGACHICK WINGS 500G,PIECE,3,13000,33051,5949,39000,April
6305,UGANDA SAFARI TEA 250G,PIECE,3,7000,17797,3203,21000,April
6307,UGANDA TEA BAGS,PIECE,3,5500,13983,2517,16500,April
6318,UMBRELLAS 8000,PIECE,3,8000,20339,3661,24000,April
6401,VASELINE BLUESEAL COCOA BUTTER250ML,PIECE,3,9500,24153,4347,28500,April
6412,VASELINE DRY SKIN REPAIR 200ML,PIECE,3,8000,20339,3661,24000,April
6423,VASELINE MEN COOLING LOTION 200ML,PIECE,3,8000,20339,3661,24000,April
6427,VASELINE MEN JELLY FRESH 240ML,PIECE,3,9500,24153,4347,28500,April
6468,VIM LAVENDER 1KG,PIECE,3,8000,20339,3661,24000,April
6537,WEETABIX 450G,PIECE,3,15500,39407,7093,46500,April
6607,WRAPPING PAPER 1000,PIECE,3,1000,2542,458,3000,April
6663,ZERO PIMPLE SOAP 120G,PIECE,3,4000,10169,1831,12000,April
6672,ZESTA MIXED FRUIT JAM,PIECE,3,7500,19068,3432,22500,April
6673,ZESTA MIXED FRUIT JAM 500G,PIECE,3,10500,26695,4805,31500,April
6677,ZESTA TOMATO KETCHUP 700G,PIECE,3,12000,30508,5492,36000,April
6707,VASELINE BLUESEAL MEN COOLING 95ML,PIECE,3,5000,12712,2288,15000,April
6710,VASELINE BLUESEAL COCOA BUTTER 95ML,PIECE,3,5000,12712,2288,15000,April
6778,PILAO PLAIN 5000,PIECE,3,5000,12712,2288,15000,April
6782,CHICKEN STEW 8000,PIECE,3,8000,20339,3661,24000,April
6794,KATOGO 2500,PIECE,3,3067,7797,1403,9200,April
6795,KATOGO 2000,PIECE,3,2800,7119,1281,8400,April
6988,ELITE BALL PENS 500,PIECE,3,500,1271,229,1500,April
7036,SOAP DISH 3500,PIECE,3,3500,8898,1602,10500,April
7090,SUPER-MAX BLADES 1000,PIECE,3,1000,2542,458,3000,April
7100,FOIL BALLOON 3000,PIECE,3,3000,7627,1373,9000,April
7295,PLASTIC SWINGING CANDLE 2500,PIECE,3,2500,6356,1144,7500,April
7362,SUMZ BAGGIA 200G,PIECE,3,5000,12712,2288,15000,April
7406,COLGATE TOOTHBRUSH 6+,PIECE,3,6000,15254,2746,18000,April
7540,NUMA KARO 2KG 12000,PIECE,3,12000,30508,5492,36000,April
7557,MEGA SPAGHETTI,PIECE,3,4500,11441,2059,13500,April
7610,MARSHAL SET,PIECE,3,4000,10169,1831,12000,April
7779,DAIMA MANGO 500ML,PIECE,3,3000,7627,1373,9000,April
7785,JINBO NOTEBOOK 15000,PIECE,3,15000,38136,6864,45000,April
7830,PICK n PEEL ORANGE JUICE 1LITRE,PIECE,3,9500,24153,4347,28500,April
10,5LTR JERRICAN 3000,PIECE,4,4000,13559,2441,16000,April
36,ACTIVE WOMAN BODY SPRAY,PIECE,4,10000,33898,6102,40000,April
95,ALWAYS VALUE PACK LONG,PIECE,4,6500,22034,3966,26000,April
253,AROMAT 200G,PIECE,4,12000,40678,7322,48000,April
339,AXESS AQUA,PIECE,4,8000,27119,4881,32000,April
344,AZAM BAKING FLOUR 2KG,PIECE,4,8500,28814,5186,34000,April
443,BABY JUNIOR JELLY 24ML,PIECE,4,700,2373,427,2800,April
533,BALLET BABY MILK SOAP,PIECE,4,4000,13559,2441,16000,April
570,BAMBOO TOOTHPICK 2500,PIECE,4,2500,8475,1525,10000,April
890,BUSHENYI HONEY 250G,PIECE,4,6000,20339,3661,24000,April
902,C.B CHOCOLATE CHOCO CHIPS 200ML,PIECE,4,5000,16949,3051,20000,April
914,C.B RIPPLES MIXED 200MLS,PIECE,4,4000,13559,2441,16000,April
949,CADBURY RUM&RAISIN 80G,PIECE,4,8000,27119,4881,32000,April
1011,CAR TOYS 3000,PIECE,4,3000,10169,1831,12000,April
1012,CAR TOYS 4000,PIECE,4,4000,13559,2441,16000,April
1235,COCONUT PRADIP,PIECE,4,4500,15254,2746,18000,April
1256,COLGATE KIDS 2-5YEARS,PIECE,4,5000,16949,3051,20000,April
1263,COLGATE MAXIMUM CAVITY 70G,PIECE,4,4500,15254,2746,18000,April
1343,COW & GATE 1 400GM,PIECE,4,44000,149153,26847,176000,April
1348,COW&GATE 3 NUTRIJUNIOR,PIECE,4,44000,149153,26847,176000,April
1396,CUSSONS BABY UNPERFUMED JELLY 100ML,PIECE,4,5500,18644,3356,22000,April
1428,D.L MAXIMO VAN-CHOCO FLAKES 175ML,PIECE,4,4000,13559,2441,16000,April
1447,D.L VAN-STRAW 500ML,PIECE,4,9500,32203,5797,38000,April
1473,DAITY ICEPRESSO COFFE,PIECE,4,2500,8475,1525,10000,April
1474,DAITY SAFFRON ICE CREAM,PIECE,4,5500,18644,3356,22000,April
1544,DETTOL EVENTONE 175G,PIECE,4,6500,22034,3966,26000,April
1552,DETTOL JUNIORS GLYCERINE SOAP 100G,PIECE,4,4500,15254,2746,18000,April
1558,DETTOL ORIGINAL 175G,PIECE,4,6500,22034,3966,26000,April
1560,DETTOL SKINCARE 175G,PIECE,4,6500,22034,3966,26000,April
1688,DOUBLE REFINED SALT 650G,PIECE,4,7000,23729,4271,28000,April
1734,DOVE ROLLON GRAPEFRUIT,PIECE,4,11000,37288,6712,44000,April
1752,DOWNY FEEL RELAXED 280ML,PIECE,4,11000,37288,6712,44000,April
1825,ECO STYLING GEL 236ML,PIECE,4,11000,37288,6712,44000,April
1887,ELEGANT STRAWBERRY 300ML,PIECE,4,7000,23729,4271,28000,April
2049,FAX ROSE&HONEY 225G SOAP,PIECE,4,5000,16949,3051,20000,April
2061,FEATHERS PADS REGULAR,PIECE,4,3000,10169,1831,12000,April
2154,FOOD COLOUR ORANGE,PIECE,4,1000,3390,610,4000,April
2298,GEISHA ROSE&HONEY 225G,PIECE,4,4000,13559,2441,16000,April
2375,GLUE STICK 21G,PIECE,4,2500,8475,1525,10000,April
2408,GOLDEN SPEED YEAST,PIECE,4,13000,44068,7932,52000,April
2413,GOOD DAY CASHEW COOKIES,PIECE,4,2600,8814,1586,10400,April
2477,HABARI SALT SMALL,PIECE,4,700,2373,427,2800,April
2515,HARPIC CITRUS,PIECE,4,15000,50847,9153,60000,April
2676,INDOCAFE CAPPUCCINO CREAMY,PIECE,4,3000,10169,1831,12000,April
2706,JAGO 100MLS,PIECE,4,3500,11864,2136,14000,April
2714,JAGO SCRUB 250G,PIECE,4,7500,25424,4576,30000,April
2916,JUMBO BLUE SWIRL 175ML,PIECE,4,4000,13559,2441,16000,April
3134,KIWI CREME BLACK 100MLS,PIECE,4,4000,13559,2441,16000,April
3150,KNICKERS 2000,PIECE,4,2000,6780,1220,8000,April
3208,KOOKSY VANILLA STRAWBERRY 250ML,PIECE,4,3500,11864,2136,14000,April
3402,LONDON FACIAL WIPES,PIECE,4,3500,11864,2136,14000,April
3535,MAGANJO BABY SOYA WITH MILK 500G,PIECE,4,8500,28814,5186,34000,April
3748,MIRROR 1500,PIECE,4,1500,5085,915,6000,April
3891,MOVIT FAMILY SOAP COCOMUT 125G,PIECE,4,2500,8475,1525,10000,April
4199,NOTE BOOK 5500,PIECE,4,5500,18644,3356,22000,April
4223,NUMA SOYA RICE 1KG,PIECE,4,7000,23729,4271,28000,April
4508,PEGS 3000,PIECE,4,3000,10169,1831,12000,April
4577,PICFARE 192 PAGES 6000,PIECE,4,6000,20339,3661,24000,April
4743,PRINGLES ORIGINAL 40G,PIECE,4,5500,18644,3356,22000,April
4792,PUCELLE JOYFULSUMMER 150ML,PIECE,4,7500,25424,4576,30000,April
4794,PUCELLE PURE AROOSAH 75ML,PIECE,4,5000,16949,3051,20000,April
4898,RED COCK BASMATI 1KG,PIECE,4,14000,47458,8542,56000,April
4943,RIHAM BUTTER COOKIES BISCUIT 1KG,PIECE,4,18000,61017,10983,72000,April
4951,RIHAM CREAMY CRUNCH STRAWBERRY,PIECE,4,3000,10169,1831,12000,April
5209,SECRETS PADS,PIECE,4,4000,13559,2441,16000,April
5223,SENSODYNE MULTICARE 40MLS,PIECE,4,7000,23729,4271,28000,April
5233,SESACO SOYACUP 150G,PIECE,4,4000,13559,2441,16000,April
5265,SHENKE FLOWER REPELLENT,PIECE,4,8000,27119,4881,32000,April
5269,SHENKE MOSQUITO COIL,PIECE,4,6000,20339,3661,24000,April
5399,SKIN CARE 100G,PIECE,4,3000,10169,1831,12000,April
5482,SNOW SPRAYS 4500,PIECE,4,5000,16949,3051,20000,April
5530,SOFTCARE L40,PIECE,4,25000,84746,15254,100000,April
5609,SPONGE 2000,PIECE,4,2000,6780,1220,8000,April
5746,SUMZ GINGER COOKIES,PIECE,4,4000,13559,2441,16000,April
5767,SUMZS CRISPS 500G,PIECE,4,12000,40678,7322,48000,April
5796,SUNLIGHT TROPICAL 1KG,PIECE,4,11000,37288,6712,44000,April
5798,SUNLIGHT TROPICAL 500G,PIECE,4,5500,18644,3356,22000,April
5844,SUPER GLUE,PIECE,4,1000,3390,610,4000,April
5906,SWT LONG GRAIN 5KG/JASONS 5KG,PIECE,4,43000,145763,26237,172000,April
6188,TROPICAL HEAT CHICKEN MASALA 100G,PIECE,4,5000,16949,3051,20000,April
6208,TROPICAL HEAT PAPRIKA,PIECE,4,3500,11864,2136,14000,April
6308,UGANDA TEA BAGS 100BAGS,PIECE,4,9000,30508,5492,36000,April
6493,WALMUS MUKENE SNACKS 7500,PIECE,4,8500,28814,5186,34000,April
6573,WHITE VINEGAR,PIECE,4,2500,8475,1525,10000,April
6708,VASELINE BLUESEAL BABY 95ML,PIECE,4,5000,16949,3051,20000,April
6848,PIZZA 16'' CHICKEN ,PIECE,4,35000,118644,21356,140000,April
6981,BAKEMATE LOVE CHOCOLATE ,PIECE,4,3500,11864,2136,14000,April
7101,JAMIES DADDIES TIN 17000,PIECE,4,17000,57627,10373,68000,April
7146,JAMIES COOKIES TIN 500G 10000,PIECE,4,10000,33898,6102,40000,April
7174,JAMIES LIQUID SOAP 5LTR 10000,PIECE,4,10000,33898,6102,40000,April
7344,COMB 1000,PIECE,4,1000,3390,610,4000,April
7361,SUMZ DADDIES 300G,PIECE,4,5000,16949,3051,20000,April
7475,MENTOS FRUIT 29G,PIECE,4,2000,6780,1220,8000,April
7550,TOYS 20000,PIECE,4,20000,67797,12203,80000,April
7646,AMERICAN GARDEN APPLE CIDER 500ML,PIECE,4,11000,37288,6712,44000,April
7707,JAMIES COOKIES@20000,PIECE,4,20000,67797,12203,80000,April
7783,MENTOS PEACH ORANGE,PIECE,4,2500,8475,1525,10000,April
7801,DOVE POMEGRADE 90G 5000,PIECE,4,5000,16949,3051,20000,April
7811,FLAMINGO ROSE& HONEY 200G,PIECE,4,3500,11864,2136,14000,April
7832,FANEST BEEF SAUSAGES 500G,PIECE,4,13000,44068,7932,52000,April
7861,ROYAL SHAVERS,PIECE,4,3500,11864,2136,14000,April
7,300MLS DISPOSABLE GLASSES,PIECE,5,5000,21186,3814,25000,April
113,AMARA MEN 400ML,PIECE,5,8500,36017,6483,42500,April
442,BABY JUNIOR JELLY 200g,PIECE,5,6000,25424,4576,30000,April
524,BALLET ACTIVE VITAMIN 300MLS,PIECE,5,9500,40254,7246,47500,April
528,BALLET BABY JELLY 120MLS,PIECE,5,5000,21186,3814,25000,April
649,BI-CARBONATE SODA,PIECE,5,1000,4237,763,5000,April
718,BLUE BAND LOW SPREAD 250G,PIECE,5,4000,16949,3051,20000,April
913,C.B RIPPLES CHOCOLATE 200ML,PIECE,5,4000,16949,3051,20000,April
1017,CARAMBOLA BLACK SPOT,PIECE,5,6000,25424,4576,30000,April
1045,CB CHOC-VANILLA 120MLS,PIECE,5,2500,10593,1907,12500,April
1047,CB CLASSIC VANILLA 200MLS,PIECE,5,4000,16949,3051,20000,April
1054,CB MAGIC STRAW 500ML,PIECE,5,10000,42373,7627,50000,April
1095,CHAPA BAKING POWDER,PIECE,5,1500,6356,1144,7500,April
1096,CHAPA NYOTA BLUE 600G,PIECE,5,4000,16949,3051,20000,April
1166,PICFARE GOLD 96PGS,PIECE,5,1000,4237,763,5000,April
1248,COLGATE DEEP CLEAN,PIECE,5,1500,6356,1144,7500,April
1289,COMPACT T.P,PIECE,5,1000,4237,763,5000,April
1359,CREAMY EFFECT WIPES,PIECE,5,6000,25424,4576,30000,April
1389,CUSSON SOAP MILD&GENTLE,PIECE,5,3500,14831,2669,17500,April
1429,D.L MEGA CONE VANILLA,PIECE,5,3500,14831,2669,17500,April
1453,DABUR NEEM TOOTHPASTE 150G,PIECE,5,6000,25424,4576,30000,April
1557,DETTOL ORIGINAL 100G,PIECE,5,4500,19068,3432,22500,April
1602,DISPOSABLE PLATES 9 ROUND,PIECE,5,6500,27542,4958,32500,April
1715,DOVE MEN SOAP ULTRA,PIECE,5,7500,31780,5720,37500,April
1718,DOVE ORIGINAL SOAP 135G,PIECE,5,5500,23305,4195,27500,April
1775,DURU ENERGIZING HONEY,PIECE,5,4500,19068,3432,22500,April
1819,EAST AFRICAN ORGANIC HONEY 250G,PIECE,5,8000,33898,6102,40000,April
2002,FACE TOWEL 3000 WHITE,PIECE,5,3000,12712,2288,15000,April
2181,FORTUNE SPAGHETTI 450,PIECE,5,3500,14831,2669,17500,April
2233,FRUITVILLE APPLE DRINK,PIECE,5,3500,14831,2669,17500,April
2299,GEISHA SHEA AND ALMOND BUTTER SOAP 225G,PIECE,5,5500,23305,4195,27500,April
2530,HEINZ KETCHUP 300G,PIECE,5,8000,33898,6102,40000,April
2636,IBON ELVAN SWEETS,PIECE,5,200,847,153,1000,April
2724,JAMIES CAKES @ 40K,PIECE,5,40000,169492,30508,200000,April
2725,JAMIES CAKES @50k,PIECE,5,50000,211864,38136,250000,April
2726,JAMIES CAKES @60K,PIECE,5,60000,254237,45763,300000,April
2809,JESA VANILLA FLAVOURED 200ML,PIECE,5,1500,6356,1144,7500,April
2921,JUMBO STRAWBERRY RIPPLE 175ML,PIECE,5,4000,16949,3051,20000,April
2988,KAZIRE POWER TONIC,PIECE,5,2000,8475,1525,10000,April
3093,KIDS WATCHES 5000 GODLER,PIECE,5,5000,21186,3814,25000,April
3116,KIRUNGI PINEAPPLE 250MLS,PIECE,5,1000,4237,763,5000,April
3493,M&G STICK GLUE 1500,PIECE,5,1500,6356,1144,7500,April
3539,MAGANJO ENERGY BOOSTER 1KG,PIECE,5,6500,27542,4958,32500,April
3575,MAKE UP FACIAL WIPES,PIECE,5,3500,14831,2669,17500,April
3584,MAMIS PEANUT PASTE 1KG,PIECE,5,15000,63559,11441,75000,April
3625,MAYONNAISE 237ML,PIECE,5,19000,80508,14492,95000,April
3956,MUKWANO OIL 500ML JERRYCAN,PIECE,5,5000,21186,3814,25000,April
4026,NATARAJ RULER,PIECE,5,1500,6356,1144,7500,April
4190,NOMI 250G BUCKET,PIECE,5,4000,16949,3051,20000,April
4222,NUMA RICE FLOUR 1KG,PIECE,5,7500,31780,5720,37500,April
4245,NUTRO STRAW CREAM WAFERS,PIECE,5,3500,14831,2669,17500,April
4346,OMO FAST ACTION 500G,PIECE,5,7500,31780,5720,37500,April
4367,ORCHID VALLEY GUAVA 1LTR,PIECE,5,7500,31780,5720,37500,April
4450,PAMPER 4 L.C PANTS,PIECE,5,9000,38136,6864,45000,April
4539,PEPSODENT CAVITY 65G,PIECE,5,2500,10593,1907,12500,April
4541,PEPSODENT HERBAL 65G,PIECE,5,2500,10593,1907,12500,April
4581,PICFARE 48PGS,PIECE,5,500,2119,381,2500,April
4592,PICFARE SET,PIECE,5,6000,25424,4576,30000,April
4598,PICK N PEEL MANGO 250ML,PIECE,5,2500,10593,1907,12500,April
4653,PLUTO ADVANCED AA,PIECE,5,6000,25424,4576,30000,April
4664,POP & CONE SWEETS,PIECE,5,500,2119,381,2500,April
4667,POPPER 7000,PIECE,5,7000,29661,5339,35000,April
4777,PROTEX HERBAL 150G,PIECE,5,6500,27542,4958,32500,April
4785,PUCELLE ECCETRIC BREEZE 75ML,PIECE,5,5000,21186,3814,25000,April
5021,ROYCO CHICKEN 200G,PIECE,5,6000,25424,4576,30000,April
5048,SAFA HONEY 400G,PIECE,5,15000,63559,11441,75000,April
5250,SHADES 6000,PIECE,5,6000,25424,4576,30000,April
5303,SHOWER TO SHOWER HAPPY DAYS,PIECE,5,6000,25424,4576,30000,April
5313,SHOWERTO SHOWER MUSK ALIVE,PIECE,5,6000,25424,4576,30000,April
5381,SIMKA VANILLA 300MLS,PIECE,5,3500,14831,2669,17500,April
5726,SULTAN COCONUT HAIL OIL,PIECE,5,5000,21186,3814,25000,April
5795,SUNLIGHT SPRING SENSATIONS 500G,PIECE,5,5500,23305,4195,27500,April
5910,SWT-P RICE 1KG YELLOW,PIECE,5,8000,33898,6102,40000,April
6202,TROPICAL HEAT GINGER 45G,PIECE,5,3500,14831,2669,17500,April
6404,VASELINE BLUESEAL MEN FRESH 100ML,PIECE,5,5000,21186,3814,25000,April
6469,VIM LAVENDER 500G,PIECE,5,5000,21186,3814,25000,April
6474,VINEGAR WHITE 700MLS,PIECE,5,2500,10593,1907,12500,April
6491,WALMUS MUKENE SNACKS,PIECE,5,5500,23305,4195,27500,April
6543,WEETABIX CORNFLAKES 250G,PIECE,5,15000,63559,11441,75000,April
6675,ZESTA STRAWBERRY JAM 300GM,PIECE,5,7500,31780,5720,37500,April
7306,MAVAL GIRL PANTY LINERS,PIECE,5,2500,10593,1907,12500,April
7553,TOYS 3000,PIECE,5,3000,12712,2288,15000,April
7592,COLGATE CHARCOAL 210G 10000,PIECE,5,10000,42373,7627,50000,April
7750,TOYS 4000,PIECE,5,4000,16949,3051,20000,April
7777,DAIMA MILK STRAWBERRY 250ML,PIECE,5,2500,10593,1907,12500,April
7824,BANANA JUICE 5000,PIECE,5,5000,21186,3814,25000,April
4,180ML DISPOSABLE GLASSES,PIECE,6,3000,15254,2746,18000,April
311,AUNT PORRIDGE 1KG,PIECE,6,14000,71186,12814,84000,April
313,AUNT PORRIDGE 6MONTHS,PIECE,6,14000,71186,12814,84000,April
353,B.D CANDLE NUMBERS,PIECE,6,1500,7627,1373,9000,April
537,BALLET BUTTER BLEND 120MLS,PIECE,6,4500,22881,4119,27000,April
541,BALLET POWDER 100G,PIECE,6,5000,25424,4576,30000,April
672,BIRTHDAY HATS 3500,PIECE,6,3500,17797,3203,21000,April
673,BIRTHDAY HATS 5000,PIECE,6,5000,25424,4576,30000,April
686,BIYINZIKA MIXED PORTIONS 2KG,PIECE,6,37000,188136,33864,222000,April
691,BIYINZIKA WINGS 500G,PIECE,6,11000,55932,10068,66000,April
703,BLESSED KISUBI TEA 125G,PIECE,6,5000,25424,4576,30000,April
730,BLUE TOILET BLOCKS SINGLE50G,PIECE,6,2500,12712,2288,15000,April
916,C.B RIPPLES STRAWBERRY 200ML,PIECE,6,4000,20339,3661,24000,April
917,C.B ROYAL MANGO 120ML,PIECE,6,2500,12712,2288,15000,April
1244,COLGATE 0-2YEARS,PIECE,6,4000,20339,3661,24000,April
1261,COLGATE MAXIMUM CAVITY 140G,PIECE,6,7500,38136,6864,45000,April
1277,COMB 1500,PIECE,6,1500,7627,1373,9000,April
1357,CREAMBELL STRAWBERRY VAN 500ML,PIECE,6,10000,50847,9153,60000,April
1437,D.L VAN.STRAW 250ML,PIECE,6,5000,25424,4576,30000,April
1448,DABUR CLOVE VALUE PACK,PIECE,6,10000,50847,9153,60000,April
1540,DETTOL ACTIVE 175G,PIECE,6,6500,33051,5949,39000,April
1668,DOMS GEOMETRY SET,PIECE,6,8500,43220,7780,51000,April
1856,EGGS TRAY,PIECE,6,14000,71186,12814,84000,April
1908,ENVELOPE A4,PIECE,6,500,2542,458,3000,April
1950,F.D PLAIN YOGHURT 450G,PIECE,6,3700,18814,3386,22200,April
1970,F.D VANILLA MILK 500MLS,PIECE,6,4000,20339,3661,24000,April
2209,FRESH UP TOOTHPASTE,PIECE,6,2000,10169,1831,12000,April
2289,GEISHA COCONUT MILK 200G,PIECE,6,4000,20339,3661,24000,April
2831,JIK REGULAR 250MLS,PIECE,6,6500,33051,5949,39000,April
2962,KANGARO STAPLES,PIECE,6,2000,10169,1831,12000,April
2966,KANGAROO BLACK SHOE CREAM,PIECE,6,2000,10169,1831,12000,April
3115,KIRUNGI MULONDO EXTRA 280ML,PIECE,6,1000,5085,915,6000,April
3119,KISUBI 85GM,PIECE,6,1500,7627,1373,9000,April
3533,MAGANJO BABY SOYA 1KG,PIECE,6,6500,33051,5949,39000,April
3561,MAGIC 1KG BUCKET,PIECE,6,12500,63559,11441,75000,April
3563,MAGIC 500G BUCKET,PIECE,6,6500,33051,5949,39000,April
3576,MAKE UP WIPES,PIECE,6,3500,17797,3203,21000,April
3598,MANUSCRIPT BOOK 2Q,PIECE,6,12000,61017,10983,72000,April
3608,MARLOS CHOCOLATE,PIECE,6,2000,10169,1831,12000,April
3655,MELEX SIMSIM BALLS 1000,PIECE,6,1000,5085,915,6000,April
3682,MESSAGE CARDS 500,PIECE,6,500,2542,458,3000,April
3855,MOTH BALLS 4000,PIECE,6,7000,35593,6407,42000,April
3997,NAIL CUTTER 2500,PIECE,6,2500,12712,2288,15000,April
4001,NANA HERBAL MOUTH 60MLS,PIECE,6,7500,38136,6864,45000,April
4198,NOTE BOOK 4000,PIECE,6,4000,20339,3661,24000,April
4218,NUMA BUSHERA 1KG,PIECE,6,6500,33051,5949,39000,April
4235,NUTRO CHOC CREAM WAFERS,PIECE,6,6500,33051,5949,39000,April
4595,PICK n PEEL APPLE 1LTR,PIECE,6,9500,48305,8695,57000,April
4718,PRESTIGE 500G,PIECE,6,7500,38136,6864,45000,April
5167,SCHOOL SOCKS BLUE&WHITE 4000,PIECE,6,4000,20339,3661,24000,April
5272,SHENKE MOSQUITO REPELLANT,PIECE,6,16000,81356,14644,96000,April
5273,SHENKE MOSQUITO REPELLANT DOUBLE 20000,PIECE,6,20000,101695,18305,120000,April
5566,SOY SAUCE DARK 150G,PIECE,6,5000,25424,4576,30000,April
5765,SUMZ SIMSIM BALLS 100G,PIECE,6,2500,12712,2288,15000,April
6676,ZESTA TOMATO KETCHUP,PIECE,6,7000,35593,6407,42000,April
6861,CASSAVA BOILED 4PCS,PIECE,6,500,2542,458,3000,April
6987,DOMS CUBOID PEN ,PIECE,6,700,3559,641,4200,April
7077,VASELINE BLUESEAL ALOEVERA 95ML,PIECE,6,5000,25424,4576,30000,April
7163,SPIDERMAN SWEETS 700,PIECE,6,700,3559,641,4200,April
7308,COTTON EAR SWABS 4000,PIECE,6,4000,20339,3661,24000,April
7363,SUMZ PUMPKIN SEEDS 100G,PIECE,6,5000,25424,4576,30000,April
7419,Sandals,PIECE,6,8002,40686,7324,48010,April
7524,TOYS 2000,PIECE,6,2000,10169,1831,12000,April
7693,HAND BRUSH 2500,PIECE,6,2500,12712,2288,15000,April
7701,CLEAR BAGS 1500,PIECE,6,1500,7627,1373,9000,April
7721,SECRETS PANT LINERS PURPLE,PIECE,6,5500,27966,5034,33000,April
7746,SWEETS 1500,PIECE,6,1500,7627,1373,9000,April
7813,PETIT BEURRE 78G,PIECE,6,1300,6610,1190,7800,April
81,ALWAYS COTTON EXTRA LONG,PIECE,7,3000,17797,3203,21000,April
92,ALWAYS ULTRA V.P,PIECE,7,6500,38559,6941,45500,April
667,BIRTHDAY CROWNS 5000,PIECE,7,5000,29661,5339,35000,April
689,BIYINZIKA SUPA 1KG,PIECE,7,20000,118644,21356,140000,April
690,BIYINZIKA THIGHS 500G,PIECE,7,10000,59322,10678,70000,April
716,BLUE BAND 500G,PIECE,7,10000,59322,10678,70000,April
891,BUSHENYI HONEY 5OOG,PIECE,7,9000,53390,9610,63000,April
942,CADBURY DREAM WHITE BISCUITS,PIECE,7,8000,47458,8542,56000,April
1046,CB CLASSIC VANILLA 120MLS,PIECE,7,2500,14831,2669,17500,April
1111,CHERRY COTTON BUDS,PIECE,7,2500,14831,2669,17500,April
1182,CLEOS HOT SAUCE 125G,PIECE,7,3500,20763,3737,24500,April
1212,CLOSEUP TRIPLEFRESH 60G,PIECE,7,3000,17797,3203,21000,April
1266,COLGATE TOOTHBRUSH 1500,PIECE,7,1500,8898,1602,10500,April
1270,COLGATE TRIPPLE ACTION 70G,PIECE,7,3500,20763,3737,24500,April
1391,CUSSONS BABY OIL 100MLS,PIECE,7,9000,53390,9610,63000,April
1443,D.L VANILLA 500ML,PIECE,7,9500,56356,10144,66500,April
1477,DAITY VANILLA ICECREAM,PIECE,7,5500,32627,5873,38500,April
1914,ERASER RUBBER,PIECE,7,500,2966,534,3500,April
1942,F.D MANGO 450G,PIECE,7,3700,21949,3951,25900,April
1971,F.D YOGHURT MIXED BERRIES 450G,PIECE,7,3700,21949,3951,25900,April
2178,FORTUNE GOLD 500ML,PIECE,7,5000,29661,5339,35000,April
2180,FORTUNE SPAGHETTI 250G,PIECE,7,2000,11864,2136,14000,April
2295,GEISHA MORINGA OIL 225G,PIECE,7,5500,32627,5873,38500,April
2311,GIFT BAG 2500,PIECE,7,2500,14831,2669,17500,April
2659,IMPERIAL LEATHER MEN FRESH BURST,PIECE,7,4500,26695,4805,31500,April
3212,KOPIKO 3 IN 1 COFFEE,PIECE,7,2000,11864,2136,14000,April
3215,KOPIKO CAPPUCCINO CHOCO,PIECE,7,1500,8898,1602,10500,April
3239,KYOGERO HERBAL SOAP 120G,PIECE,7,3500,20763,3737,24500,April
3284,LATO CHOCO PWDER MILK 15G,PIECE,7,500,2966,534,3500,April
3548,MAGANJO PURE MILLET 1KG,PIECE,7,6500,38559,6941,45500,April
3585,MAMIS PEANUT PASTE 500G,PIECE,7,8000,47458,8542,56000,April
4036,NEEK YOGHURT 500G 3500,PIECE,7,3500,20763,3737,24500,April
4117,NISA CUCUMBER HAIR REMOVAL 20ML,PIECE,7,2000,11864,2136,14000,April
4123,NISA LEMON HAIR REMOVAL CREME 20ML,PIECE,7,2000,11864,2136,14000,April
4191,NOMI BUCKET 1KG,PIECE,7,12500,74153,13347,87500,April
4215,NTALE 25G,PIECE,7,2071,12288,2212,14500,April
4293,ODONIL DISINFECTANT,PIECE,7,7000,41525,7475,49000,April
4343,OMO COMFORT 500G,PIECE,7,7500,44492,8008,52500,April
4542,PEPSODENT HERBAL TRIPPLE140G,PIECE,7,5000,29661,5339,35000,April
5024,ROYCO CUBE CHICKEN FLAVOUR,PIECE,7,5000,29661,5339,35000,April
5222,SENSODYNE MULTI CARE 75MLS,PIECE,7,14000,83051,14949,98000,April
5660,STEEPO CHOCOLATE,PIECE,7,2000,11864,2136,14000,April
5786,SUNLIGHT LAVENDER 500G,PIECE,7,5500,32627,5873,38500,April
5979,TEMMY'S CORNFLAKES 250G,PIECE,7,9000,53390,9610,63000,April
6042,TOCEBAL AA,PIECE,7,1000,5932,1068,7000,April
6534,WEETABIX 112G,PIECE,7,4500,26695,4805,31500,April
6882,SUMZ FRIED PEAS,PIECE,7,2500,14831,2669,17500,April
6953,STRIKE NUTS CHOCOLATE BAR,PIECE,7,1500,8898,1602,10500,April
7642,KAXUE TOOTH BRUSH,PIECE,7,2500,14831,2669,17500,April
7703,TOYS 1000,PIECE,7,1000,5932,1068,7000,April
7726,DABUR CHARCOAL 150G,PIECE,7,6500,38559,6941,45500,April
7772,SUMZ BBQ FLAVOUR 60G,PIECE,7,3000,17797,3203,21000,April
274,ART PENCILS 3B,PIECE,8,1000,6780,1220,8000,April
915,C.B RIPPLES ORANGE 200ML,PIECE,8,4000,27119,4881,32000,April
1048,CB CLASSIC VANILLA 500ML,PIECE,8,10000,67797,12203,80000,April
1093,CHAMPION A4 200PAGES,PIECE,8,4000,27119,4881,32000,April
1406,CUSSONS SOAP SOFT&SMOOTH,PIECE,8,3500,23729,4271,28000,April
1510,DELIDENT MAX 70G,PIECE,8,2000,13559,2441,16000,April
1937,F.D FLAVOURED CHOCOLATE,PIECE,8,4000,27119,4881,32000,April
2175,FORTUNE BUTTO 500ML,PIECE,8,4500,30508,5492,36000,April
2290,GEISHA COCONUTMILK 125G,PIECE,8,2500,16949,3051,20000,April
2303,GEISHA TRADITIONAL BLACK SOAP 125G,PIECE,8,4000,27119,4881,32000,April
2317,GIFT BAG FLORAL LARGE,PIECE,8,6000,40678,7322,48000,April
2414,GOOD DAY CHOCO CHIP,PIECE,8,5000,33898,6102,40000,April
2538,HERMELA GUEST SOAP,PIECE,8,3500,23729,4271,28000,April
2663,IMPERIAL LEATHER SOAP RED 175G,PIECE,8,4000,27119,4881,32000,April
2989,KAZIRE RED TONIC 350MLS,PIECE,8,2000,13559,2441,16000,April
3276,LANZO BUBBLY SOAP,PIECE,8,3500,23729,4271,28000,April
3995,NACET BLADES 2500 PKT,PIECE,8,2500,16949,3051,20000,April
4035,NEEK YOGHURT 300G 2000,PIECE,8,2500,16949,3051,20000,April
4363,ORAL-B TOOTHBRUSH,PIECE,8,3500,23729,4271,28000,April
4444,PAMPER 2 L.C,PIECE,8,9000,61017,10983,72000,April
4594,PICH n PEEL TROPICAL MIX 1LTR,PIECE,8,9500,64407,11593,76000,April
4599,PICK N PEEL TROPICAL MIX 250ML,PIECE,8,2500,16949,3051,20000,April
4626,PLASTIC GLASSES 3500,PIECE,8,3500,23729,4271,28000,April
4950,RIHAM CREAMY CRUNCH CHOCOLATE,PIECE,8,3000,20339,3661,24000,April
4992,ROKI OIL 500ML,PIECE,8,5000,33898,6102,40000,April
5020,ROYCO BEEF 60G,PIECE,8,1200,8136,1464,9600,April
5053,SAFARI TEA 50G,PIECE,8,1500,10169,1831,12000,April
5181,SCOURING PADS 500,PIECE,8,500,3390,610,4000,April
5264,SHENKE COIL 4500,PIECE,8,4500,30508,5492,36000,April
5371,SIMKA CHOC-VANILLA 500ML,PIECE,8,4500,30508,5492,36000,April
5377,SIMKA STRAW-VAN 500MLS,PIECE,8,4500,30508,5492,36000,April
5536,SOFTCARE PAMPERS S15,PIECE,8,7500,50847,9153,60000,April
5567,SOY SAUCE DARK 500G,PIECE,8,10000,67797,12203,80000,April
5633,SQUISHY BLUE RASBERRY 200ML,PIECE,8,2000,13559,2441,16000,April
5731,SUMZ COCONUT COOKIES,PIECE,8,4000,27119,4881,32000,April
5734,SUMZ CORN CRAX CHILLI80G,PIECE,8,1500,10169,1831,12000,April
6216,TROPICAL HEAT TEA MASALA 45G,PIECE,8,5000,33898,6102,40000,April
6709,VASELINE BLUESEAL JELLY ORIGINAL 95ML,PIECE,8,5000,33898,6102,40000,April
7065,BRITANIA SWEET MEAL BISCUITS,PIECE,8,2500,16949,3051,20000,April
7164,NUTRO ORANGE BISCUIT 1200,PIECE,8,1200,8136,1464,9600,April
7364,SUMZ BAGGIA 100G,PIECE,8,3000,20339,3661,24000,April
7405,SUMZ FRIED SOYA BEANS 100G,PIECE,8,2500,16949,3051,20000,April
7547,TOYS 15000,PIECE,8,10625,72034,12966,85000,April
7810,EVERYDAY CREAM BISCUITS 80G,PIECE,8,1200,8136,1464,9600,April
7816,FRUIT VILLE STRAWBERRY BANANA 500ML,PIECE,8,3500,23729,4271,28000,April
9,500MLS DISPOSABLE GLASSES,PIECE,9,6000,45763,8237,54000,April
729,BLUE TOILET BLOCKS DOUBLE,PIECE,9,5000,38136,6864,45000,April
892,BUSHENYI HONEY 90G,PIECE,9,3500,26695,4805,31500,April
939,CADBURY DAIRY MILK MINT CRISP 80G,PIECE,9,8000,61017,10983,72000,April
946,CADBURY FRUIT & NUT 80G,PIECE,9,8000,61017,10983,72000,April
1131,CHINA GREEN TEA 50G,PIECE,9,5000,38136,6864,45000,April
1246,COLGATE CHARCOAL TWIN TOOTHBRUSH,PIECE,9,4000,30508,5492,36000,April
1254,COLGATE HERBAL 35G,PIECE,9,2500,19068,3432,22500,April
1424,D.L FIESTA SALTED CARAMEL,PIECE,9,4000,30508,5492,36000,April
2480,HACO RULER ORIGINAL,PIECE,9,2000,15254,2746,18000,April
2811,JESA VANILLA YOGHURT 250G,PIECE,9,2500,19068,3432,22500,April
2987,KAZIRE ORANGE,PIECE,9,2000,15254,2746,18000,April
3293,LATO MILK 250G,PIECE,9,12000,91525,16475,108000,April
3381,LIMOUSINE CHOCOLATE,PIECE,9,1500,11441,2059,13500,April
3560,MAGIC 1KG SACHET,PIECE,9,8500,64831,11669,76500,April
3946,MUKISA MANDAZI 1000,PIECE,9,1500,11441,2059,13500,April
3963,MUSA'S BAKERY COOKIES 360G,PIECE,9,5500,41949,7551,49500,April
4046,NESCAFE CLASSIC 50G,PIECE,9,12000,91525,16475,108000,April
4742,PRINGLES ORIGINAL 165G BURSTING,PIECE,9,11111,84746,15254,100000,April
4963,RIHAM VANILLA CREAMYCRUNCH,PIECE,9,3000,22881,4119,27000,April
5023,ROYCO CHICKEN 60G,PIECE,9,1200,9153,1647,10800,April
5333,SHUYA 330MM,PIECE,9,6000,45763,8237,54000,April
5366,SIMKA CHOC- VAN 300ML,PIECE,9,3500,26695,4805,31500,April
5802,SUNSEED OIL 1LTRS,PIECE,9,12000,91525,16475,108000,April
7296,BANANA JUICE 3000,PIECE,9,3000,22881,4119,27000,April
7593,COLGATE CHARCOAL 35G 2500,PIECE,9,2500,19068,3432,22500,April
7648,COCKROACH KILLING BAIT 5G,PIECE,9,999,7619,1372,8991,April
7812,FLAMINGO LEMON&HONEY 200G,PIECE,9,3500,26695,4805,31500,April
7831,7UP 500ML,PIECE,9,1500,11441,2059,13500,April
93,ALWAYS V.P EXTRA LONG,PIECE,10,6500,55085,9915,65000,April
636,BESSA MILLET DRINK 500MLS,PIECE,10,4500,38136,6864,45000,April
637,BESSA MILLET MALT DRINK 330ML,PIECE,10,3000,25424,4576,30000,April
918,C.B ROYAL MANGO 200ML,PIECE,10,4500,38136,6864,45000,April
1247,COLGATE CHILDREN 50MLS,PIECE,10,4500,38136,6864,45000,April
1421,D.L CHOCO NUT 70ML,PIECE,10,2500,21186,3814,25000,April
1430,D.L MINI FIESTA CARAMEL,PIECE,10,2500,21186,3814,25000,April
1462,DAIRY MILK TOP DECK 80G,PIECE,10,8000,67797,12203,80000,April
1487,DATES 5000,PIECE,10,5500,46610,8390,55000,April
1526,DENTAL FLOSS /PICKS,PIECE,10,2500,21186,3814,25000,April
1999,FACE TOWEL 1000,PIECE,10,1000,8475,1525,10000,April
2296,GEISHA ROSE&HONEY,PIECE,10,2500,21186,3814,25000,April
3190,KOOKSY STRAWBERRY 220ML,PIECE,10,2000,16949,3051,20000,April
3196,KOOKSY VANILLA 120MLS,PIECE,10,1000,8475,1525,10000,April
3553,MAGANJO SOYA RICE 1KGS,PIECE,10,7500,63559,11441,75000,April
3564,MAGIC 500G SACHET,PIECE,10,4500,38136,6864,45000,April
3566,MAGIC SACHET 45G,PIECE,10,500,4237,763,5000,April
3998,NAIL CUTTERS 1500,PIECE,10,1500,12712,2288,15000,April
4219,NUMA BUSHERA 2KG,PIECE,10,12000,101695,18305,120000,April
4252,NUTRO WAFERS VANILLA,PIECE,10,3500,29661,5339,35000,April
4597,PICK n PEEL MANGO 1LTR,PIECE,10,9500,80508,14492,95000,April
4813,PURE GLUCOSE BOX,PIECE,10,1000,8475,1525,10000,April
5025,ROYCO CUBES BEEF,PIECE,10,4000,33898,6102,40000,April
5289,SHOE BRUSHES 1500,PIECE,10,1500,12712,2288,15000,April
5597,SPLASH GUAVA 1LTR,PIECE,10,8000,67797,12203,80000,April
5759,SUMZ PUMPKIN SEEDS 50G,PIECE,10,2500,21186,3814,25000,April
6068,TOOTHPICK 1000,PIECE,10,1000,8475,1525,10000,April
6535,WEETABIX 225G,PIECE,10,8500,72034,12966,85000,April
6651,YOUR CHOICE SAUSAGES 500G,PIECE,10,17000,144068,25932,170000,April
6787,VEGETABLE RICE 3500,PIECE,10,4950,41949,7551,49500,April
7588,SUMZ CASHEW NUTS 75G,PIECE,10,7500,63559,11441,75000,April
7724,JAMIES DOUGHNUTS SMALL 6PCS,PIECE,10,3000,25424,4576,30000,April
7778,DAIMA MILK VANILLA 250ML,PIECE,10,2500,21186,3814,25000,April
901,C.B CHOCOLATE CHOCO CHIP 120ML,PIECE,11,2500,23305,4195,27500,April
1356,CREAMBELL MAGIC STRAW120ML,PIECE,11,2500,23305,4195,27500,April
1445,D.L VAN-STRAW 120ML,PIECE,11,2000,18644,3356,22000,April
1555,DETTOL LIQUID 50MLS,PIECE,11,4000,37288,6712,44000,April
1753,DOWNY VALLEY DEW 20ML,PIECE,11,700,6525,1175,7700,April
2072,FIDODIDO CHOCO-VAN 220ML,PIECE,11,2500,23305,4195,27500,April
2291,GEISHA LEMON&HONEY,PIECE,11,4000,37288,6712,44000,April
2720,JAMIES BROWN SALT BREAD 500G,PIECE,11,3000,27966,5034,33000,April
2797,JESA STRAW 250G YOGHURT,PIECE,11,2500,23305,4195,27500,April
2986,KAZIRE LEMON TEA,PIECE,11,2000,18644,3356,22000,April
3322,LATO YOG STRAWBERRY 100G,PIECE,11,1200,11186,2014,13200,April
3736,MIRINDA APPLE,PIECE,11,1500,13983,2517,16500,April
5332,SHUYA 280MM,PIECE,11,6000,55932,10068,66000,April
5521,SOFT CARE BABY WIPES,PIECE,11,7000,65254,11746,77000,April
5733,SUMZ CHOCOLATE COOKIES 200G,PIECE,11,4000,37288,6712,44000,April
5743,SUMZ CRUNCHY DADDIES 150G,PIECE,11,3000,27966,5034,33000,April
6384,VALUE MAX PREP RAZOR,PIECE,11,3500,32627,5873,38500,April
7859,TOFFEE 500,PIECE,11,500,4661,839,5500,April
454,BABY NIPPLES 700,PIECE,12,700,7119,1281,8400,April
731,BLUEBAND LOW FAT 100G,PIECE,12,2000,20339,3661,24000,April
943,CADBURY DREAM WHITE CREAMY 80G,PIECE,12,8000,81356,14644,96000,April
1253,COLGATE HERBAL 230G,PIECE,12,9500,96610,17390,114000,April
1259,COLGATE MAX-FRESH 130G,PIECE,12,6500,66102,11898,78000,April
1423,D.L FIESTA CLASSIC 100MLS,PIECE,12,3500,35593,6407,42000,April
1785,DURU NATURAL CARE,PIECE,12,4500,45763,8237,54000,April
1936,F.D CHOCOLATE MILK 250MLS,PIECE,12,2000,20339,3661,24000,April
2026,FANAKA GUAVA 500ML,PIECE,12,3500,35593,6407,42000,April
2028,FANSICKERS COCOA CREAM,PIECE,12,2500,25424,4576,30000,April
2033,FANTA FRUIT BLAST 350ML,PIECE,12,1000,10169,1831,12000,April
2428,GORILLO'S CHICKEN 150G,PIECE,12,2500,25424,4576,30000,April
2450,GRAPES 12000,PIECE,12,12000,122034,21966,144000,April
2719,JAMIES BROWN SALT BREAD 1KG,PIECE,12,5500,55932,10068,66000,April
2796,JESA PLAIN YOGHURT 500G,PIECE,12,3700,37627,6773,44400,April
3867,MOUSE &RAT TRAPS GREEN,PIECE,12,3000,30508,5492,36000,April
4082,NICE TOOTHBRUSH,PIECE,12,600,6102,1098,7200,April
4247,NUTRO TEA BISCUIT,PIECE,12,3500,35593,6407,42000,April
4341,OMO BLEACH REGULAR 70ML,PIECE,12,1200,12203,2197,14400,April
5214,SENSITIVE BABY WIPES,PIECE,12,7000,71186,12814,84000,April
5235,SESAME SNACKS,PIECE,12,5000,50847,9153,60000,April
5758,SUMZ POTATO CRISPS TASTY TOMATO12G,PIECE,12,600,6102,1098,7200,April
7378,SUMZ COATED PEANUTS CHILLI MASALA 150G,PIECE,12,3000,30508,5492,36000,April
49,AFIA APPLE 500ML,PIECE,13,3000,33051,5949,39000,April
51,AFIA MANGO 500MLS,PIECE,13,3000,33051,5949,39000,April
86,ALWAYS EXTRA LONG,PIECE,13,3500,38559,6941,45500,April
1278,COMB 500,PIECE,13,500,5508,992,6500,April
1358,CREAMBELL STRAW-VAN 120ML,PIECE,13,2500,27542,4958,32500,April
1527,DENTEX TOOTHBRUSH SOFT,PIECE,13,3500,38559,6941,45500,April
2288,GEISHA ALOEVERA &HONEY 125G,PIECE,13,2500,27542,4958,32500,April
3607,MARIKA ICING SUGAR 500G,PIECE,13,4000,44068,7932,52000,April
3964,MUSA'S COOKIES 180G,PIECE,13,3000,33051,5949,39000,April
4024,NATARAJ PENS,PIECE,13,700,7712,1388,9100,April
5095,SANTA LUCIA LUMACA,PIECE,13,5000,55085,9915,65000,April
5380,SIMKA VANILLA 230MLS,PIECE,13,2000,22034,3966,26000,April
5673,STONEY 350MLS,PIECE,13,1000,11017,1983,13000,April
7173,D.L FIESTA WHITE 70ML,PIECE,13,3000,33051,5949,39000,April
648,BIC SHEVARS,PIECE,14,1000,11864,2136,14000,April
1249,COLGATE DOUBLE ACTION,PIECE,14,4000,47458,8542,56000,April
1420,D.L CHOCO BOMB 70ML,PIECE,14,2500,29661,5339,35000,April
2292,GEISHA LEMON&HONEY 125G,PIECE,14,2500,29661,5339,35000,April
2302,GEISHA TRADITIONAL BLACK SOAP,PIECE,14,5500,65254,11746,77000,April
2825,JIB WATER 20LTRS REFILL,PIECE,14,8000,94915,17085,112000,April
3294,LATO MILK 400G,PIECE,14,19000,225424,40576,266000,April
3562,MAGIC 250G BUCKET,PIECE,14,4000,47458,8542,56000,April
3653,MELEX SIMSIM 170G 2000,PIECE,14,2000,23729,4271,28000,April
4465,PANASONIC AAA,PIECE,14,2000,23729,4271,28000,April
4953,RIHAM CREAMY STRAWBERRY,PIECE,14,1200,14237,2563,16800,April
5345,SILKEE DESIGNER SERVIETTES,PIECE,14,2500,29661,5339,35000,April
5761,SUMZ ROASTED NUTS 120G,PIECE,14,3000,35593,6407,42000,April
7120,JAMIES DADDIES 500G 10000,PIECE,14,10000,118644,21356,140000,April
7137,JAMIES COOKIES 2000,PIECE,14,2000,23729,4271,28000,April
7486,APPLES PACKED 11000,PIECE,14,11000,130508,23492,154000,April
7748,BAKEMATE LOVE 1500,PIECE,14,1500,17797,3203,21000,April
1252,COLGATE HERBAL 140G,PIECE,15,7500,95339,17161,112500,April
1265,COLGATE TOOTBRUSH,PIECE,15,2500,31780,5720,37500,April
1461,DAIRY MILK PLAIN 80G,PIECE,15,8000,101695,18305,120000,April
2728,JAMIES COCONUT BREAD 500G,PIECE,15,3000,38136,6864,45000,April
2802,JESA STRAWBERRY YOGHURT 500G,PIECE,15,3700,47034,8466,55500,April
2813,JESA VANILLA YOGHURT 500G,PIECE,15,3700,47034,8466,55500,April
3609,MARS CHOCOLATE,PIECE,15,3500,44492,8008,52500,April
4034,NEEK YOGHURT 1LTR,PIECE,15,7000,88983,16017,105000,April
4454,PAMPER 5 L.C PANTS,PIECE,15,9000,114407,20593,135000,April
4695,POULTRY VIENNAS 250G,PIECE,15,13000,165254,29746,195000,April
4696,POULTRY VIENNAS 500G,PIECE,15,21000,266949,48051,315000,April
5636,SQUISHY STRAWBERRY 200ML,PIECE,15,2000,25424,4576,30000,April
6288,U-FRESH MANGO,PIECE,15,700,8898,1602,10500,April
6936,JESA MIXED BERRY YOGHURT 500G,PIECE,15,3700,47034,8466,55500,April
7494,FRUIT VILLE TROPICAL,PIECE,15,3500,44492,8008,52500,April
7499,JAMIES SWEET CAKE WHOLESALE 500G,PIECE,15,2498,31754,5716,37470,April
55,AFIA WHITE GUAVA,PIECE,16,3000,40678,7322,48000,April
1094,CHAMPION A4 96 PAGES,PIECE,16,2000,27119,4881,32000,April
1245,COLGATE CHARCOAL GENTLE CLEAN,PIECE,16,7500,101695,18305,120000,April
2286,GEISHA ALOE VERA&HONEY,PIECE,16,4000,54237,9763,64000,April
3306,LATO PLAIN YOGHURT 500G,PIECE,16,3700,50169,9031,59200,April
4333,OMO 40G FRESH,PIECE,16,500,6780,1220,8000,April
5591,SPLASH APPLE 1LTR,PIECE,16,8000,108475,19525,128000,April
5879,SWEETS 300,PIECE,16,300,4068,732,4800,April
6272,UBISCO CREAMS VANILLA,PIECE,16,1000,13559,2441,16000,April
6894,SQUISHY JUICE APPLE,PIECE,16,2000,27119,4881,32000,April
7404,MELEX SIMSIM BALLS 250G,PIECE,16,5000,67797,12203,80000,April
7621,MINTORE X PLUS 500,PIECE,16,500,6780,1220,8000,April
7858,MOOISTE COCOA,PIECE,16,2500,33898,6102,40000,April
1255,COLGATE HERBAL 70G,PIECE,17,4500,64831,11669,76500,April
1267,COLGATE TOOTHBRUSH CHARCOAL,PIECE,17,2500,36017,6483,42500,April
1269,COLGATE TRIPLE ACTION 140G,PIECE,17,6500,93644,16856,110500,April
1486,DATES 3000,PIECE,17,3500,50424,9076,59500,April
2803,JESA TOFFEE 250G,PIECE,17,2500,36017,6483,42500,April
2952,KAKIRA SUGAR 2KG,PIECE,17,13059,188136,33864,222000,April
3318,LATO VANILLA YOGHURT 250ML,PIECE,17,2500,36017,6483,42500,April
3472,M&G HELLO BEARS PEN ERASE,PIECE,17,2500,36017,6483,42500,April
3610,MARSHMALLOW DELICIOUS ASSORTED 15G,PIECE,17,2000,28814,5186,34000,April
3690,MIKOSHI GREEN TEA,PIECE,17,6000,86441,15559,102000,April
5730,SUMZ COATED PEANUT 50G,PIECE,17,1200,17288,3112,20400,April
5882,SWEETS 700 BIG FIVE,PIECE,17,700,10085,1815,11900,April
832,BRITANIA SHORTCAKE BISCUITS,PIECE,18,2000,30508,5492,36000,April
1525,DENTAL FLOSS,PIECE,18,2500,38136,6864,45000,April
1568,DEXE BLACK HAIR SHAMPOO,PIECE,18,2000,30508,5492,36000,April
1941,F.D MANGO 400G,PIECE,18,2500,38136,6864,45000,April
2235,FRUITVILLE MANGO 500ML,PIECE,18,3500,53390,9610,63000,April
2716,JAMAA WHITE WASHING BAR,PIECE,18,6000,91525,16475,108000,April
2804,JESA TOFFEE YOGHURT 500G,PIECE,18,3700,56441,10159,66600,April
3378,LIGHTERS,PIECE,18,1000,15254,2746,18000,April
3737,MIRINDA APPLE 2LTR,PIECE,18,4500,68644,12356,81000,April
4700,POWERPLAY 400MLS,PIECE,18,2000,30508,5492,36000,April
4948,RIHAM CREAM CHOCOLATE,PIECE,18,1200,18305,3295,21600,April
5016,ROYCO BEEF 200G,PIECE,18,6000,91525,16475,108000,April
7050,MARSHMALLOW PALAZI 1500,PIECE,18,2000,30508,5492,36000,April
4348,ONER BERRIES 300ML,PIECE,19,1500,24153,4347,28500,April
4896,RED BULL 250MLS,PIECE,19,7000,112712,20288,133000,April
5593,SPLASH APPLES 150ML,PIECE,19,1500,24153,4347,28500,April
5735,SUMZ CORN CRAX 160G,PIECE,19,2500,40254,7246,47500,April
5741,SUMZ CRISPS FRUIT CHUTNEY,PIECE,19,1500,24153,4347,28500,April
6642,YOJUS APPLE DRINK,PIECE,19,1000,16102,2898,19000,April
7789,JAMIES DANISH BREAD@3500,PIECE,19,3500,56356,10144,66500,April
1964,F.D VANILLA 150G,PIECE,20,1800,30508,5492,36000,April
2089,FIDODIDO STRWABERRY 220ML,PIECE,20,2500,42373,7627,50000,April
3207,KOOKSY VANILLA STRAWBERRY 220ML,PIECE,20,2000,33898,6102,40000,April
5750,SUMZ GONJA CRISPS 160G,PIECE,20,5500,93220,16780,110000,April
5763,SUMZ ROASTED NUTS 60G,PIECE,20,1500,25424,4576,30000,April
6101,TOP UP 400G,PIECE,20,2000,33898,6102,40000,April
349,AZAM MALT 500MLS,PIECE,21,3000,53390,9610,63000,April
844,BROOKSIDE MILK 500ML,PIECE,21,2300,40932,7368,48300,April
1953,F.D STRAWBERRY 150G,PIECE,21,1800,32034,5766,37800,April
5477,SMILE PENS WAVE 500,PIECE,21,500,8898,1602,10500,April
5604,SPLASH MANGO JUICE 1LTR,PIECE,21,8000,142373,25627,168000,April
5635,SQUISHY FRUIT DRINK MANGO 200ML,PIECE,21,2000,35593,6407,42000,April
7826,JAMIES CINNAMON BREAD 500G,PIECE,21,3500,62288,11212,73500,April
713,BLUE BAND 100G,PIECE,22,2500,46610,8390,55000,April
2985,KAZIRE ALOEVERA,PIECE,22,1500,27966,5034,33000,April
5739,SUMZ CRISPS CHILLI 60G,PIECE,22,2500,46610,8390,55000,April
6798,CADBURY DAIRY MILK 35G,PIECE,22,4000,74576,13424,88000,April
7385,RIHAM X-ENERGY 320ML,PIECE,22,1500,27966,5034,33000,April
7426,JAMIES SWEET CAKE BREAD WHOLESALE 5000,PIECE,22,5000,93220,16780,110000,April
346,AZAM EMBE MANGO,PIECE,23,1500,29237,5263,34500,April
1959,F.D STRAWBERRY MILK 500MLS,PIECE,23,4000,77966,14034,92000,April
5625,SPRITE 2LTR,PIECE,23,5000,97458,17542,115000,April
5764,SUMZ SALT&VINEGAR 30G,PIECE,23,1500,29237,5263,34500,April
7745,CHOCOLATE 800,PIECE,23,800,15593,2807,18400,April
843,BROOKSIDE LEMON BISCUITS 450G,PIECE,24,5479,111441,20059,131500,April
1029,CARROT CAKE,PIECE,24,5000,101695,18305,120000,April
1444,D.L VANILLA CREAM 120MLS,PIECE,24,2000,40678,7322,48000,April
1969,F.D VANILLA FLAVOURED 250ML,PIECE,24,2000,40678,7322,48000,April
3335,LAVITA PINEAPPLE 320MLS,PIECE,24,1000,20339,3661,24000,April
3435,LUCOZADE 250MLS,PIECE,24,3000,61017,10983,72000,April
4615,PK CHEWING GUM 500,PIECE,24,500,10169,1831,12000,April
4936,RIBENA 1LTR,PIECE,24,10000,203390,36610,240000,April
5481,SNICKERS CHOCOLATE,PIECE,24,3500,71186,12814,84000,April
7808,PICNIK CHOCOLATE 10G,PIECE,24,1000,20339,3661,24000,April
348,AZAM MALT 300MLS,PIECE,25,1500,31780,5720,37500,April
2476,HABARI SALT BIG,PIECE,25,1000,21186,3814,25000,April
3315,LATO VANILLA 100G,PIECE,25,1200,25424,4576,30000,April
3433,LUCOZADE 1LTR,PIECE,25,10000,211864,38136,250000,April
3684,MIA GONJA 1000,PIECE,25,1000,21186,3814,25000,April
3944,MUKISA CAKE 2500,PIECE,25,2500,52966,9534,62500,April
4350,ONER MANGO 1LTR,PIECE,25,5000,105932,19068,125000,April
5367,SIMKA CHOCO BAR 100MLS,PIECE,25,2500,52966,9534,62500,April
5379,SIMKA VANILLA 120MLS,PIECE,25,1000,21186,3814,25000,April
5736,SUMZ CORN CRAX 80G,PIECE,25,1500,31780,5720,37500,April
5766,SUMZ TANGY LEMON CRISPS 30G,PIECE,25,1500,31780,5720,37500,April
849,BROOKSIDE STRAWBERRIES 250G,PIECE,26,3000,66102,11898,78000,April
1288,COMPACT NAPKINS,PIECE,26,3000,66102,11898,78000,April
2682,INDOMIE BEEF NOODLES 120G,PIECE,26,2000,44068,7932,52000,April
3323,LATO YOG STRAWBERRY 250G,PIECE,26,2500,55085,9915,65000,April
3744,MIRINDA ORANGE 500ML,PIECE,26,1500,33051,5949,39000,April
5753,SUMZ POTATO CRISP BBQ 30G,PIECE,26,1500,33051,5949,39000,April
6643,YOJUS MANGO 150ML,PIECE,26,1000,22034,3966,26000,April
7284,SUMZ SALT& VIEGAR,PIECE,26,600,13220,2380,15600,April
1961,F.D UHT MILK 2000,PIECE,27,2000,45763,8237,54000,April
3319,LATO VANILLA YOGHURT 500G,PIECE,27,3700,84661,15239,99900,April
6271,UBISCO CREAMS CHOCOLATE,PIECE,27,1000,22881,4119,27000,April
2498,HANKIES 3000,PIECE,28,3000,71186,12814,84000,April
3742,MIRINDA ORANGE 2LTRS,PIECE,28,4500,106780,19220,126000,April
7365,SUMZ BAGGIA 50G,PIECE,28,1500,35593,6407,42000,April
1946,F.D MIXED BERRIES 400G,PIECE,29,2500,61441,11059,72500,April
1949,F.D PLAIN YOGHURT 400G,PIECE,29,2500,61441,11059,72500,April
2342,GILLETTE BLUE2 PLUS,PIECE,29,2500,61441,11059,72500,April
2727,JAMIES COCONUT BREAD 1KG,PIECE,29,5500,135169,24331,159500,April
3299,LATO MILK PWDER STRAWBERRY 15G,PIECE,29,500,12288,2212,14500,April
5876,SWEETS 1000,PIECE,29,1000,24576,4424,29000,April
6280,UBISCO KREAMY CREAMS STRAWBERRY,PIECE,29,1000,24576,4424,29000,April
1931,EVERVESS,PIECE,30,1000,25424,4576,30000,April
1958,F.D STRAWBERRY FLAVOURED 250ML,PIECE,30,2000,50847,9153,60000,April
3059,KICK SNACKS BBQ BEEF 15G,PIECE,30,500,12712,2288,15000,April
3209,KOOKSY VAN-MANGO 120ML,PIECE,30,1000,25424,4576,30000,April
5050,SAFA TOMATO PASTE 70GM,PIECE,30,1500,38136,6864,45000,April
5634,SQUISHY FRUIT DRINK 200ML,PIECE,30,2000,50847,9153,60000,April
6876,"GREENS (NAKATI,DODO ETC)",PIECE,30.27,6596,169195,30455,199650,April
3188,KOOKSY STRAWBERRY 120ML,PIECE,31,1000,26271,4729,31000,April
3202,KOOKSY VANILLA CHOCOLATE 220ML,PIECE,31,2000,52542,9458,62000,April
3458,LUXURY TOILET PAPER,PIECE,31,600,15763,2837,18600,April
5859,SWEET IVORY PCS,PIECE,31,100,2627,473,3100,April
6816,BLUE BAND 250G,PIECE,31,5000,131356,23644,155000,April
1291,COMSOFT FACIAL WIPES 1000,PIECE,32,1000,27119,4881,32000,April
1431,D.L MINI FIESTA CLASSIC 70MLS,PIECE,32,2500,67797,12203,80000,April
1485,DATES 2000,PIECE,32,2000,54237,9763,64000,April
3221,KRYSTAL WATER 500ML,PIECE,32,1000,27119,4881,32000,April
4131,NIVANA WATER 1.5L,PIECE,32,1500,40678,7322,48000,April
5602,SPLASH MANGO 150ML,PIECE,32,1500,40678,7322,48000,April
5754,SUMZ POTATO CRISPS 180G,PIECE,32,5000,135593,24407,160000,April
7239,BEEF PILAU 20000,PIECE,32,5944,161186,29014,190200,April
7770,PREDATOR ENERGY 350ML,PIECE,32,2281,61864,11136,73000,April
6871,POSHO KG,PIECE,32.82,4509,125424,22576,148000,April
1484,DATES 1000,PIECE,33,1000,27966,5034,33000,April
1935,EXOTIC 320MLS,PIECE,33,1000,27966,5034,33000,April
3739,MIRINDA FRUITY,PIECE,33,1500,41949,7551,49500,April
647,BIC PENS,PIECE,34,700,20169,3631,23800,April
836,BROOKSIDE FRUIT STRAWBERRIES,PIECE,34,5500,158475,28525,187000,April
1607,DIVINE 300MLS,PIECE,34,2500,72034,12966,85000,April
3194,KOOKSY VAN-CHOC 120MLS,PIECE,34,1000,28814,5186,34000,April
3217,KREST 500MLS,PIECE,34,1500,43220,7780,51000,April
3729,MINUTEMAID BERRY BLAST 1LTR,PIECE,34,5000,144068,25932,170000,April
5435,SKY VIEW ORANGE 320ML,PIECE,34,1000,28814,5186,34000,April
5539,SOFTCARE SANITARY PADS,PIECE,34,3000,86441,15559,102000,April
5674,STONEY 500MLS,PIECE,34,1500,43220,7780,51000,April
1750,DOWNY FEEL LUX 20ML,PIECE,35,700,20763,3737,24500,April
3311,LATO STRAWBERRY YOGHURT 500G,PIECE,35,3700,109746,19754,129500,April
4965,RIHAM WATER 600ML,PIECE,35,1000,29661,5339,35000,April
5626,SPRITE 350MLS,PIECE,35,1000,29661,5339,35000,April
2812,JESA VANILLA YOGHURT 400G,PIECE,36,2500,76271,13729,90000,April
3214,KOPIKO BROWN COFFEE,PIECE,36,1500,45763,8237,54000,April
4534,PEPSI,PIECE,36,1500,45763,8237,54000,April
5091,SANTA LUCIA 450G,PIECE,36,5000,152542,27458,180000,April
6612,YAKET 1.5LTR,PIECE,36,1500,45763,8237,54000,April
1608,DIVINE 500MLS,PIECE,37,4000,125424,22576,148000,April
4717,PRESTIGE 250G,PIECE,37,4500,141102,25398,166500,April
4945,RIHAM COFFEE MALT,PIECE,37,1500,47034,8466,55500,April
5592,SPLASH APPLE 250MLS,PIECE,37,2000,62712,11288,74000,April
7165,ONER APPLE DRINK 1LTR,PIECE,37,5000,156780,28220,185000,April
2739,JAMIES HOT DOG BUNS 6PCS,PIECE,38,4000,128814,23186,152000,April
4236,NUTRO CHOCOLATE BISCUITS,PIECE,38,1200,38644,6956,45600,April
5436,SKYVIEW 320MLS,PIECE,38,1000,32203,5797,38000,April
6859,ROLEX NORMAL 2EGGS,PIECE,38,2500,80508,14492,95000,April
2684,INDOMIE NOODLES CHICKEN 120G,PIECE,40,2000,67797,12203,80000,April
3740,MIRINDA FRUITY 2LTR,PIECE,40,4500,152542,27458,180000,April
5369,SIMKA CHOC-VAN 230MLS,PIECE,40,2000,67797,12203,80000,April
5717,SUGAR 1KG,PIECE,40,6250,211864,38136,250000,April
5744,SUMZ DADDIES 75G 1000,PIECE,40,1500,50847,9153,60000,April
347,AZAM ENERGY DRINK 300MLS,PIECE,41,1500,52119,9381,61500,April
842,BROOKSIDE LEMON 250G,PIECE,41,3000,104237,18763,123000,April
1464,DAIRY TOP YOGHURT STRAWBERRY 250G,PIECE,41,1000,34746,6254,41000,April
2794,JESA MILK UHT 500ML,PIECE,42,2200,78305,14095,92400,April
5672,STING RED RUSH,PIECE,42,2000,71186,12814,84000,April
7279,JUICE 4000 500ml,PIECE,42,4000,142373,25627,168000,April
7554,AFIA LEMON 500ML,PIECE,42,3000,106780,19220,126000,April
2729,JAMIE'S COOKIE SCONES,PIECE,43,2000,72881,13119,86000,April
1169,CLASSIC G.B.K WHOLE MILK 500ML,PIECE,44,2200,82034,14766,96800,April
2234,FRUITVILLE GUAVA 500ML,PIECE,44,3500,130508,23492,154000,April
2799,JESA STRAW YOGHURT 400G,PIECE,44,2500,93220,16780,110000,April
3302,LATO MIXED BERRIES 250G,PIECE,44,3000,111864,20136,132000,April
3862,MOUNTAIN DEW,PIECE,44,1500,55932,10068,66000,April
4209,NOVIDA 500MLS,PIECE,44,1500,55932,10068,66000,April
6943,SUMZ POTATO CRISPS FRUIT CHUTNEY 12G,PIECE,44,600,22373,4027,26400,April
7073,SUMZ TANGY LEMON CRISPS 12G,PIECE,44,600,22373,4027,26400,April
7706,JAMIES MILK BREAD 500G,PIECE,44,3500,130508,23492,154000,April
7423,JAMIES COOKIES WHOLESALE 700,PIECE,45,700,26695,4805,31500,April
1134,CHOCOLATE 500,PIECE,46,500,19492,3508,23000,April
3747,MIRINDA PINEAPPLE 330ML,PIECE,46,1000,38983,7017,46000,April
4537,PEPSI MAX,PIECE,46,1000,38983,7017,46000,April
5355,SILVER PLATE 300,PIECE,46,300,11695,2105,13800,April
5749,SUMZ GONJA 90G CRISPS,PIECE,46,3000,116949,21051,138000,April
2085,FIDODIDO STRAW-VAN 120MLS,PIECE,47,1200,47797,8603,56400,April
3863,MOUNTAIN DEW 2LTR,PIECE,47,4500,179237,32263,211500,April
5748,SUMZ GONJA 40G,PIECE,48,1500,61017,10983,72000,April
7815,7UP 330ML,PIECE,48,1000,40678,7322,48000,April
4937,RIBENA 250MLS,PIECE,49,3000,124576,22424,147000,April
5090,SANTA LUCIA 250G,PIECE,49,2500,103814,18686,122500,April
655,BIG DADDY 300 SWEETS,PIECE,50,300,12712,2288,15000,April
2755,JAMIES SWEET CAKE BREAD 500G,PIECE,50,3000,127119,22881,150000,April
4535,PEPSI 2LTR,PIECE,50,4500,190678,34322,225000,April
5354,SILVER PLATE 1000,PIECE,51,1000,43220,7780,51000,April
1334,COVERTINA CHOCOLATE 500,PIECE,52,500,22034,3966,26000,April
1955,F.D STRAWBERRY 250G,PIECE,52,2500,110169,19831,130000,April
1966,F.D VANILLA 250G,PIECE,52,2500,110169,19831,130000,April
3743,MIRINDA ORANGE 330ML,PIECE,52,1000,44068,7932,52000,April
5810,SUNSHINE PLAIN FLAVOR,PIECE,52,500,22034,3966,26000,April
5864,SWEET PEPSI,PIECE,53,100,4492,808,5300,April
4956,RIHAM EXOTIC TAMARIND,PIECE,54,1000,45763,8237,54000,April
7647,SKY VIEW APPLE 320ML,PIECE,54,1000,45763,8237,54000,April
1960,F.D UHT 200ML MILK,PIECE,55,1000,46610,8390,55000,April
5671,STING,PIECE,55,2000,93220,16780,110000,April
2029,FANTA 2LTRS ORANGE,PIECE,56,5000,237288,42712,280000,April
2950,KAKIRA SUGAR 1KG,PIECE,56,6732,319492,57508,377000,April
3317,LATO VANILLA MILK 250MLS,PIECE,56,2000,94915,17085,112000,April
7139,SUMZ BBQ CRISPS 12G,PIECE,56,600,28475,5125,33600,April
7656,JAMIES MANDAZ 1000,PIECE,56,1000,47458,8542,56000,April
2070,FIDODIDO CHOCOLATE 120ML,PIECE,57,1200,57966,10434,68400,April
3285,LATO CHOCOLATE MILK 250MLS,PIECE,57,2000,96610,17390,114000,April
3327,LATO YOGHURT VANILLA 200G,PIECE,57,1000,48305,8695,57000,April
4045,NESCAFE CLASSIC 2G,PIECE,57,500,24153,4347,28500,April
5808,SUNSHINE CHICKEN FLAVOR,PIECE,57,500,24153,4347,28500,April
824,BRITANIA MILK BISCUIT,PIECE,59,500,25000,4500,29500,April
7278,JUICE 2000 300ML,PIECE,59,2025,101271,18229,119500,April
4575,PIAO PIAO TP ORIGINAL,PIECE,60,2000,101695,18305,120000,April
4616,PK CHEWING GUM BIG,PIECE,60,1000,50847,9153,60000,April
5368,SIMKA CHOC-VAN 120MLS,PIECE,62,1000,52542,9458,62000,April
5433,SKY VIEW FRUITII 320ML,PIECE,62,1000,52542,9458,62000,April
5375,SIMKA STRAW-VAN 230MLS,PIECE,63,2000,106780,19220,126000,April
7130,JAMIES MUFFINS 2000,PIECE,63,2000,106780,19220,126000,April
4208,NOVIDA 350MLS,PIECE,64,1000,54237,9763,64000,April
6464,VIGOS HAZELNUT CHOCOLATE 800,PIECE,64,800,43390,7810,51200,April
7431,JAMIES MARBLE CAKE 10000,PIECE,64,10000,542373,97627,640000,April
7144,JAMIES DOUGHNUT BIG CHOCOLATE 2500,PIECE,65,2500,137712,24788,162500,April
1855,EGGS PIECES,PIECE,66,500,27966,5034,33000,April
3723,MINUTE MAID BERRY BLAST 400MLS,PIECE,66,2500,139831,25169,165000,April
4888,REBEX RICH MILK STICK BISCUITS,PIECE,66,1200,67119,12081,79200,April
5627,SPRITE 500MLS,PIECE,67,1500,85169,15331,100500,April
6695,JAMIES CAKE SLICE @6k,PIECE,69,6000,350847,63153,414000,April
6613,YAKET 550ML,PIECE,70,500,29661,5339,35000,April
3326,LATO YOGHURT STRAWBERRY 400G,PIECE,71,2500,150424,27076,177500,April
1221,COCACOLA 2LTRS,PIECE,72,5000,305085,54915,360000,April
2203,FRESH DAIRY MILK UHT 500ML,PIECE,72,2000,122034,21966,144000,April
3721,MINUTE MAID 1LTRS,PIECE,72,5000,305085,54915,360000,April
1967,F.D VANILLA 400G,PIECE,73,2500,154661,27839,182500,April
3324,LATO YOGHURT 400G VANILLA,PIECE,74,2500,156780,28220,185000,April
5180,SCOURER 1000,PIECE,74,1000,62712,11288,74000,April
1957,F.D STRAWBERRY 450G,PIECE,75,3700,235169,42331,277500,April
2761,JAMIES SWEET YELLOW BREAD 500G,PIECE,76,3000,193220,34780,228000,April
3310,LATO STRAWBERRY MILK 250MLS,PIECE,78,2000,132203,23797,156000,April
6572,WHITE STAR SOAP 1KG,PIECE,78,6833,451695,81305,533000,April
7425,JAMIES QUEEN CAKES WHOLESALE 2500,PIECE,78,2500,165254,29746,195000,April
7587,ONER TAMARIND 300ML,PIECE,78,1500,99153,17847,117000,April
4248,NUTRO VANILLA 30G,PIECE,79,1200,80339,14461,94800,April
7397,JAMIES SWEET YELLOW 500G WHOLE SALE 2500,PIECE,79,2500,167373,30127,197500,April
5811,SUNSHINE TOMATO FLAVOR,PIECE,80,500,33898,6102,40000,April
2514,HARMONY POT WATER 1LTR,PIECE,81,2000,137288,24712,162000,April
4536,PEPSI 330ML,PIECE,82,1000,69492,12508,82000,April
2683,INDOMIE NOODLES 70G,PIECE,83,1200,84407,15193,99600,April
7410,ONER TAMARIND 500ML,PIECE,83,2500,175847,31653,207500,April
1968,F.D VANILLA 450G,PIECE,85,3700,266525,47975,314500,April
2736,JAMIES COOKIES 4000,PIECE,85,4000,288136,51864,340000,April
5809,SUNSHINE ONION FLAVOR,PIECE,85,500,36017,6483,42500,April
2060,FAY TP,PIECE,87,2000,147458,26542,174000,April
826,BRITANIA MUNCHIES BISCUITS,PIECE,88,500,37288,6712,44000,April
6310,UKWAJU,PIECE,89,1500,113136,20364,133500,April
3296,LATO MILK CHOCOLATE 125ML FLAVOURED,PIECE,90,1000,76271,13729,90000,April
563,BALOON 300,PIECE,91,300,23136,4164,27300,April
2758,JAMIES SWEET WHITE BUNS 12PCS,PIECE,91,3500,269915,48585,318500,April
1956,F.D STRAWBERRY 400G,PIECE,92,2500,194915,35085,230000,April
2032,FANTA 500MLS,PIECE,92,1500,116949,21051,138000,April
7396,JAMIES SWEET WHITE WHOLESALE 500G 2500,PIECE,92,2500,194915,35085,230000,April
7790,JAMIES CINNAMON BREAD,PIECE,92,6000,467797,84203,552000,April
2805,JESA UHT FINO,PIECE,93,2000,157627,28373,186000,April
2031,FANTA 330MLS,PIECE,94,1000,79661,14339,94000,April
2427,GORILLO'S BBQ BEEF 24G,PIECE,95,500,40254,7246,47500,April
7143,GRAVY SOUP 1000,PIECE,96.16,993,80941,14569,95510,April
3361,LEMON CAKES 1000,PIECE,97,1200,98644,17756,116400,April
2754,JAMIES SWEET CAKE BREAD 1KG,PIECE,101,5500,470763,84737,555500,April
5356,SILVER PLATE 500,PIECE,101,500,42797,7703,50500,April
5603,SPLASH MANGO 250MLS,PIECE,101,2000,171186,30814,202000,April
6799,SPRING ROLLS VEGETABLE 1000,PIECE,103,1000,87288,15712,103000,April
3864,MOUNTAIN DEW 300MLS,PIECE,107,1000,90678,16322,107000,April
4984,ROCK BOOM 320MLS,PIECE,109,2000,184746,33254,218000,April
7398,JAMIES SWEET BROWN 500G WHOLE SALE 2500,PIECE,109,2500,230932,41568,272500,April
2740,JAMIES MANDAZ 8PCS,PIECE,114,3000,289831,52169,342000,April
5043,RWENZORI WATER 500ML,PIECE,114,1000,96610,17390,114000,April
5757,SUMZ POTATO CRISPS 90G,PIECE,115,3000,292373,52627,345000,April
7829,KICK PRINCESS CHICKEN FLAVOUR ,PIECE,115,500,48729,8771,57500,April
3309,LATO STRAWBERRY MILK 125MLS,PIECE,116,1000,98305,17695,116000,April
5807,SUNSHINE BEEF FLAVOR,PIECE,116,500,49153,8847,58000,April
6776,KEBAB 3000,PIECE,117,3000,297458,53542,351000,April
2763,JAMIES SWEET YELLOW BUNS 6PCS,PIECE,119,3500,352966,63534,416500,April
7142,JAMIES MARBLE CAKE 3000,PIECE,120,3000,305085,54915,360000,April
1963,F.D VANILLA 100G,PIECE,122,1200,124068,22332,146400,April
3741,MIRINDA FRUITY 330MLS,PIECE,122,1000,103390,18610,122000,April
5878,SWEETS 200,PIECE,123,200,20847,3753,24600,April
1223,COCACOLA 500MLS,PIECE,124,1500,157627,28373,186000,April
3316,LATO VANILLA 125ML MILK,PIECE,126,1000,106780,19220,126000,April
6813,GRILLED CHICKEN 7000,PIECE,127,7000,753390,135610,889000,April
2792,JESA MILK 1LTR,PIECE,131,3600,399661,71939,471600,April
2431,GORILLO'S CHILLI TOMATO 24G,PIECE,132,500,55932,10068,66000,April
2752,JAMIES SWEET BROWN BREAD 500G,PIECE,132,3000,335593,60407,396000,April
5374,SIMKA STRAW-VAN 120MLS,PIECE,132,1000,111864,20136,132000,April
7704,JAMIES MILK BREAD 5500,PIECE,132,6000,671186,120814,792000,April
1952,F.D STRAWBERRY 100G,PIECE,135,1200,137288,24712,162000,April
2681,INDOMIE BEEF 70G,PIECE,136,1200,138305,24895,163200,April
3738,MIRINDA APPLE 330ML,PIECE,138,1000,116949,21051,138000,April
4347,ONER APPLE JUICE DRINK,PIECE,138,2500,292373,52627,345000,April
7375,JAMIES WHOLE SALE SWEET BROWN 5000,PIECE,138,5000,584746,105254,690000,April
4351,ONER MANGO 500MLS,PIECE,145,2500,307203,55297,362500,April
6841,PIZZA CHICKEN SLICE BIG ,PIECE,145,6000,737288,132712,870000,April
7112,PUMPKIN SLICE 1000,PIECE,147,1000,124576,22424,147000,April
6784,LIVER STEW 8000,PIECE,148.2,7414,931186,167614,1098800,April
7374,JAMIES WHOLE SALE SWEET YELLOW 5000,PIECE,150,5000,635593,114407,750000,April
2748,JAMIES QUEEN CAKES 6PCS 3000,PIECE,151,3500,447881,80619,528500,April
2718,JAMIES BROWN BUNS 6PCS,PIECE,160,3500,474576,85424,560000,April
3298,LATO MILK POWDER 15G,PIECE,160,500,67797,12203,80000,April
7370,JAMIES SCONES WHOLESALE 1000,PIECE,160,1000,135593,24407,160000,April
1222,COCACOLA 350MLS,PIECE,162,1000,137288,24712,162000,April
2513,HARMONY POT WATER,PIECE,162,1000,137288,24712,162000,April
3325,LATO YOGHURT SRAWBERRY 200G,PIECE,163,1000,138136,24864,163000,April
4961,RIHAM ONER MANGO 300ml,PIECE,163,1500,207203,37297,244500,April
1286,COMFORT T.P 1000,PIECE,164,1000,138983,25017,164000,April
2757,JAMIES SWEET WHITE BREAD 500,PIECE,167,3000,424576,76424,501000,April
2759,JAMIES SWEET WHITE BUNS 6PCS,PIECE,168,3500,498305,89695,588000,April
6808,CRACKERS 1500,PIECE,170,2000,288136,51864,340000,April
5347,SILKEE JUMBO TP,PIECE,174,2000,294915,53085,348000,April
7650,JAMIES SWEET WHITE BUNS @4000,PIECE,180,4000,610169,109831,720000,April
4960,RIHAM ONER APPLE 300ML,PIECE,181,1500,230085,41415,271500,April
3725,Minute maid mango,PIECE,182,2500,385593,69407,455000,April
5756,SUMZ POTATO CRISPS 40G,PIECE,205,1500,260593,46907,307500,April
3060,KICK SNACKS CHICKEN,PIECE,207,500,87712,15788,103500,April
5881,SWEETS 500,PIECE,207,500,87712,15788,103500,April
2734,JAMIES DOUGH NUTS HUGE,PIECE,209,2000,354237,63763,418000,April
6971,SWEET POTATOES BOILED 1000,PIECE,209,1000,177119,31881,209000,April
182,APPLES GREEN,PIECE,214,1500,272034,48966,321000,April
5036,RWENZORI 1.5LTRS,PIECE,215,2000,364407,65593,430000,April
6970,YAM SLICE 1000,PIECE,220,1000,186441,33559,220000,April
6775,CHAPS 3000,PIECE,230,3000,584746,105254,690000,April
6773,VEGETABLE SAMOSA 1000,PIECE,255,1000,216102,38898,255000,April
7376,JAMIES WHOLE SALE SWEET WHITE 5000,PIECE,256,5000,1084746,195254,1280000,April
5875,SWEETS 100,PIECE,260,100,22034,3966,26000,April
6779,PILAO PLAIN 10000,PIECE,260.9,10000,2211017,397983,2609000,April
2751,JAMIES SWEET BROWN BREAD1KG,PIECE,267,5500,1244492,224008,1468500,April
6840,GONJA FRIED 1000,PIECE,273,1000,231356,41644,273000,April
5755,SUMZ POTATO CRISPS 20G,PIECE,278,600,141356,25444,166800,April
6781,VEGETABLE RICE 7000,PIECE,279.41,6773,1603856,288694,1892550,April
6807,BEAN STEW 2000,PIECE,287.8,1967,479661,86339,566000,April
6868,SPAGHETI 2500,PIECE,292.76,2472,613305,110395,723700,April
6790,KATOGO 4000,PIECE,299.05,3952,1001466,180264,1181730,April
7430,JAMIES SWEET YELLOW BUNS WHOLESALE 2500,PIECE,307,2500,650424,117076,767500,April
6820,BEEF SAMOSA 1500,PIECE,311,1500,395339,71161,466500,April
2760,JAMIES SWEET YELLOW BREAD 1KG,PIECE,349,5500,1626695,292805,1919500,April
7497,JAMIES SWEET BUNS BROWN 6PCS WHOLESALE,PIECE,362,2500,766949,138051,905000,April
6889,EGGS BOILED 500,PIECE,375,500,158898,28602,187500,April
7026,CHICKEN STEW 4000,PIECE,381,4000,1291525,232475,1524000,April
7727,JAMIES SWEET WHITE BUNS WHOLESALE,PIECE,397,2500,992500,0,992500,April
2429,GORILLO'S CHICKEN 24G,PIECE,423,500,179237,32263,211500,April
4128,NIVANA 500MLS,PIECE,447,500,189407,34093,223500,April
2744,JAMIES MUFFINS,PIECE,456,1500,579661,104339,684000,April
2756,JAMIES SWEET WHITE BREAD 1KG,PIECE,469,5500,2186017,393483,2579500,April
6792,CHIPS 2500,PIECE,480.18,2559,1041254,187426,1228680,April
6812,BEEF STEW 6000,PIECE,656,2012,1118644,201356,1320000,April
2735,JAMIES DOUGH NUTS SMALL 4000,PIECE,661,3000,1680508,302492,1983000,April
6805,PANCAKES 500,PIECE,721,500,305508,54992,360500,April
183,APPLES RED,PIECE,733,1500,931780,167720,1099500,April
2793,JESA MILK 500ML,PIECE,1155,1800,1761864,317136,2079000,April
6788,BEEF SAUSAGES 1000,PIECE,1733,1000,1468644,264356,1733000,April
6821,CHAPATI 1000,PIECE,2887,1000,2446610,440390,2887000,April
27,ABC DENT 70G,PIECE,1,2000,1695,305,2000,May
61,AFROCARE JELLY 100G,PIECE,1,3000,2542,458,3000,May
62,AFROCARE PERFUMED GLYCERINE,PIECE,1,2500,2119,381,2500,May
66,AKABANGA CHILI OIL 20ML,PIECE,1,2500,2119,381,2500,May
88,ALWAYS LONG,PIECE,1,4200,3559,641,4200,May
91,ALWAYS ULTRA THIN,PIECE,1,3500,2966,534,3500,May
98,AMARA ALOEVERA 400ML,PIECE,1,8500,7203,1297,8500,May
111,AMARA HYDRATING GLYCERINE 400ML LOTION,PIECE,1,8500,7203,1297,8500,May
115,AMARA RAW SHEA 200ML,PIECE,1,5500,4661,839,5500,May
118,AMARA REJUVENATING ALOE 200ML,PIECE,1,6000,5085,915,6000,May
123,AMERICAN GARDEN BBQ SAUCE 510G,PIECE,1,17000,14407,2593,17000,May
131,AMERICAN GARDEN MUSTARD 14OZ,PIECE,1,15000,12712,2288,15000,May
136,AMERICAN GREEN GARDEN HONEY 200G,PIECE,1,8000,6780,1220,8000,May
209,Ariel color and style,PIECE,1,8000,6780,1220,8000,May
211,ARIEL DOWNY 1KG,PIECE,1,15500,13136,2364,15500,May
212,ARIEL DOWNY 500G,PIECE,1,8000,6780,1220,8000,May
214,ARIEL LAVENDER 1KG,PIECE,1,15500,13136,2364,15500,May
218,ARMAF AIR FRESHNER SPRING,PIECE,1,10000,8475,1525,10000,May
245,ARMF BEAU SPLASH FOR MEN,PIECE,1,16000,13559,2441,16000,May
279,ASANTEE PAPAYA SOAP,PIECE,1,6500,5508,992,6500,May
312,AUNT PORRIDGE 2KG,PIECE,1,28000,23729,4271,28000,May
331,AXE DARK TEMPTATION,PIECE,1,12000,10169,1831,12000,May
371,"BABY BASIN 20,000",PIECE,1,20000,16949,3051,20000,May
383,BABY BOTTLE 092 6000,PIECE,1,6000,5085,915,6000,May
388,BABY BOTTLES 12000,PIECE,1,12000,10169,1831,12000,May
413,BABY CUPS 3000,PIECE,1,3000,2542,458,3000,May
421,BABY DOLL LONG 50000,PIECE,1,50000,42373,7627,50000,May
443,BABY JUNIOR JELLY 24ML,PIECE,1,700,593,107,700,May
447,BABY JUNIOR100g,PIECE,1,3500,2966,534,3500,May
450,BABY LOVE TOY 15000,PIECE,1,15000,12712,2288,15000,May
466,BABY RATTLES,PIECE,1,22000,18644,3356,22000,May
480,BABY SPOONS 10000,PIECE,1,10000,8475,1525,10000,May
497,BABY& ME BABYJELLY 240ML,PIECE,1,5000,4237,763,5000,May
526,BALLET ALOE VERA 120MLS,PIECE,1,5000,4237,763,5000,May
532,BALLET BABY LOTION 240ML,PIECE,1,12000,10169,1831,12000,May
545,BALLOON NUMBERS 1500,PIECE,1,1500,1271,229,1500,May
551,BALLS 12000,PIECE,1,12000,10169,1831,12000,May
590,BASKETS 5000,PIECE,1,5000,4237,763,5000,May
667,BIRTHDAY CROWNS 5000,PIECE,1,5000,4237,763,5000,May
688,BIYINZIKA STANDARD1.2KG,PIECE,1,25000,21186,3814,25000,May
724,BLUE LADY SPRAY,PIECE,1,15000,12712,2288,15000,May
740,BODY LUXE PETROLEUM JELLY,PIECE,1,4500,3814,686,4500,May
745,BODYLUXE JELLY 500G,PIECE,1,10000,8475,1525,10000,May
765,BOTTLES 12000,PIECE,1,12000,10169,1831,12000,May
766,BOTTLES 17000,PIECE,1,17000,14407,2593,17000,May
767,BOTTLES 10000,PIECE,1,10000,8475,1525,10000,May
768,BOTTLES 13000,PIECE,1,13000,11017,1983,13000,May
769,BOTTLES 15000,PIECE,1,15000,12712,2288,15000,May
771,BOTTLES 18000,PIECE,1,18000,15254,2746,18000,May
790,BOX FILES 6000,PIECE,1,7000,5932,1068,7000,May
817,BRITANIA BUTTER 1KG,PIECE,1,20000,16949,3051,20000,May
828,BRITANIA NICE BISCUITS 1KG,PIECE,1,20000,16949,3051,20000,May
866,BUCKET 7000,PIECE,1,7000,5932,1068,7000,May
873,BUCKETS CLEAR 3000,PIECE,1,3000,2542,458,3000,May
876,BUCKETS KENPOLY 20000,PIECE,1,20000,16949,3051,20000,May
884,BUGSTONE VEST 10000,PIECE,1,10000,8475,1525,10000,May
888,BUILDING BLOCKS GOOD PARTNER 18000,PIECE,1,18000,15254,2746,18000,May
907,C.B DOULBLES CHOCOLATE,PIECE,1,3000,2542,458,3000,May
941,CADBURY DAIRYMILK 10G CHOCOLATE,PIECE,1,1500,1271,229,1500,May
945,CADBURY DRINKING CHOCOLATE 450G,PIECE,1,22000,18644,3356,22000,May
1011,CAR TOYS 3000,PIECE,1,3000,2542,458,3000,May
1020,CARDS 2500,PIECE,1,2500,2119,381,2500,May
1025,CARPET BRUSH 7000,PIECE,1,7000,5932,1068,7000,May
1038,CASIO 401/991MS CALCULATOR,PIECE,1,45000,38136,6864,45000,May
1060,CELOTAPE BLACK,PIECE,1,1500,1271,229,1500,May
1062,CELOTAPE BROWN SMALL,PIECE,1,3000,2542,458,3000,May
1098,CHAPATI ROLLER 25000,PIECE,1,20000,16949,3051,20000,May
1108,CHASTITY RASASI SPRAY,PIECE,1,12000,10169,1831,12000,May
1163,CLAIRMEN CREAM 120ML,PIECE,1,7000,5932,1068,7000,May
1166,PICFARE GOLD 96PGS,PIECE,1,1000,847,153,1000,May
1182,CLEOS HOT SAUCE 125G,PIECE,1,3500,2966,534,3500,May
1186,CLERE BABY JELLY 100G,PIECE,1,3000,2542,458,3000,May
1199,CLIMAX EXOTIC TROPICAL FRUITS 170G,PIECE,1,6000,5085,915,6000,May
1235,COCONUT PRADIP,PIECE,1,4500,3814,686,4500,May
1279,COMB WITH MIRROR 1500,PIECE,1,1500,1271,229,1500,May
1306,CONTAINERS 3500,PIECE,1,5000,4237,763,5000,May
1348,COW&GATE 3 NUTRIJUNIOR,PIECE,1,44000,37288,6712,44000,May
1351,CRANE BOOK 96PGS,PIECE,1,1000,847,153,1000,May
1380,CUPS 7000,PIECE,1,7000,5932,1068,7000,May
1393,CUSSONS BABY OIL PINK 200MLS,PIECE,1,16000,13559,2441,16000,May
1397,CUSSONS BABY UNPERFUMED JELLY 200ML,PIECE,1,12000,10169,1831,12000,May
1420,D.L CHOCO BOMB 70ML,PIECE,1,2500,2119,381,2500,May
1441,D.L VANILLA 1LTR,PIECE,1,18000,15254,2746,18000,May
1446,D.L VAN-STRAW 1LTR,PIECE,1,18000,15254,2746,18000,May
1457,DAIRIES 12000,PIECE,1,12000,10169,1831,12000,May
1458,DAIRIES 17000,PIECE,1,15000,12712,2288,15000,May
1500,DEAR BODY THURSDAY BODY MIST,PIECE,1,16000,13559,2441,16000,May
1515,DEMICH SKIMMED MILK 500G,PIECE,1,16000,13559,2441,16000,May
1544,DETTOL EVENTONE 175G,PIECE,1,6500,5508,992,6500,May
1551,DETTOL HERBAL 175G,PIECE,1,6500,5508,992,6500,May
1553,DETTOL LIQUID 250 MLS,PIECE,1,15000,12712,2288,15000,May
1643,DOLL 4000,PIECE,1,4000,3390,610,4000,May
1644,DOLL 8000,PIECE,1,8000,6780,1220,8000,May
1655,DOLLS 8000 WANJU,PIECE,1,8000,6780,1220,8000,May
1656,DOLLS BABY 35000,PIECE,1,35000,29661,5339,35000,May
1659,DOLLS MOTHER 6000,PIECE,1,6000,5085,915,6000,May
1667,DOMS COLOUR PENCILS SHORT,PIECE,1,4000,3390,610,4000,May
1670,DOMS PENCILS A1 5000,PIECE,1,5000,4237,763,5000,May
1697,DOVE CUCUMBER&GREENTEA SHOWERGEL,PIECE,1,20000,16949,3051,20000,May
1703,DOVE GLOWINGRITUAL 750ML,PIECE,1,27000,22881,4119,27000,May
1709,DOVE INVIGORATING 750ML,PIECE,1,27000,22881,4119,27000,May
1715,DOVE MEN SOAP ULTRA,PIECE,1,7500,6356,1144,7500,May
1759,DRINKING CHOCOLATE 225G,PIECE,1,13000,11017,1983,13000,May
1772,DURU CARING MILK,PIECE,1,4500,3814,686,4500,May
1774,DURU DOLCE ALMOND,PIECE,1,4500,3814,686,4500,May
1776,DURU FLORAL INFUSION,PIECE,1,14000,11864,2136,14000,May
1783,DURU MISKET 4PCS,PIECE,1,16000,13559,2441,16000,May
1786,DURU NATURAL OLIVE 720G,PIECE,1,18000,15254,2746,18000,May
1799,DUSTBIN 7000,PIECE,1,7000,5932,1068,7000,May
1816,EAST AFRICAN HONEY 350G,PIECE,1,13000,11017,1983,13000,May
1820,EAST AFRICAN ORGANIC HONEY 450G,PIECE,1,12000,10169,1831,12000,May
1825,ECO STYLING GEL 236ML,PIECE,1,11000,9322,1678,11000,May
1840,EDEN BODY MILK 500ML,PIECE,1,25000,21186,3814,25000,May
1853,EGGS HALF TRAY,PIECE,1,7000,5932,1068,7000,May
1861,ELEGANCE COCOA BUTTER,PIECE,1,6000,5085,915,6000,May
1869,ELEGANT BLACK A.F,PIECE,1,7000,5932,1068,7000,May
1890,ELGON BLEND 250G,PIECE,1,14000,11864,2136,14000,May
1909,ENVELOPES 1000,PIECE,1,1000,847,153,1000,May
1938,F.D FLAVOURED MILK BOX46000,BOX,1,45000,38136,6864,45000,May
1948,F.D PLAIN 250G,PIECE,1,2500,2119,381,2500,May
1983,FA MEN ATTRACTION FORCE,PIECE,1,6500,5508,992,6500,May
1995,FA WHITENING & CARE,PIECE,1,6500,5508,992,6500,May
2002,FACE TOWEL 3000 WHITE,PIECE,1,3000,2542,458,3000,May
2011,FAMILY CARE 200G,PIECE,1,4500,3814,686,4500,May
2023,FAMILY TEA 250G,PIECE,1,7500,6356,1144,7500,May
2055,FAY FACIAL TISSUE WHITE,PIECE,1,4000,3390,610,4000,May
2114,FLYMEEGO VESTS 25000,PIECE,1,25000,21186,3814,25000,May
2123,FOGG ELEGANCE ROLLON,PIECE,1,8500,7203,1297,8500,May
2128,FOGG MARCO SPRAY,PIECE,1,18000,15254,2746,18000,May
2129,FOGG MASTER AGAR,PIECE,1,18500,15678,2822,18500,May
2130,FOGG MASTER CEDAR,PIECE,1,18500,15678,2822,18500,May
2131,FOGG MASTER OAK,PIECE,1,18500,15678,2822,18500,May
2135,FOGG PARADISE,PIECE,1,18000,15254,2746,18000,May
2136,FOGG ROYAL SPRAY,PIECE,1,18000,15254,2746,18000,May
2137,FOGG SPLENDID ROLLON,PIECE,1,8500,7203,1297,8500,May
2149,FOOD COLOUR BLACK,PIECE,1,1000,847,153,1000,May
2155,FOOD COLOUR PINK,PIECE,1,1000,847,153,1000,May
2184,FOUNTAIN PENS 2000,PIECE,1,2000,1695,305,2000,May
2263,GALAXY BLOOMING SPRAY,PIECE,1,12000,10169,1831,12000,May
2276,GARDEN FRESH 50G,PIECE,1,2000,1695,305,2000,May
2277,GARDEN FRESH TEA 100G,PIECE,1,4000,3390,610,4000,May
2280,GARDEN TEA 100G,PIECE,1,5000,4237,763,5000,May
2319,GIFT BAG FLORAL SMALL,PIECE,1,2000,1695,305,2000,May
2344,GIRL BIKE 8000,PIECE,1,8000,6780,1220,8000,May
2360,GLASSES 8000 PCS,PIECE,1,8000,6780,1220,8000,May
2393,GOLDEN CLING FILM 25000,PIECE,1,25000,21186,3814,25000,May
2551,HIGHWAY EAR BUDS,PIECE,1,2500,2119,381,2500,May
2559,HIT INSECT KILLER GREENTEA 275ML,PIECE,1,12000,10169,1831,12000,May
2608,HUGGIES 3 H.C,PIECE,1,58000,49153,8847,58000,May
2628,HUGGIES WIPES NATURAL CARE,PIECE,1,9000,7627,1373,9000,May
2658,IMPERIAL LEATHER MEN COOL 400L LOTION,PIECE,1,13000,11017,1983,13000,May
2668,IMPERIAL LEATHER UPLIFTING 400ML LOTION,PIECE,1,12000,10169,1831,12000,May
2674,INDOCAFE 100G,PIECE,1,17000,14407,2593,17000,May
2707,JAGO 500MLS,PIECE,1,10000,8475,1525,10000,May
2715,JAGO SCRUB 500G,PIECE,1,13000,11017,1983,13000,May
2768,JCJ HAND WRITING BOOK 2000,PIECE,1,2000,1695,305,2000,May
2783,JESA FLAVOURED MILK BOX,BOX,1,30000,25424,4576,30000,May
2796,JESA PLAIN YOGHURT 500G,PIECE,1,3700,3136,564,3700,May
2826,JIB WATER 20LTRS TAP NEW,PIECE,1,50000,42373,7627,50000,May
2932,"KABODY BABY BOOSTER,S.R WITH ENKEJJE",PIECE,1,6500,5508,992,6500,May
2934,KABODY COMPOSITE FLOUR,PIECE,1,6500,5508,992,6500,May
2943,KABODY QUICK PORRIDGE1KG,PIECE,1,6000,5085,915,6000,May
2945,KABODY SOYA PORRIDGE,PIECE,1,6000,5085,915,6000,May
2946,KABODY SOYA RICE 1KG,PIECE,1,6500,5508,992,6500,May
2948,KADIO CALCULATOR,PIECE,1,15000,12712,2288,15000,May
2956,KALARA CHILLI OIL 20ML,PIECE,1,2500,2119,381,2500,May
2960,KANGARO STAPLER DS-E335,PIECE,1,14000,11864,2136,14000,May
2999,KENPOLY LUNCH BOX,PIECE,1,5000,4237,763,5000,May
3049,KEY HOLDERS 2000,PIECE,1,2000,1695,305,2000,May
3050,KEY HOLDERS 2500,PIECE,1,2500,2119,381,2500,May
3051,KEY HOLDERS 3500,PIECE,1,3500,2966,534,3500,May
3054,KIBIMBA RICE IKG,PIECE,1,8000,6780,1220,8000,May
3071,KIDS BOXERS 6000,PIECE,1,6000,5085,915,6000,May
3087,KIDS VEST 3000,PIECE,1,3000,2542,458,3000,May
3090,KIDS VESTS CLEVER GOLD 20K,PIECE,1,20000,16949,3051,20000,May
3093,KIDS WATCHES 5000 GODLER,PIECE,1,5000,4237,763,5000,May
3100,KIMBO 500G,PIECE,1,7500,6356,1144,7500,May
3105,KINKIZI TEA 250G,PIECE,1,9000,7627,1373,9000,May
3113,KIRUNGI KAZI BOOSTER 280ML,PIECE,1,1000,847,153,1000,May
3119,KISUBI 85GM,PIECE,1,1500,1271,229,1500,May
3137,KIWI DARK TAN 32G,PIECE,1,4500,3814,686,4500,May
3159,KNIFE 3000,PIECE,1,3000,2542,458,3000,May
3184,KOOKSY MANGO V 500ML,PIECE,1,4500,3814,686,4500,May
3195,KOOKSY VAN-CHOC 500ML,PIECE,1,5000,4237,763,5000,May
3199,KOOKSY VANILLA 250ML,PIECE,1,3500,2966,534,3500,May
3200,KOOKSY VANILLA 500ML,PIECE,1,5000,4237,763,5000,May
3208,KOOKSY VANILLA STRAWBERRY 250ML,PIECE,1,3500,2966,534,3500,May
3219,KRISHNA MATCH BOX 1000,PIECE,1,1000,847,153,1000,May
3246,LA BELLE JELLY 250G,PIECE,1,6000,5085,915,6000,May
3278,LANZO MENTHOL SOAP,PIECE,1,4500,3814,686,4500,May
3289,LATO FLAVOURED 250ML 46000,PIECE,1,46000,38983,7017,46000,May
3388,LIQUID SOAP 1LTR 3000,PIECE,1,3000,2542,458,3000,May
3402,LONDON FACIAL WIPES,PIECE,1,3500,2966,534,3500,May
3404,LONG DUSTPAN 18OOO,PIECE,1,18000,15254,2746,18000,May
3406,LORD CROWN PERFUME,PIECE,1,10000,8475,1525,10000,May
3445,LUNCH BOX 42000,PIECE,1,42000,35593,6407,42000,May
3461,M&G CALCULATOR 20000,PIECE,1,20000,16949,3051,20000,May
3478,M&G MATHEMATICAL SET,PIECE,1,5000,4237,763,5000,May
3484,M&G PAPER CLIPS 1500,PIECE,1,1500,1271,229,1500,May
3486,M&G PUNCHING MACHINE,PIECE,1,15000,12712,2288,15000,May
3495,M&G STICKY NOTES 2000,PIECE,1,2000,1695,305,2000,May
3496,M&G STICKY NOTES PLAIN YELLOW,PIECE,1,2000,1695,305,2000,May
3597,MANUSCRIPT 3Q BOOK,PIECE,1,16000,13559,2441,16000,May
3621,MATHEMATICAL SET 3500 KYLIAN,PIECE,1,4000,3390,610,4000,May
3622,CAR TOY 15000,PIECE,1,15000,12712,2288,15000,May
3634,MELAMINE PLATES 5000,PIECE,1,5000,4237,763,5000,May
3667,MEN BOXERS 7000,PIECE,1,7000,5932,1068,7000,May
3709,MILO 100G,PIECE,1,11000,9322,1678,11000,May
3811,MOPPER PVA 35000,PIECE,1,35000,29661,5339,35000,May
3847,MOSQUITO NET 13000,PIECE,1,13000,11017,1983,13000,May
3858,MOTHERS PRIDE MILK BREAD 1KG,PIECE,1,5500,4661,839,5500,May
3871,MOVIT BABY JELLY 425g,PIECE,1,11000,9322,1678,11000,May
3872,MOVIT BABY JELLY 70g,PIECE,1,2000,1695,305,2000,May
3889,MOVIT FAMILY SOAP ALOE 230G,PIECE,1,4000,3390,610,4000,May
3912,MOVIT JELLY 110G,PIECE,1,3500,2966,534,3500,May
3917,MOVIT JELLY 85ML,PIECE,1,2000,1695,305,2000,May
3935,MOZZARELLA CHEESE 500G,PIECE,1,25000,21186,3814,25000,May
3947,MUKWANO BASIN 6000,PIECE,1,6000,5085,915,6000,May
3967,MUSAWO BODY JELLY,PIECE,1,2500,2119,381,2500,May
3973,MUSAWO SOAP 240G,PIECE,1,3000,2542,458,3000,May
4044,NESCAFE CLASSIC 200G,PIECE,1,29000,24576,4424,29000,May
4052,NEVIA PEARL&BEAUTY ROLLON,PIECE,1,11000,9322,1678,11000,May
4085,NICE&LOVELY ALOE 200ML,PIECE,1,6000,5085,915,6000,May
4100,NIGINA 10000,PIECE,1,10000,8475,1525,10000,May
4115,NISA CAMEL MILK CARROT SOAP,PIECE,1,5000,4237,763,5000,May
4118,NISA HAIR REMOVAL CUCUMBER 100ML,PIECE,1,10000,8475,1525,10000,May
4125,NISA ROSE HAIR REMOVAL CREAM 20ML,PIECE,1,2000,1695,305,2000,May
4134,NIVEA BLACK & WHITE 50ML,PIECE,1,11000,9322,1678,11000,May
4142,NIVEA DRY COMFORT ROLLON,PIECE,1,11000,9322,1678,11000,May
4148,NIVEA FRESH NATURAL ROLLON,PIECE,1,10000,8475,1525,10000,May
4158,NIVEA MEN DEEP ROLLON,PIECE,1,11000,9322,1678,11000,May
4177,NIVEA PROTECT&CARE BODY SPRAY,PIECE,1,16000,13559,2441,16000,May
4178,NIVEA REPAIR& CARE 72H 400ML,PIECE,1,19000,16102,2898,19000,May
4197,NOTE BOOK 3500,PIECE,1,3500,2966,534,3500,May
4272,NUVITA LEMON BISCUITS 750,PIECE,1,1500,1271,229,1500,May
4293,ODONIL DISINFECTANT,PIECE,1,7000,5932,1068,7000,May
4294,OFFICE GLUE 1KG,PIECE,1,7000,5932,1068,7000,May
4297,OFFICE POINT STICK GLUE,PIECE,1,2000,1695,305,2000,May
4312,OLD SPICE PURE SPORT63G,PIECE,1,20000,16949,3051,20000,May
4322,OLITALIA OLIVE OIL POMACE 250ML,PIECE,1,27000,22881,4119,27000,May
4330,OLIVE OIL SPRAY 85ML,PIECE,1,7500,6356,1144,7500,May
4345,OMO FAST ACTION 3.5KG,PIECE,1,40000,33898,6102,40000,May
4383,ORGANIC COCOABUTTER&SHEA BUTTER,PIECE,1,22000,18644,3356,22000,May
4463,PAMPERS WIPES COMPLETE CLEAN,PIECE,1,13500,11441,2059,13500,May
4466,PANASONIC BIG,PIECE,1,6000,5085,915,6000,May
4473,PANT PEG 5000,PIECE,1,5000,4237,763,5000,May
4499,PASSION STRAWBERRY,PIECE,1,16000,13559,2441,16000,May
4555,PETTI COT 5000,PIECE,1,5000,4237,763,5000,May
4568,"PHOTO ALBUMS HY,4R",PIECE,1,18000,15254,2746,18000,May
4573,PIANO TOYS 4000,PIECE,1,4000,3390,610,4000,May
4577,PICFARE 192 PAGES 6000,PIECE,1,6000,5085,915,6000,May
4578,PICFARE 2 QUIRE,PIECE,1,5000,4237,763,5000,May
4592,PICFARE SET,PIECE,1,6000,5085,915,6000,May
4602,PICK-UP POLICE CAR 13000,PIECE,1,13000,11017,1983,13000,May
4667,POPPER 7000,PIECE,1,7000,5932,1068,7000,May
4672,POTATO BABY BOTTLE P10675 18000,PIECE,1,18000,15254,2746,18000,May
4694,POULTRY VIENNAS 1KG,PIECE,1,36000,30508,5492,36000,May
4696,POULTRY VIENNAS 500G,PIECE,1,21000,17797,3203,21000,May
4713,PRESSOL HAIR GEL 125G,PIECE,1,5500,4661,839,5500,May
4720,PRICETAGS 1000,PIECE,1,1000,847,153,1000,May
4722,PRIDE DISH WASHING PASTE LIME 400G,PIECE,1,10000,8475,1525,10000,May
4733,PRINCESS ULTRA THIN,PIECE,1,3000,2542,458,3000,May
4735,PRINGLES BBQ 40G,PIECE,1,5500,4661,839,5500,May
4740,PRINGLES KETCHUP 165G,PIECE,1,11000,9322,1678,11000,May
4746,PRINGLES SOUR CREAM 165G,PIECE,1,12000,10169,1831,12000,May
4753,PRIVE INTERMAT BODYSPLASH,PIECE,1,15000,12712,2288,15000,May
4757,PRIVE MODA POUR FEMME,PIECE,1,15000,12712,2288,15000,May
4789,PUCELLE JOLLY RHYTHM 150MLS,PIECE,1,7500,6356,1144,7500,May
4799,PUCELLE WAVY OCEAN 150MLS,PIECE,1,7500,6356,1144,7500,May
4814,Pure soft facial wipes,PIECE,1,3000,2542,458,3000,May
4849,RAHA COCOA 100G,PIECE,1,8000,6780,1220,8000,May
4852,RAHA DRINKING CHOCOLATE 200G,PIECE,1,10000,8475,1525,10000,May
4859,RAKES 9000,PIECE,1,9000,7627,1373,9000,May
4871,RASPBERRY MIST PASSION,PIECE,1,16000,13559,2441,16000,May
4878,RAZAC HAND&BODY LOTION 20Z,PIECE,1,5000,4237,763,5000,May
4879,RAZAC HAND&BODY LOTION 40Z,PIECE,1,7500,6356,1144,7500,May
4882,RAZOR BLADE,PIECE,1,300,254,46,300,May
4889,RECEIPT BOOKS CARBONATED,PIECE,1,6000,5085,915,6000,May
4890,RECEIPT BOOKS NORMAL,PIECE,1,3000,2542,458,3000,May
4919,REXONA COTTON DRY,PIECE,1,5000,4237,763,5000,May
4934,RIBBONS 2500,PIECE,1,2500,2119,381,2500,May
4974,RINJU SHEA BUTTER 59ML,PIECE,1,5000,4237,763,5000,May
4976,RIOLA LUNCH BOX,PIECE,1,6000,5085,915,6000,May
4994,ROMANCE BODY SPRAY,PIECE,1,12000,10169,1831,12000,May
5007,ROTATRIM,PIECE,1,28000,23729,4271,28000,May
5013,ROYAL POUR HOMME BLACK,PIECE,1,12000,10169,1831,12000,May
5030,RUBEE LOTION 59ML,PIECE,1,5000,4237,763,5000,May
5059,SAF-INSTANT YEAST 500G,PIECE,1,16000,13559,2441,16000,May
5060,SAFISHA DISINFECTOR 200G,PIECE,1,7800,6610,1190,7800,May
5078,SAMONA HERBAL JELLY 150G,PIECE,1,5000,4237,763,5000,May
5086,SANDALS 5000,PIECE,1,5000,4237,763,5000,May
5087,SANDALS 6000,PIECE,1,6000,5085,915,6000,May
5105,SAPIL PINK NANCY,PIECE,1,15000,12712,2288,15000,May
5144,SAVANNAH COCOPINE 5LTR,PIECE,1,35000,29661,5339,35000,May
5145,SAVANNAH LEMON 3LTR,PIECE,1,22000,18644,3356,22000,May
5157,SAVLON 500MLS,PIECE,1,16000,13559,2441,16000,May
5166,SCHOOL BUS TOY,PIECE,1,10000,8475,1525,10000,May
5183,SCOURING PADS NICE CLEAN,PIECE,1,6000,5085,915,6000,May
5191,SCRUBBING HAND BRUSH 8000,PIECE,1,8000,6780,1220,8000,May
5198,SCRUBING HAND BRUSH 3000,PIECE,1,3000,2542,458,3000,May
5229,SERVING SPOONS 3000,PIECE,1,3000,2542,458,3000,May
5230,SERVING SPOONS 8000,PIECE,1,8000,6780,1220,8000,May
5253,SHAKERS 12000,PIECE,1,12000,10169,1831,12000,May
5255,SHAKERS 4000,PIECE,1,4000,3390,610,4000,May
5264,SHENKE COIL 4500,PIECE,1,4500,3814,686,4500,May
5281,SHIVA HONEY 250G,PIECE,1,8000,6780,1220,8000,May
5301,SHOWER 2 SHOWER CONFIDENT,PIECE,1,6000,5085,915,6000,May
5302,SHOWER CAPS,PIECE,1,2000,1695,305,2000,May
5303,SHOWER TO SHOWER HAPPY DAYS,PIECE,1,6000,5085,915,6000,May
5328,SHREEJI SHORTHAND BOOK,PIECE,1,2000,1695,305,2000,May
5361,SIMBA MBILI 200G,PIECE,1,9500,8051,1449,9500,May
5379,SIMKA VANILLA 120MLS,PIECE,1,1000,847,153,1000,May
5387,SKALA ALOEVERA CREAM 200G,PIECE,1,4000,3390,610,4000,May
5389,SKALA CARROT BODY CREAM,PIECE,1,4000,3390,610,4000,May
5390,SKALA CARROT LOTION 400ML,PIECE,1,6000,5085,915,6000,May
5395,SKALA PAPAYA LOTION,PIECE,1,6000,5085,915,6000,May
5399,SKIN CARE 100G,PIECE,1,3000,2542,458,3000,May
5402,SKIN CARE 250G,PIECE,1,6500,5508,992,6500,May
5408,SKIN DOCTOR HERBAL 250G,PIECE,1,7000,5932,1068,7000,May
5485,SO SOFT KITCHEN TOWEL,PIECE,1,8000,6780,1220,8000,May
5491,SOAP DISH 2000,PIECE,1,2000,1695,305,2000,May
5515,SOFT BROOM 15000,PIECE,1,15000,12712,2288,15000,May
5528,SOFTCARE BABY PANTS M44,PIECE,1,27000,22881,4119,27000,May
5557,SOSOFT BABY 2.5L,PIECE,1,29000,24576,4424,29000,May
5568,SOY SAUCE LIGHT 150G,PIECE,1,5000,4237,763,5000,May
5574,SPARKLING CANDLES 8000,PIECE,1,7000,5932,1068,7000,May
5575,SPARKLING CANDLES 9000,PIECE,1,9000,7627,1373,9000,May
5629,SQUEEZER 11000,PIECE,1,11000,9322,1678,11000,May
5632,SQUEEZERS METALLIC 14000,PIECE,1,14000,11864,2136,14000,May
5638,SSCHOOL SOCKS WHITE,PIECE,1,4000,3390,610,4000,May
5642,STA SOFT SPRINGFRESH 2LTR,PIECE,1,25000,21186,3814,25000,May
5651,STAR COFFEE 50G,PIECE,1,9000,7627,1373,9000,May
5662,STELAR 70MM,PIECE,1,20000,16949,3051,20000,May
5675,STONEY ZERO 350MLS,PIECE,1,1000,847,153,1000,May
5696,STRAWS 2500,PIECE,1,2500,2119,381,2500,May
5697,STREPSILS ORIGINAL,PIECE,1,1000,847,153,1000,May
5737,SUMZ CORN CRAX PKT 13000,PIECE,1,13000,11017,1983,13000,May
5782,SUNLIGHT DISHWASJING STRAWBERRY 400ML,PIECE,1,6500,5508,992,6500,May
5784,SUNLIGHT LAVENDER 1KG,PIECE,1,11000,9322,1678,11000,May
5792,SUNLIGHT SOAP 175G,PIECE,1,2500,2119,381,2500,May
5793,SUNLIGHT SPRING 3.5KG,PIECE,1,34000,28814,5186,34000,May
5796,SUNLIGHT TROPICAL 1KG,PIECE,1,11000,9322,1678,11000,May
5804,SUNSEED OIL 3LTRS,PIECE,1,28000,23729,4271,28000,May
5825,SUNTOUR SOCKS,PIECE,1,6000,5085,915,6000,May
5865,SWEET PEPSI PKT 2000,PIECE,1,2000,1695,305,2000,May
5923,TABLE KNIFE PIECES 3000,PIECE,1,3000,2542,458,3000,May
5952,TATE LYLE SUGAR 500G,PIECE,1,13000,11017,1983,13000,May
5959,TEAM VESTS 4000,PIECE,1,3000,2542,458,3000,May
5962,TEEPEE BRUSH A25,PIECE,1,3500,2966,534,3500,May
5995,TERRY BOY BOXERS 3PCS,PIECE,1,18000,15254,2746,18000,May
6047,TOILET BRUSH 6000,PIECE,1,6000,5085,915,6000,May
6049,TOILET BRUSH TEEPEE10000,PIECE,1,10000,8475,1525,10000,May
6053,TOILET PUMPS,PIECE,1,7000,5932,1068,7000,May
6057,TOMDECA VESTS,PIECE,1,25000,21186,3814,25000,May
6137,TOTOS VESTLINE JELLY 100G,PIECE,1,3000,2542,458,3000,May
6143,TOWELS 20000,PIECE,1,20000,16949,3051,20000,May
6149,TOY BIKES 8000,PIECE,1,8000,6780,1220,8000,May
6167,TREE CITY SHOWER GELS 2L,PIECE,1,25000,21186,3814,25000,May
6172,TRI-CIRCLE 263,PIECE,1,7500,6356,1144,7500,May
6187,TROPICAL HEAT BLACK PEPPER 50G,PIECE,1,5500,4661,839,5500,May
6189,TROPICAL HEAT CINNAMON 100G,PIECE,1,9500,8051,1449,9500,May
6191,TROPICAL HEAT CLOVE POWDER,PIECE,1,7500,6356,1144,7500,May
6192,TROPICAL HEAT CORIANDER 50G,PIECE,1,4500,3814,686,4500,May
6199,TROPICAL HEAT GARLIC POWDER 100G,PIECE,1,7000,5932,1068,7000,May
6202,TROPICAL HEAT GINGER 45G,PIECE,1,3500,2966,534,3500,May
6215,TROPICAL HEAT TEA MASALA 100G,PIECE,1,10000,8475,1525,10000,May
6219,TROPICAL HEAT WHITE PEPPER 50G,PIECE,1,8000,6780,1220,8000,May
6295,UGACHICK GRILLER 1KG,PIECE,1,24000,20339,3661,24000,May
6298,UGACHICK STARDARD 1.2KG,PIECE,1,27000,22881,4119,27000,May
6300,UGACHICK THIGHS 500G,PIECE,1,13000,11017,1983,13000,May
6314,ULTRASONIC PEST REPELLER,PIECE,1,15000,12712,2288,15000,May
6318,UMBRELLAS 8000,PIECE,1,8000,6780,1220,8000,May
6322,UMOJA SANDALS 6000,PIECE,1,7000,5932,1068,7000,May
6371,VACUUM BOTTLE 40000,PIECE,1,40000,33898,6102,40000,May
6398,VASELINE ALOESOOTHE LOTION 400ML,PIECE,1,14500,12288,2212,14500,May
6413,VASELINE DRY SKIN REPAIR LOTION 400ML,PIECE,1,15000,12712,2288,15000,May
6437,VENUS MOROCCAN ARGAN OIL LOTION 400ML,PIECE,1,10000,8475,1525,10000,May
6452,VESTLINE GARLIC 200G,PIECE,1,4000,3390,610,4000,May
6474,VINEGAR WHITE 700MLS,PIECE,1,2500,2119,381,2500,May
6484,VOYAGE DE LA PARIS SPLASH,PIECE,1,14000,11864,2136,14000,May
6493,WALMUS MUKENE SNACKS 7500,PIECE,1,8500,7203,1297,8500,May
6496,WANDAZ PETROLEUM JELLY 250G,PIECE,1,6000,5085,915,6000,May
6535,WEETABIX 225G,PIECE,1,8500,7203,1297,8500,May
6537,WEETABIX 450G,PIECE,1,15500,13136,2364,15500,May
6539,WEETABIX 900G,PIECE,1,27000,22881,4119,27000,May
6543,WEETABIX CORNFLAKES 250G,PIECE,1,12000,10169,1831,12000,May
6564,WHISPPEX SHAVERS,PIECE,1,3000,2542,458,3000,May
6588,WIG CAP HAIR NET,PIECE,1,1500,1271,229,1500,May
6612,YAKET 1.5LTR,PIECE,1,1500,1271,229,1500,May
6618,YARRISON BOXERS 3PCS 22000,PIECE,1,22000,18644,3356,22000,May
6619,YARRISON UNDER SHIRT 30000,PIECE,1,35000,29661,5339,35000,May
6663,ZERO PIMPLE SOAP 120G,PIECE,1,4000,3390,610,4000,May
6769,SUNLIGHT TROPICAL 2KG,PIECE,1,20000,16949,3051,20000,May
6782,CHICKEN STEW 8000,PIECE,1,8000,6780,1220,8000,May
6794,KATOGO 2500,PIECE,1,3000,2542,458,3000,May
6806,KIWI DARKTAN LEATHER 100ML,PIECE,1,7000,5932,1068,7000,May
6815,PENCILS 200,PIECE,1,200,169,31,200,May
6827,ELEGANT AIRFRESHNER LOUND,PIECE,1,7000,5932,1068,7000,May
6835,PREMIUM BLADE RAZOR 6PACK,PIECE,1,11000,9322,1678,11000,May
6850,PIZZA 14'' BEEF,PIECE,1,25000,21186,3814,25000,May
6901,DEAR BODY ANGEL BITTEN 250ML,PIECE,1,18000,15254,2746,18000,May
6905,CARPET BRUSH 10000,PIECE,1,10000,8475,1525,10000,May
6938,OMO BLEACH COLOUR SAFE 5LTR,PIECE,1,48000,40678,7322,48000,May
6983,STRIKE COCONUT CHOCOLATE BAR,PIECE,1,1000,847,153,1000,May
6991,GOLDER WHITE BOARD MARKER ,PIECE,1,1500,1271,229,1500,May
6995,DOMS WAX CRAYONS ,PIECE,1,2500,2119,381,2500,May
6999,CASIO SCIENTIFIC CALCULATORS WHITE ,PIECE,1,55000,46610,8390,55000,May
7003,M&G OFFICE SCISSORS 170MM,PIECE,1,4000,3390,610,4000,May
7007,ENERGIZER AA2 MAX ,PIECE,1,6000,5085,915,6000,May
7009,VENUS VITAMIN E 200ML LOTION,PIECE,1,6000,5085,915,6000,May
7019,WELLICE SHOWERGEL MILK,PIECE,1,23000,19492,3508,23000,May
7043,CHOPPING BOARDS 20000,PIECE,1,20000,16949,3051,20000,May
7051,KELLOGGS CORN FLAKES 750G ORIGINAL,PIECE,1,34000,28814,5186,34000,May
7062,"REXONA BODY SPRAYS TROPICAL,BIORYTHM,SHOWER FRESH 200ML",PIECE,1,13000,11017,1983,13000,May
7063,"AXE ICE CHILL, GOLD, ADRENALIN",PIECE,1,13000,11017,1983,13000,May
7094,NICE$LOVELY ALOEVERA 600ML,PIECE,1,15000,12712,2288,15000,May
7115,CLAIRMEN CREAM 300ML,PIECE,1,14000,11864,2136,14000,May
7148,HUGGIES DRY COMFORT PANTS 5JUMBO,PIECE,1,54000,45763,8237,54000,May
7160,PAWPAW OIL 60ML,PIECE,1,6000,5085,915,6000,May
7161,PRETTY WHITE OIL 60ML,PIECE,1,6000,5085,915,6000,May
7270,FRIED EGGS 5000,PIECE,1,2000,1695,305,2000,May
7277,DOUGHNUTS WHOLESALE 2500,PIECE,1,2500,2119,381,2500,May
7282,Downy vanilla&cashmere musk 880ml,PIECE,1,24000,20339,3661,24000,May
7289,TRIDENT CHEWING GUM,PIECE,1,6000,5085,915,6000,May
7306,MAVAL GIRL PANTY LINERS,PIECE,1,2500,2119,381,2500,May
7312,SAPIL SECRET ROMANCE 15000,PIECE,1,15000,12712,2288,15000,May
7319,ARMAF ENCHANTED ROMANCE AIR.F,PIECE,1,8000,6780,1220,8000,May
7328,MOSQUITO REPELLENT,PIECE,1,16000,13559,2441,16000,May
7330,SUMZ GONJA CRISP 400G,PIECE,1,12000,10169,1831,12000,May
7332,SWT-P 5KG,PIECE,1,40000,33898,6102,40000,May
7373,VASELINE BLUESEAL BABY 240ML,PIECE,1,9500,8051,1449,9500,May
7383,MOVIT BABY JELLY 200G,PIECE,1,5000,4237,763,5000,May
7406,COLGATE TOOTHBRUSH 6+,PIECE,1,6000,5085,915,6000,May
7411,PAMPERS PANTS 6,PIECE,1,40000,33898,6102,40000,May
7412,AMERICAN SHOWER GEL ROSE 1000ML,PIECE,1,18000,15254,2746,18000,May
7413,AMERICAN CROWN SHOWER GEL COCONUT JOY 1000ML,PIECE,1,18000,15254,2746,18000,May
7415,SHOWER GEL ALOEVERA 2L,PIECE,1,25000,21186,3814,25000,May
7438,YARRISON KIDS VESTS18000,PIECE,1,18000,15254,2746,18000,May
7446,DOWNY VALLEY DEW 1L 22000,PIECE,1,24000,20339,3661,24000,May
7454,MOPPER 3000,PIECE,1,3000,2542,458,3000,May
7455,CANDLE NUMBER BIG 3500,PIECE,1,3500,2966,534,3500,May
7491,C.B DOUBLES BLUEBERRY ICE CREAM,PIECE,1,2500,2119,381,2500,May
7500,KABODY BABY BODY IMMUNE BOOSTER,PIECE,1,7500,6356,1144,7500,May
7522,JUST WOW 250ML,PIECE,1,15000,12712,2288,15000,May
7523,SPARKING CANDLE 7000,PIECE,1,6000,5085,915,6000,May
7538,KIDS SHADES 2000,PIECE,1,2000,1695,305,2000,May
7541,MEN SOCKS 5500,PIECE,1,5500,4661,839,5500,May
7544,DOLLS 5000,PIECE,1,5000,4237,763,5000,May
7562,PAMPERS PANTS S5,PIECE,1,40000,33898,6102,40000,May
7563,NIVEA FRESH NATURAL,PIECE,1,16000,13559,2441,16000,May
7567,RIGGS DYNAMO,PIECE,1,16000,13559,2441,16000,May
7568,RIGGS VOYAGE,PIECE,1,16000,13559,2441,16000,May
7578,PRETTY STRAWBEERY GEL,PIECE,1,18000,15254,2746,18000,May
7579,PRETTY LAVENDER,PIECE,1,18000,15254,2746,18000,May
7600,NISA CARROT OIL LOTION 200ML,PIECE,1,8000,6780,1220,8000,May
7608,KOOKSY BLUEBERRY CHEESE CAKE 125ML,PIECE,1,3000,2542,458,3000,May
7612,HB PICFARE PENCIL 2500,PIECE,1,2500,2119,381,2500,May
7633,CLERE COCOA BUTTER 400ML,PIECE,1,8000,6780,1220,8000,May
7638,COSMO OUD GEL 480ML,PIECE,1,12000,10169,1831,12000,May
7652,HOT DOGS 3000,PIECE,1,3000,2542,458,3000,May
7667,SCHOOL SOCKS WHITE 6000,PIECE,1,6000,5085,915,6000,May
7689,CONTAINER AND BOTTLE 15000,PIECE,1,15000,12712,2288,15000,May
7693,HAND BRUSH 2500,PIECE,1,2500,2119,381,2500,May
7698,QUTIE FEEDING CUP 20000,PIECE,1,20000,16949,3051,20000,May
7708,FOGG DERMATOLOGICALLY TESTED ROLL 50ML,PIECE,1,8500,7203,1297,8500,May
7710,FOGG PINE SPRAY,PIECE,1,18000,15254,2746,18000,May
7711,RIGGS ARMOUR SPRAY 250ML,PIECE,1,16000,13559,2441,16000,May
7716,DOVE RELAXING JASMINE& COCONUT MILK GEL 500ML,PIECE,1,22000,18644,3356,22000,May
7718,BERTINI OLIVE OIL 100ML,PIECE,1,18000,15254,2746,18000,May
7725,JAMIES BRONCH BREAD 500G,PIECE,1,3500,2966,534,3500,May
7738,CUP GIFT 12000,PIECE,1,12000,10169,1831,12000,May
7750,TOYS 4000,PIECE,1,4000,3390,610,4000,May
7754,DOLL 10000,PIECE,1,10000,8475,1525,10000,May
7766,JAMIES CAKE 45000,PIECE,1,45000,38136,6864,45000,May
7776,SUMZ FRUIT CHUTNEY 60G,PIECE,1,3000,2542,458,3000,May
7780,VENUS MOROCCAN ARGAN OIL 200ML,PIECE,1,6000,5085,915,6000,May
7781,DOVE RESTORING CARE LOTION 400ML,PIECE,1,20000,16949,3051,20000,May
7785,JINBO NOTEBOOK 15000,PIECE,1,15000,12712,2288,15000,May
7787,BROOKSIDE MILK BOX 28000,PIECE,1,28000,23729,4271,28000,May
7795,TROPIKAL POWDER FRESH 12000,PIECE,1,12000,10169,1831,12000,May
7797,VERSMAN TRENDY 10000,PIECE,1,9500,8051,1449,9500,May
7798,NISA PAPAYA 200ML 8000,PIECE,1,8000,6780,1220,8000,May
7804,FACE MASK COFFEE 120ML 10000,PIECE,1,10000,8475,1525,10000,May
7818,ODEON CHARCOAL&TEA TREE 300ML,PIECE,1,11000,9322,1678,11000,May
7822,DOVE REVIVING GEL 500ML,PIECE,1,22000,18644,3356,22000,May
7832,FANEST BEEF SAUSAGES 500G,PIECE,1,13000,11017,1983,13000,May
7835,HURRICANE OCEAN FRESH 500ML,PIECE,1,9000,7627,1373,9000,May
7836,HURRICANE LEMON FRESH 500ML,PIECE,1,9000,7627,1373,9000,May
7846,HOBBY ROMANTIC HAND WASH 400ML,PIECE,1,7500,6356,1144,7500,May
7847,HOBBY PEACH& MANGO 400ML,PIECE,1,7500,6356,1144,7500,May
7849,ELEGANT LEGEND AF 300ML,PIECE,1,7000,5932,1068,7000,May
7852,OLD SPICE KRAKENGARD,PIECE,1,21000,17797,3203,21000,May
7854,COSMO COCONUT CRUSH GEL 1000ML,PIECE,1,18000,15254,2746,18000,May
7869,CLEAN SPONGE 5500,PIECE,1,5500,4661,839,5500,May
7872,DOVE INTENSE CARE LOTION 400ML,PIECE,1,18999,16101,2898,18999,May
7873,DOVE INVIGORATING CARE 400ML,PIECE,1,19000,16102,2898,19000,May
7874,DOVE RESTORING CARE 400ML,PIECE,1,19000,16102,2898,19000,May
7875,DOVE PAMPERING CARE 400ML,PIECE,1,19000,16102,2898,19000,May
7879,WEETABIX VANILLA 230G,PIECE,1,9500,8051,1449,9500,May
7884,ROKI COOKING OIL 1L,PIECE,1,8000,6780,1220,8000,May
7886,PAKA MATCH BOX,PIECE,1,1000,847,153,1000,May
7887,LIFEBUOY MOISTURE PLUS 175G,PIECE,1,6000,5085,915,6000,May
7892,NISA ROSE 50ML,PIECE,1,3500,2966,534,3500,May
7901,YULU CLASSIC BOXERS 3PCS 22000,PIECE,1,22000,18644,3356,22000,May
7902,NIVEA FRESH CHERRY ROLL ON ,PIECE,1,11000,9322,1678,11000,May
7903,BLUE BAND WITH CHOCO 500G,PIECE,1,11000,9322,1678,11000,May
7907,WEETABIX CORNFLAKES CRUNCHY 250G,PIECE,1,9500,8051,1449,9500,May
7909,ONER APPLE DRINK 200ML,PIECE,1,1000,847,153,1000,May
7910,ONER MANGO 200ML,PIECE,1,1000,847,153,1000,May
7911,RIHAM X ENERGY 400ML,PIECE,1,2000,1695,305,2000,May
7912,COSMO SHOWERGELS MIX VAN.STRAW.TROPICAL 1LTR,PIECE,1,20000,16949,3051,20000,May
6874,MUSHROOM STEW,PIECE,1.82,10000,15424,2776,18200,May
6,20LTR JERRICAN,PIECE,2,10000,16949,3051,20000,May
9,500MLS DISPOSABLE GLASSES,PIECE,2,6000,10169,1831,12000,May
18,7DAYS PANT LINERS,PIECE,2,4000,6780,1220,8000,May
26,ABC BABY WIPES,PIECE,2,9000,15254,2746,18000,May
36,ACTIVE WOMAN BODY SPRAY,PIECE,2,10000,16949,3051,20000,May
60,AFROCARE BODY LOTION 400ML,PIECE,2,6000,10169,1831,12000,May
63,AFROCARE PETROLEUM JELLY,PIECE,2,4500,7627,1373,9000,May
108,AMARA FOR MEN 400ML,PIECE,2,10000,16949,3051,20000,May
215,ARIEL ORIGINAL 1KG,PIECE,2,15500,26271,4729,31000,May
219,ARMAF AIR FRESHNER SUMMER,PIECE,2,10000,16949,3051,20000,May
311,AUNT PORRIDGE 1KG,PIECE,2,14000,23729,4271,28000,May
334,AXE MUSK,PIECE,2,13000,22034,3966,26000,May
343,AXION PASTE LIME,PIECE,2,6000,10169,1831,12000,May
455,BABY NIPPLES BIG 1000,PIECE,2,1000,1695,305,2000,May
523,BALLET ACTIVE VITAMIN 120MLS,PIECE,2,5000,8475,1525,10000,May
525,BALLET ALMOMD OIL 125ML,PIECE,2,9500,16102,2898,19000,May
571,BAMBOO TOOTHPICKS,PIECE,2,2500,4237,763,5000,May
612,BECCA COUNTER BOOKS 6500,PIECE,2,6500,11017,1983,13000,May
655,BIG DADDY 300 SWEETS,PIECE,2,300,508,92,600,May
686,BIYINZIKA MIXED PORTIONS 2KG,PIECE,2,37000,62712,11288,74000,May
687,BIYINZIKA MUCHOMO 1.5KG,PIECE,2,28000,47458,8542,56000,May
691,BIYINZIKA WINGS 500G,PIECE,2,11000,18644,3356,22000,May
773,BOTTLES 4000,PIECE,2,4000,6780,1220,8000,May
786,BOWLS 3000,PIECE,2,3000,5085,915,6000,May
820,BRITANIA DIGESTIVE 1KG,PIECE,2,20000,33898,6102,40000,May
822,BRITANIA GINGER 1KG,PIECE,2,20000,33898,6102,40000,May
833,BRITANIA SHORTCAKE BISCUITS 1KG,PIECE,2,20000,33898,6102,40000,May
851,BROOMS 1000,PIECE,2,1000,1695,305,2000,May
869,BUCKETS ANGEL 6500,PIECE,2,6500,11017,1983,13000,May
902,C.B CHOCOLATE CHOCO CHIPS 200ML,PIECE,2,5000,8475,1525,10000,May
904,C.B CLASSIC VANILLA 1LTR,PIECE,2,19500,33051,5949,39000,May
994,CANDLES 2400,PIECE,2,2500,4237,763,5000,May
1037,CASHO CALC,PIECE,2,15000,25424,4576,30000,May
1044,CB BUTTERSCOTCH 1LTR,PIECE,2,24000,40678,7322,48000,May
1054,CB MAGIC STRAW 500ML,PIECE,2,10000,16949,3051,20000,May
1068,CERELAC 7MONTHS MIXEDFRUITS,PIECE,2,27000,45763,8237,54000,May
1172,CLASSIC SHORTHAND NOTEBOOK,PIECE,2,2000,3390,610,4000,May
1176,CLEAR BAG 1000,PIECE,2,1000,1695,305,2000,May
1185,CLERE ALOEVERA 250G,PIECE,2,5000,8475,1525,10000,May
1187,CLERE BABY JELLY 250G,PIECE,2,5000,8475,1525,10000,May
1194,CLERE PETROLEUM JELLY100G,PIECE,2,3000,5085,915,6000,May
1202,CLIMAX TROPICAL FRUITS 50G,PIECE,2,2500,4237,763,5000,May
1213,CLOSEUP TRIPPLE FRESH 125G,PIECE,2,5000,8475,1525,10000,May
1239,COCOPULP CREME 100ML,PIECE,2,7500,12712,2288,15000,May
1264,COLGATE NATURAL EXTRACT 75MLS,PIECE,2,9000,15254,2746,18000,May
1280,COMB WITH MIRROR 2500,PIECE,2,2500,4237,763,5000,May
1394,CUSSONS BABY PERFUMED JELLY 200ML,PIECE,2,12000,20339,3661,24000,May
1413,CUTTERS 1500,PIECE,2,1500,2542,458,3000,May
1421,D.L CHOCO NUT 70ML,PIECE,2,2500,4237,763,5000,May
1431,D.L MINI FIESTA CLASSIC 70MLS,PIECE,2,2500,4237,763,5000,May
1437,D.L VAN.STRAW 250ML,PIECE,2,5000,8475,1525,10000,May
1450,DABUR HERBAL CLOVE 150G,PIECE,2,6000,10169,1831,12000,May
1488,"DEAR BODY ROCKING,CHIC",PIECE,2,17000,28814,5186,34000,May
1511,DELLA CHOCOLATE,PIECE,2,3000,5085,915,6000,May
1540,DETTOL ACTIVE 175G,PIECE,2,6500,11017,1983,13000,May
1554,DETTOL LIQUID 500ML,PIECE,2,23000,38983,7017,46000,May
1568,DEXE BLACK HAIR SHAMPOO,PIECE,2,2000,3390,610,4000,May
1569,DIANA LOTION 30ML,PIECE,2,4000,6780,1220,8000,May
1595,DISPOSABLE FORKS 2500,PIECE,2,4000,6780,1220,8000,May
1633,DOLBY SPORT SPRAY,PIECE,2,12000,20339,3661,24000,May
1641,DOLL 25000,PIECE,2,25000,42373,7627,50000,May
1653,DOLLS 2000,PIECE,2,2000,3390,610,4000,May
1666,DOMS COLOUR PENCILS LONG,PIECE,2,7000,11864,2136,14000,May
1688,DOUBLE REFINED SALT 650G,PIECE,2,7000,11864,2136,14000,May
1731,DOVE ROLL ON MIX,PIECE,2,11000,18644,3356,22000,May
1768,DURACELL AA ORIGINAL,PIECE,2,7000,11864,2136,14000,May
1779,DURU FRESH SENSATION 4PCS,PIECE,2,16000,27119,4881,32000,May
1877,ELEGANT JASMINE A.F,PIECE,2,7000,11864,2136,14000,May
1924,EUROTOP JUMBO T.P 2000,PIECE,2,2000,3390,610,4000,May
1934,EXCEL GLUCOSE 250G,PIECE,2,6500,11017,1983,13000,May
2006,FAMEN FRESHLY FREE,PIECE,2,6500,11017,1983,13000,May
2061,FEATHERS PADS REGULAR,PIECE,2,3000,5085,915,6000,May
2118,FOGG ABSOLUTE ROLLON,PIECE,2,8500,14407,2593,17000,May
2120,FOGG BOLD ROLLON 50MLS,PIECE,2,8500,14407,2593,17000,May
2177,FORTUNE GOLD 3LTR,PIECE,2,28000,47458,8542,56000,May
2205,FRESH DIARY LONG LIFE BOX,BOX,2,23000,38983,7017,46000,May
2281,GARDEN TEA 250,PIECE,2,14000,23729,4271,28000,May
2310,GIFT BAG 1500,PIECE,2,1500,2542,458,3000,May
2311,GIFT BAG 2500,PIECE,2,2500,4237,763,5000,May
2455,GREEN RIVER POWDER 5G,PIECE,2,1000,1695,305,2000,May
2569,HOBBY LIQUID SOAP GLISERIN'KIWI,PIECE,2,7500,12712,2288,15000,May
2721,JAMIES CAKE @70k,PIECE,2,70000,118644,21356,140000,May
2730,JAMIES CROCKDILE BREAD 1KG,PIECE,2,6000,10169,1831,12000,May
2803,JESA TOFFEE 250G,PIECE,2,2500,4237,763,5000,May
2804,JESA TOFFEE YOGHURT 500G,PIECE,2,3700,6271,1129,7400,May
2829,JIK COLOURS 1LTRS,PIECE,2,16000,27119,4881,32000,May
2936,KABODY MILLET SOYA PORRIDGE,PIECE,2,6500,11017,1983,13000,May
2937,KABODY MUKENE SOYA RICE1KG,PIECE,2,6000,10169,1831,12000,May
2942,KABODY PURE MILLET 1KG,PIECE,2,6000,10169,1831,12000,May
2992,KELLOGS CORNFLAKES 500g,PIECE,2,27000,45763,8237,54000,May
3078,KIDS PATRAS 3000,PIECE,2,3000,5085,915,6000,May
3084,KIDS TOOTH BRUSH 5000,PIECE,2,5000,8475,1525,10000,May
3144,KIWI SUEDE CLEANER BLACK,PIECE,2,7000,11864,2136,14000,May
3145,KIWI SUEDE CLEANER NEUTRAL,PIECE,2,7000,11864,2136,14000,May
3160,KNIFE 4000 KM7095,PIECE,2,5000,8475,1525,10000,May
3191,KOOKSY STRAWBERRY 500ML,PIECE,2,5000,8475,1525,10000,May
3236,KYOGERO HERBAL JELLY 250G,PIECE,2,7500,12712,2288,15000,May
3244,LA BELLE BABY JELLY 55G,PIECE,2,2000,3390,610,4000,May
3317,LATO VANILLA MILK 250MLS,PIECE,2,2000,3390,610,4000,May
3411,LOTUS TOOTHBRUSH EXPERT,PIECE,2,4000,6780,1220,8000,May
3525,MACDO TOMATO SAUCE SACHETS,PIECE,2,13000,22034,3966,26000,May
3548,MAGANJO PURE MILLET 1KG,PIECE,2,6500,11017,1983,13000,May
3561,MAGIC 1KG BUCKET,PIECE,2,12500,21186,3814,25000,May
3598,MANUSCRIPT BOOK 2Q,PIECE,2,12000,20339,3661,24000,May
3612,MASKING TAPE 2500,PIECE,2,2500,4237,763,5000,May
3626,MAYONNAISE BIG 887ML,PIECE,2,30000,50847,9153,60000,May
3653,MELEX SIMSIM 170G 2000,PIECE,2,2000,3390,610,4000,May
3657,MELEX SIMSIM BALLS 500,PIECE,2,2750,4661,839,5500,May
3748,MIRROR 1500,PIECE,2,1500,2542,458,3000,May
3888,MOVIT FAMILY SOAP ALOE 120G,PIECE,2,2500,4237,763,5000,May
3903,MOVIT HAIR FOOD 70G,PIECE,2,3000,5085,915,6000,May
3904,MOVIT HAIR FOOD AVACADO OIL 200G,PIECE,2,5500,9322,1678,11000,May
3906,MOVIT HERBAL JELLY 120G,PIECE,2,3500,5932,1068,7000,May
3939,MR.ZECO SWEETS,PIECE,2,300,508,92,600,May
3982,MWANA MUGIMU JELLY 200G,PIECE,2,6000,10169,1831,12000,May
4047,NESCAFE CLASSIC SACHETS 1.6G,PIECE,2,500,847,153,1000,May
4053,NEW FASHION RUBBER BANDS,PIECE,2,1000,1695,305,2000,May
4108,NIGINA SHOES 17000,PIECE,2,17000,28814,5186,34000,May
4119,NISA HAIR REMOVAL CUCUMBER 50ML,PIECE,2,7000,11864,2136,14000,May
4170,NIVEA MEN REVITALIZING 200ML,PIECE,2,15000,25424,4576,30000,May
4196,NOTE BOOK 3000,PIECE,2,3000,5085,915,6000,May
4198,NOTE BOOK 4000,PIECE,2,4000,6780,1220,8000,May
4207,NOVICOL WOOD GLUE,PIECE,2,5000,8475,1525,10000,May
4267,NUVITA GINGER BISCUITS 75G,PIECE,2,2000,3390,610,4000,May
4274,NUVITA ORANGE CREAM BISCUITS,PIECE,2,1500,2542,458,3000,May
4326,OLIVE OIL BODY WHIP 444ML,PIECE,2,28000,47458,8542,56000,May
4328,OLIVE OIL ORS SPRAY 472ML,PIECE,2,15000,25424,4576,30000,May
4344,OMO FAST ACTION 1KG,PIECE,2,12500,21186,3814,25000,May
4350,ONER MANGO 1LTR,PIECE,2,5000,8475,1525,10000,May
4416,OX FORD SETS 11000,PIECE,2,11000,18644,3356,22000,May
4431,PADLOCK 3500,PIECE,2,3500,5932,1068,7000,May
4434,PADLOCK 6000,PIECE,2,6000,10169,1831,12000,May
4442,PAMPER 2 H.C,PIECE,2,40000,67797,12203,80000,May
4500,PASSION WOODY OUD,PIECE,2,17000,28814,5186,34000,May
4511,PEGS 5000,PIECE,2,5000,8475,1525,10000,May
4513,PEGS DM 12000,PIECE,2,12000,20339,3661,24000,May
4546,PEPTANG KETCHUP 400G,PIECE,2,7500,12712,2288,15000,May
4590,PICFARE RULED PAPER BIG,PIECE,2,20000,33898,6102,40000,May
4695,POULTRY VIENNAS 250G,PIECE,2,13000,22034,3966,26000,May
4716,PRESTIGE 1KG,PIECE,2,14000,23729,4271,28000,May
4732,PRINCESS ULTRA PADS,PIECE,2,2700,4576,824,5400,May
4743,PRINGLES ORIGINAL 40G,PIECE,2,5500,9322,1678,11000,May
4748,PRIVE BLACK OPTION BODYSPLASH,PIECE,2,15000,25424,4576,30000,May
4751,PRIVE EYE CANDY PARFUM,PIECE,2,16000,27119,4881,32000,May
4760,PRIVE SENA POUR FEMME,PIECE,2,15000,25424,4576,30000,May
4764,PROCTOR&ALLAN CORNFLAKES 250G,PIECE,2,14000,23729,4271,28000,May
4784,PUCELLE ECCENTRIC BREEZE,PIECE,2,7250,12288,2212,14500,May
4819,PVC CLING FILM 45CM,PIECE,2,18000,30508,5492,36000,May
4820,QUAKER WHITE OATS,PIECE,2,13000,22034,3966,26000,May
4841,RADIANT OLIVE OIL HAIR SPRAY 100ML,PIECE,2,6500,11017,1983,13000,May
4897,RED COCK 2KG,PIECE,2,27000,45763,8237,54000,May
4903,RELAX TP,PIECE,2,1500,2542,458,3000,May
4935,RIBBONS 7500,PIECE,2,7500,12712,2288,15000,May
4955,RIHAM DIGESTIVE TIN,PIECE,2,18000,30508,5492,36000,May
4973,RINJU HAND&BODY CREAM 118ML,PIECE,2,18000,30508,5492,36000,May
4989,ROKI 5LTRS,PIECE,2,30000,50847,9153,60000,May
5024,ROYCO CUBE CHICKEN FLAVOUR,PIECE,2,5000,8475,1525,10000,May
5072,SALT SHAKERS 4000,PIECE,2,4000,6780,1220,8000,May
5077,SAMONA HERBAL JELLY 100G,PIECE,2,4000,6780,1220,8000,May
5088,SANDALS 7000,PIECE,2,7000,11864,2136,14000,May
5147,SAVANNAH MANGO 3LTR,PIECE,2,22000,37288,6712,44000,May
5151,SAVANNAH PINEAPPLE 2LTR,PIECE,2,18000,30508,5492,36000,May
5187,SCRATCHERS 1000,PIECE,2,1000,1695,305,2000,May
5209,SECRETS PADS,PIECE,2,4000,6780,1220,8000,May
5227,SERVING SPOON 2000,PIECE,2,2000,3390,610,4000,May
5269,SHENKE MOSQUITO COIL,PIECE,2,6000,10169,1831,12000,May
5293,SHOE BRUSHES 4000,PIECE,2,4000,6780,1220,8000,May
5304,SHOWER TO SHOWER INVISIBLE DRY,PIECE,2,6000,10169,1831,12000,May
5306,SHOWER TO SHOWER SENSITIVE,PIECE,2,6000,10169,1831,12000,May
5308,SHOWER TOSHOWER FRESH MORNING,PIECE,2,6000,10169,1831,12000,May
5314,SHOWERTOSHOWER FRESH DAWN,PIECE,2,6000,10169,1831,12000,May
5315,SHOWERTOSHOWER FRESH POWDER,PIECE,2,6000,10169,1831,12000,May
5360,SIMBA MBILI 100G,PIECE,2,7000,11864,2136,14000,May
5373,SIMKA PINE-VANILLA 120ML,PIECE,2,1000,1695,305,2000,May
5484,SO SOFT FRESH 2.5L,PIECE,2,28500,48305,8695,57000,May
5506,SOFINE MILK BRIGHTEN 1LTR,PIECE,2,20000,33898,6102,40000,May
5518,SOFT BROOMS 12000,PIECE,2,12000,20339,3661,24000,May
5523,SOFT PERFUME,PIECE,2,12000,20339,3661,24000,May
5527,SOFTCARE BABY PANTS L40,PIECE,2,27000,45763,8237,54000,May
5531,SOFTCARE M42 GOLD,PIECE,2,25000,42373,7627,50000,May
5558,SOSOFT BABY 750MLS,PIECE,2,11000,18644,3356,22000,May
5559,SOSOFT FRESH 750ML,PIECE,2,11000,18644,3356,22000,May
5597,SPLASH GUAVA 1LTR,PIECE,2,8000,13559,2441,16000,May
5605,SPLASH ORANGE 250ML,PIECE,2,2000,3390,610,4000,May
5618,SPOONS 10000 6PCS,PIECE,2,10000,16949,3051,20000,May
5631,SQUEEZERS DOULBLE 10000,PIECE,2,10000,16949,3051,20000,May
5649,STAR COFFEE 250G B. CHOICE,PIECE,2,10000,16949,3051,20000,May
5656,STA-SOFT LAVENDER 750ML,PIECE,2,12000,20339,3661,24000,May
5745,SUMZ DADDIES PKT 13000,PIECE,2,13000,22034,3966,26000,May
5794,SUNLIGHT SPRING IKG,PIECE,2,11000,18644,3356,22000,May
5813,SUNSIP APPLE 3LTRS,PIECE,2,16000,27119,4881,32000,May
5814,SUNSIP APPLE 5LTR,PIECE,2,24000,40678,7322,48000,May
5815,SUNSIP BLACKCURRANT 3LTR,PIECE,2,16000,27119,4881,32000,May
5823,SUNSIP STRAWBERRY 5LTRS,PIECE,2,24000,40678,7322,48000,May
5904,SWT CHENAB 2KG,PIECE,2,28000,47458,8542,56000,May
5964,TEEPEE BRUSH A9,PIECE,2,3000,5085,915,6000,May
5993,TENNIS BALL 2500,PIECE,2,3000,5085,915,6000,May
6045,TOILET BLUE BLOCKS 4PCS,PIECE,2,7500,12712,2288,15000,May
6051,TOILET BRUSHES METTALIC,PIECE,2,8000,13559,2441,16000,May
6139,TOTO'S VESTLINE JELLY 500G,PIECE,2,10000,16949,3051,20000,May
6186,TROPICAL HEAT BLACK PEPPER 100G,PIECE,2,8500,14407,2593,17000,May
6190,TROPICAL HEAT CINNAMON 50G,PIECE,2,4500,7627,1373,9000,May
6197,TROPICAL HEAT FISH MASALA 100G,PIECE,2,5000,8475,1525,10000,May
6208,TROPICAL HEAT PAPRIKA,PIECE,2,3500,5932,1068,7000,May
6210,TROPICAL HEAT PILAU MASALA 50G,PIECE,2,6000,10169,1831,12000,May
6217,TROPICAL HEAT TURMERIC 100G,PIECE,2,7000,11864,2136,14000,May
6288,U-FRESH MANGO,PIECE,2,700,1186,214,1400,May
6304,UGANDA SAFARI TEA 100G,PIECE,2,3500,5932,1068,7000,May
6308,UGANDA TEA BAGS 100BAGS,PIECE,2,9000,15254,2746,18000,May
6412,VASELINE DRY SKIN REPAIR 200ML,PIECE,2,8000,13559,2441,16000,May
6423,VASELINE MEN COOLING LOTION 200ML,PIECE,2,8000,13559,2441,16000,May
6468,VIM LAVENDER 1KG,PIECE,2,8000,13559,2441,16000,May
6497,WANDAZ PETROLEUM JELLY 500G,PIECE,2,11500,19492,3508,23000,May
6672,ZESTA MIXED FRUIT JAM,PIECE,2,7500,12712,2288,15000,May
6673,ZESTA MIXED FRUIT JAM 500G,PIECE,2,10500,17797,3203,21000,May
6676,ZESTA TOMATO KETCHUP,PIECE,2,7000,11864,2136,14000,May
6765,BIRTHDAY CANDLE 2K,PIECE,2,2000,3390,610,4000,May
6766,BIRTHDAY CANDLE 1500,PIECE,2,1500,2542,458,3000,May
6884,SAFA TOMATO KETCHUP 340G,PIECE,2,6000,10169,1831,12000,May
6959,S CONTROL HAIR TEXTURIZER 125ML,PIECE,2,5000,8475,1525,10000,May
7077,VASELINE BLUESEAL ALOEVERA 95ML,PIECE,2,5000,8475,1525,10000,May
7132,HUGGIES PANTS DRY COMFORT S.6,PIECE,2,32000,54237,9763,64000,May
7175,JAMIES LIQUID SOAP 3LTR,PIECE,2,3000,5085,915,6000,May
7317,PRIVE CRAZY GIRL 250ML,PIECE,2,14000,23729,4271,28000,May
7339,SOFTCARE GOLD S48,PIECE,2,25000,42373,7627,50000,May
7344,COMB 1000,PIECE,2,1000,1695,305,2000,May
7363,SUMZ PUMPKIN SEEDS 100G,PIECE,2,5000,8475,1525,10000,May
7400,NUTRO DIGESTIVE LIGHT 400G,PIECE,2,13000,22034,3966,26000,May
7419,Sandals,PIECE,2,8001,13561,2441,16002,May
7429,TROPICAL HEAT PAPRIKA SPICE 100G,PIECE,2,6000,10169,1831,12000,May
7485,JAMIES HOTDOG WHOLESALE 3000,PIECE,2,3000,5085,915,6000,May
7490,BIRTHDAY CANDLES STAR 4000,PIECE,2,4000,6780,1220,8000,May
7502,ISLAND BREEZE A.F LEMON 350ML,PIECE,2,7000,11864,2136,14000,May
7598,NISA ALOEVERA LOTION 200ML,PIECE,2,8000,13559,2441,16000,May
7613,CLEAR BAG 1500,PIECE,2,1500,2542,458,3000,May
7645,SOFTCARE GOLD XL36,PIECE,2,25000,42373,7627,50000,May
7719,SECRETS PADS ULTRA DAY&NIGHT PINK,PIECE,2,5500,9322,1678,11000,May
7762,PRINGLES PAPRIKA,PIECE,2,5500,9322,1678,11000,May
7765,PRINGLES PAPRIKA 165G,PIECE,2,12000,20339,3661,24000,May
7768,SOAP DISH 5000,PIECE,2,5000,8475,1525,10000,May
7774,SUMZ TANGY LEMON 60G,PIECE,2,3000,5085,915,6000,May
7820,REXONA STRESS CONTROL 200ML,PIECE,2,13000,22034,3966,26000,May
7839,RIGGS CHIEF 250ML,PIECE,2,16000,27119,4881,32000,May
7850,ELEGANT LUXURIOUS GOLD,PIECE,2,7000,11864,2136,14000,May
7855,OLYMPUS BLOSSOM 250ML,PIECE,2,16000,27119,4881,32000,May
7880,WEETABIX STRAWBERRY 230G,PIECE,2,9500,16102,2898,19000,May
7882,ELEGANT LADY BLUE A.F 300ML,PIECE,2,6500,11017,1983,13000,May
7889,DOVE GO FRESH ROLLON 48HR,PIECE,2,11000,18644,3356,22000,May
7905,SAFEGUARD LEMON SOAP,PIECE,2,1500,2542,458,3000,May
7906,SAFEGUARD PURE WHITE ,PIECE,2,1500,2542,458,3000,May
4,180ML DISPOSABLE GLASSES,PIECE,3,3000,7627,1373,9000,May
7,300MLS DISPOSABLE GLASSES,PIECE,3,5000,12712,2288,15000,May
15,7DAYS ANTIBACTERIAL BABY WIPES,PIECE,3,8500,21610,3890,25500,May
35,ACTIVE MAN SPRAY,PIECE,3,10000,25424,4576,30000,May
84,Always dreamzz,PIECE,3,3500,8898,1602,10500,May
103,AMARA COCOA BUTTER 200ML,PIECE,3,6000,15254,2746,18000,May
105,AMARA COCOA BUTTER LOTION 400ML,PIECE,3,8500,21610,3890,25500,May
127,AMERICAN GARDEN KETCHUP 425G,PIECE,3,13500,34322,6178,40500,May
146,AMLA HAIR OIL 100ML,PIECE,3,7000,17797,3203,21000,May
186,APTAMIL 1 400G,PIECE,3,52000,132203,23797,156000,May
208,ARIEL COLOR 1KG,PIECE,3,15502,39412,7094,46506,May
235,ARMAF SHADES FOR MEN,PIECE,3,16000,40678,7322,48000,May
270,ART BOOK BIG,PIECE,3,4000,10169,1831,12000,May
276,ART PENCILS 5B,PIECE,3,1000,2542,458,3000,May
340,AXION LEMON 200G,PIECE,3,6000,15254,2746,18000,May
350,B.D BALOON CHART,PIECE,3,3667,9322,1678,11000,May
442,BABY JUNIOR JELLY 200g,PIECE,3,6000,15254,2746,18000,May
454,BABY NIPPLES 700,PIECE,3,700,1780,320,2100,May
501,BABY&ME JELLY 120ML,PIECE,3,3000,7627,1373,9000,May
505,BACKPACK GREEN,PIECE,3,12000,30508,5492,36000,May
534,BALLET BABY OIL ALMOND 240ML,PIECE,3,14000,35593,6407,42000,May
536,BALLET BABY SOAP CALENDULA,PIECE,3,4000,10169,1831,12000,May
541,BALLET POWDER 100G,PIECE,3,5000,12712,2288,15000,May
690,BIYINZIKA THIGHS 500G,PIECE,3,10000,25424,4576,30000,May
712,BLUE 4 MEN SPRAY,PIECE,3,12000,30508,5492,36000,May
714,BLUE BAND 1KG,PIECE,3,19000,48305,8695,57000,May
915,C.B RIPPLES ORANGE 200ML,PIECE,3,4000,10169,1831,12000,May
918,C.B ROYAL MANGO 200ML,PIECE,3,4500,11441,2059,13500,May
981,CAMERA NIPPLES L,PIECE,3,1500,3814,686,4500,May
1015,CAR TOYS 6000,PIECE,3,6000,15254,2746,18000,May
1063,CELOTAPE MEDIUM,PIECE,3,5000,12712,2288,15000,May
1067,CERELAC 6MONTHS,PIECE,3,27000,68644,12356,81000,May
1189,CLERE FOR MEN ICE 250G,PIECE,3,6000,15254,2746,18000,May
1191,CLERE MEN ICE 100G,PIECE,3,2000,5085,915,6000,May
1244,COLGATE 0-2YEARS,PIECE,3,4000,10169,1831,12000,May
1248,COLGATE DEEP CLEAN,PIECE,3,1500,3814,686,4500,May
1263,COLGATE MAXIMUM CAVITY 70G,PIECE,3,4500,11441,2059,13500,May
1277,COMB 1500,PIECE,3,1500,3814,686,4500,May
1278,COMB 500,PIECE,3,500,1271,229,1500,May
1338,COVERTINA MILK CHOCOLATE,PIECE,3,3500,8898,1602,10500,May
1343,COW & GATE 1 400GM,PIECE,3,44000,111864,20136,132000,May
1391,CUSSONS BABY OIL 100MLS,PIECE,3,9000,22881,4119,27000,May
1412,CUTTERS 1000,PIECE,3,1000,2542,458,3000,May
1451,DABUR HERBAL MINT&LEMON,PIECE,3,6500,16525,2975,19500,May
1486,DATES 3000,PIECE,3,3500,8898,1602,10500,May
1526,DENTAL FLOSS /PICKS,PIECE,3,2500,6356,1144,7500,May
1538,DESSERT NOTE BOOK 4000,PIECE,3,4500,11441,2059,13500,May
1539,DETTOL 125MLS,PIECE,3,9000,22881,4119,27000,May
1550,DETTOL HERBAL 105G,PIECE,3,4500,11441,2059,13500,May
1557,DETTOL ORIGINAL 100G,PIECE,3,4500,11441,2059,13500,May
1773,DURU CUCUMBER,PIECE,3,4500,11441,2059,13500,May
1784,DURU MOUNTAINAIR SOAP,PIECE,3,14000,35593,6407,42000,May
1788,DURU OCEAN BREEZE SOAP,PIECE,3,14000,35593,6407,42000,May
1804,E.A HONEY 1LTR,PIECE,3,29000,73729,13271,87000,May
1908,ENVELOPE A4,PIECE,3,500,1271,229,1500,May
1974,FA CARRIEAN LEMON,PIECE,3,6500,16525,2975,19500,May
1975,FA DRY PROTECT,PIECE,3,6500,16525,2975,19500,May
2140,FOGG ULTIMATE ROLLON,PIECE,3,8500,21610,3890,25500,May
2152,FOOD COLOUR EGG YELLOW,PIECE,3,1000,2542,458,3000,May
2153,FOOD COLOUR GREEN,PIECE,3,1000,2542,458,3000,May
2176,FORTUNE GOLD 1LTR,PIECE,3,10000,25424,4576,30000,May
2375,GLUE STICK 21G,PIECE,3,2500,6356,1144,7500,May
2413,GOOD DAY CASHEW COOKIES,PIECE,3,2600,6610,1190,7800,May
2489,HAND SCRUBBING BRUSH 2000,PIECE,3,2000,5085,915,6000,May
2518,HARPIC ORIGINAL PLUS,PIECE,3,15000,38136,6864,45000,May
2598,HOT PEPPER POWDER,PIECE,3,4000,10169,1831,12000,May
2673,INDO CAFE 50G,PIECE,3,10000,25424,4576,30000,May
2922,JUMBO WAX CRAYONS,PIECE,3,5000,12712,2288,15000,May
2924,JUNSHENG COTTON SWABS,PIECE,3,2000,5085,915,6000,May
2944,KABODY RICE FLOUR 1KG,PIECE,3,6500,16525,2975,19500,May
3133,KIWI BLACK 80G,PIECE,3,8000,20339,3661,24000,May
3140,KIWI POLISH 12G,PIECE,3,2500,6356,1144,7500,May
3203,KOOKSY VANILLA CHOCOLATE 250ML,PIECE,3,3500,8898,1602,10500,May
3260,LABELLE HAIR FOOD 150G,PIECE,3,5000,12712,2288,15000,May
3275,LANZO ANTI-BACTERIAL SOAP,PIECE,3,4500,11441,2059,13500,May
3279,LANZO VANILLA SOAP,PIECE,3,3500,8898,1602,10500,May
3367,LET'S IMAGINE SPRAY,PIECE,3,12000,30508,5492,36000,May
3457,LUXURY CAR TISSUE,PIECE,3,4000,10169,1831,12000,May
3472,M&G HELLO BEARS PEN ERASE,PIECE,3,2500,6356,1144,7500,May
3526,MACRO DENTAL FLOSS,PIECE,3,3000,7627,1373,9000,May
3533,MAGANJO BABY SOYA 1KG,PIECE,3,6500,16525,2975,19500,May
3602,MARHABA AMLA OIL 160ML,PIECE,3,12000,30508,5492,36000,May
3606,MARIKA CORN FLOUR 400G,PIECE,3,5000,12712,2288,15000,May
3655,MELEX SIMSIM BALLS 1000,PIECE,3,1000,2542,458,3000,May
3669,MEN SOCKS 3500,PIECE,3,3500,8898,1602,10500,May
3855,MOTH BALLS 4000,PIECE,3,7000,17797,3203,21000,May
3887,MOVIT FAMILY SOAP 230G,PIECE,3,4000,10169,1831,12000,May
3891,MOVIT FAMILY SOAP COCOMUT 125G,PIECE,3,2500,6356,1144,7500,May
3902,MOVIT HAIR FOOD 120G,PIECE,3,3000,7627,1373,9000,May
3909,MOVIT HERBAL JELLY 50G,PIECE,3,1500,3814,686,4500,May
3930,MOVIT SOAP LEMON 120G,PIECE,3,2500,6356,1144,7500,May
3995,NACET BLADES 2500 PKT,PIECE,3,2500,6356,1144,7500,May
4001,NANA HERBAL MOUTH 60MLS,PIECE,3,7500,19068,3432,22500,May
4122,NISA HAIR REMOVAL ROSE 50ML,PIECE,3,7000,17797,3203,21000,May
4157,NIVEA MEN DEEP BLACK CARBON,PIECE,3,11000,27966,5034,33000,May
4201,NOTE BOOK SPIRAL 10000,PIECE,3,10000,25424,4576,30000,May
4245,NUTRO STRAW CREAM WAFERS,PIECE,3,3500,8898,1602,10500,May
4339,OMO BLEACH REGULAR,PIECE,3,8000,20339,3661,24000,May
4342,OMO COMFORT 1KG,PIECE,3,13000,33051,5949,39000,May
4363,ORAL-B TOOTHBRUSH,PIECE,3,3500,8898,1602,10500,May
4365,ORCHID VALLEY APPLE 1LTR,PIECE,3,7500,19068,3432,22500,May
4372,ORCHID VALLEY TROPICAL 1LTR,PIECE,3,7500,19068,3432,22500,May
4425,P.K GREEN BIG,PIECE,3,1000,2542,458,3000,May
4450,PAMPER 4 L.C PANTS,PIECE,3,9000,22881,4119,27000,May
4517,PELIKAN RUBBERS 1000,PIECE,3,1000,2542,458,3000,May
4520,PENCIL BAG 3500,PIECE,3,3500,8898,1602,10500,May
4540,PEPSODENT CAVITY FIGHTER 150G,PIECE,3,5000,12712,2288,15000,May
4580,PICFARE 4 QUIRE 10000,PIECE,3,10000,25424,4576,30000,May
4594,PICH n PEEL TROPICAL MIX 1LTR,PIECE,3,9500,24153,4347,28500,May
4644,PLATES CLAY 3000,PIECE,3,3500,8898,1602,10500,May
4739,PRINGLES HOT&SPICY 40G,PIECE,3,6000,15254,2746,18000,May
4787,PUCELLE FOR MY HEART,PIECE,3,7500,19068,3432,22500,May
4851,RAHA DRINKING CHOCOLATE 100G,PIECE,3,7000,17797,3203,21000,May
4943,RIHAM BUTTER COOKIES BISCUIT 1KG,PIECE,3,18000,45763,8237,54000,May
4990,ROKI OIL 1LTR,PIECE,3,10000,25424,4576,30000,May
5015,ROYALE BLUE SPRAY,PIECE,3,12000,30508,5492,36000,May
5018,ROYCO BEEF 500G,PIECE,3,12000,30508,5492,36000,May
5020,ROYCO BEEF 60G,PIECE,3,1200,3051,549,3600,May
5026,ROYCO CURRY+MCHUZI,PIECE,3,6500,16525,2975,19500,May
5053,SAFARI TEA 50G,PIECE,3,1500,3814,686,4500,May
5063,SAF-LEVURE 125G,PIECE,3,8500,21610,3890,25500,May
5170,SCHOOL SOCKS RED/GREEN YELLOW,PIECE,3,4000,10169,1831,12000,May
5176,SCISSORS 1500,PIECE,3,1500,3814,686,4500,May
5236,SESAME SNACKS 100G,PIECE,3,2500,6356,1144,7500,May
5260,SHARPENERS,PIECE,3,1000,2542,458,3000,May
5290,SHOE BRUSHES 2000,PIECE,3,2000,5085,915,6000,May
5324,SHREEJI GRAPH BOOK 96,PIECE,3,3000,7627,1373,9000,May
5400,SKIN CARE 150G,PIECE,3,4500,11441,2059,13500,May
5530,SOFTCARE L40,PIECE,3,25000,63559,11441,75000,May
5569,SOY SAUCE LIGHT 500G,PIECE,3,10000,25424,4576,30000,May
5613,SPONGES 2500,PIECE,3,2500,6356,1144,7500,May
5615,SPONGES WHITE 3000,PIECE,3,3000,7627,1373,9000,May
5668,STICK NOTES 8000,PIECE,3,8000,20339,3661,24000,May
5693,STRAWBERRY PRADIP COLORED,PIECE,3,5000,12712,2288,15000,May
5773,SUN SIP PASSION 3LTR,PIECE,3,16000,40678,7322,48000,May
5777,SUNLIGHT DISH LIQUID LEMON 400MLS,PIECE,3,7000,17797,3203,21000,May
5795,SUNLIGHT SPRING SENSATIONS 500G,PIECE,3,5500,13983,2517,16500,May
5819,SUNSIP MANGO 5LTR,PIECE,3,24000,61017,10983,72000,May
5852,SUPREME BAKING FLOUR,PIECE,3,9000,22881,4119,27000,May
5977,TEMMY'S CHOCO SCOOPS 250G,PIECE,3,11000,27966,5034,33000,May
6185,TROPICAL HEAT BEEF MASALA 100G,PIECE,3,5000,12712,2288,15000,May
6188,TROPICAL HEAT CHICKEN MASALA 100G,PIECE,3,5000,12712,2288,15000,May
6201,TROPICAL HEAT GINGER 100G,PIECE,3,7000,17797,3203,21000,May
6203,TROPICAL HEAT MEAT TENDERISER50G,PIECE,3,4000,10169,1831,12000,May
6239,TRUCK TOYS 12000,PIECE,3,12000,30508,5492,36000,May
6323,UMOJA SANDALS 8000,PIECE,3,10000,25424,4576,30000,May
6407,VASELINE COCOA GLOW 200ML,PIECE,3,8000,20339,3661,24000,May
6427,VASELINE MEN JELLY FRESH 240ML,PIECE,3,9500,24153,4347,28500,May
6548,WEETABIX OATIBIX 1KG,PIECE,3,18500,47034,8466,55500,May
6606,WRAPPERS 500,PIECE,3,500,1271,229,1500,May
6650,YOUR CHOICE SAUSAGE 1KG,PIECE,3,30000,76271,13729,90000,May
6817,BALLET BABY SOAP ALOEVERA,PIECE,3,4000,10169,1831,12000,May
6847,PIZZA 14'' CHICKEN ,PIECE,3,25000,63559,11441,75000,May
6848,PIZZA 16'' CHICKEN ,PIECE,3,35000,88983,16017,105000,May
6882,SUMZ FRIED PEAS,PIECE,3,2500,6356,1144,7500,May
6892,RAHA DRINKING CHOCOLATE 10G,PIECE,3,500,1271,229,1500,May
6987,DOMS CUBOID PEN ,PIECE,3,700,1780,320,2100,May
7036,SOAP DISH 3500,PIECE,3,3500,8898,1602,10500,May
7053,TREET SHAVER 1000,PIECE,3,1000,2542,458,3000,May
7120,JAMIES DADDIES 500G 10000,PIECE,3,10000,25424,4576,30000,May
7146,JAMIES COOKIES TIN 500G 10000,PIECE,3,10000,25424,4576,30000,May
7173,D.L FIESTA WHITE 70ML,PIECE,3,3000,7627,1373,9000,May
7346,LED TOUCH,PIECE,3,4000,10169,1831,12000,May
7393,HIKMA DADDIES 2000,PIECE,3,2000,5085,915,6000,May
7488,VERSMAN ACTIVE LOTION 400ML,PIECE,3,17000,43220,7780,51000,May
7554,AFIA LEMON 500ML,PIECE,3,3000,7627,1373,9000,May
7627,NIVEA MEN FRESH OCEAN 150ML,PIECE,3,16000,40678,7322,48000,May
7637,NISA ALOEVERA HAND&BODY LOTION 3000,PIECE,3,3000,7627,1373,9000,May
7723,JAMIES BROCRH BREAD 500G,PIECE,3,3500,8898,1602,10500,May
7742,RIHAM MILK&HONEY,PIECE,3,11000,27966,5034,33000,May
7761,LOVE HEART 2000,PIECE,3,2000,5085,915,6000,May
7819,KUZA INDIAN HEMP 113G,PIECE,3,22667,57627,10373,68000,May
7853,U BEATY GEL 1.8L,PIECE,3,20000,50847,9153,60000,May
7863,ORCHID VALLEY MANGO 250ML,PIECE,3,2000,5085,915,6000,May
7868,OMO HAMPER 25000,PIECE,3,25000,63559,11441,75000,May
7888,REXONA INVISIBLE DRY FRESH ROLLON 72JAM,PIECE,3,10000,25424,4576,30000,May
7891,NISA PAPAYA OIL 50ML,PIECE,3,3500,8898,1602,10500,May
7896,NUVITA CHOCO CHIP COOKIES 100GM,PIECE,3,2500,6356,1144,7500,May
113,AMARA MEN 400ML,PIECE,4,8625,29237,5263,34500,May
114,AMARA MEN COOLING,PIECE,4,6000,20339,3661,24000,May
277,ART PENCILS 6B,PIECE,4,1000,3390,610,4000,May
527,BALLET ALOE VERA JELLY 300MLS,PIECE,4,9500,32203,5797,38000,May
533,BALLET BABY MILK SOAP,PIECE,4,4000,13559,2441,16000,May
543,BALLET SHEA BUTTER SOAP,PIECE,4,3500,11864,2136,14000,May
570,BAMBOO TOOTHPICK 2500,PIECE,4,2500,8475,1525,10000,May
673,BIRTHDAY HATS 5000,PIECE,4,5000,16949,3051,20000,May
717,BLUE BAND LOW FAT,PIECE,4,6500,22034,3966,26000,May
776,BOTTLES 7000,PIECE,4,7000,23729,4271,28000,May
781,BOUNTY CHOCOLATE,PIECE,4,4000,13559,2441,16000,May
815,BRITANIA ASSORTED 1KG,PIECE,4,20000,67797,12203,80000,May
898,C' WARM CHOCOLATE,PIECE,4,500,1695,305,2000,May
914,C.B RIPPLES MIXED 200MLS,PIECE,4,4000,13559,2441,16000,May
1058,CELOTAPE 2000,PIECE,4,2500,8475,1525,10000,May
1059,CELOTAPE BIGGER 1OOOO,PIECE,4,10000,33898,6102,40000,May
1093,CHAMPION A4 200PAGES,PIECE,4,4000,13559,2441,16000,May
1095,CHAPA BAKING POWDER,PIECE,4,1500,5085,915,6000,May
1193,CLERE PETROLEUM JELLY 250G,PIECE,4,6000,20339,3661,24000,May
1256,COLGATE KIDS 2-5YEARS,PIECE,4,5000,16949,3051,20000,May
1257,COLGATE MAX FRESH 65G,PIECE,4,3500,11864,2136,14000,May
1270,COLGATE TRIPPLE ACTION 70G,PIECE,4,3500,11864,2136,14000,May
1358,CREAMBELL STRAW-VAN 120ML,PIECE,4,2500,8475,1525,10000,May
1384,CUPS STALLION 3000,PIECE,4,3000,10169,1831,12000,May
1389,CUSSON SOAP MILD&GENTLE,PIECE,4,3500,11864,2136,14000,May
1396,CUSSONS BABY UNPERFUMED JELLY 100ML,PIECE,4,5500,18644,3356,22000,May
1401,CUSSONS PERFUMED JELLY A&R 100ML,PIECE,4,5500,18644,3356,22000,May
1510,DELIDENT MAX 70G,PIECE,4,2000,6780,1220,8000,May
1559,DETTOL SENSITIVE 175G,PIECE,4,6500,22034,3966,26000,May
1560,DETTOL SKINCARE 175G,PIECE,4,6500,22034,3966,26000,May
1668,DOMS GEOMETRY SET,PIECE,4,8500,28814,5186,34000,May
1778,DURU FRESH SENSATION 4PC,PIECE,4,16000,54237,9763,64000,May
1987,FA MYSTIC MOMENTS,PIECE,4,6500,22034,3966,26000,May
1989,FA PINK PASSION ROLLON,PIECE,4,6500,22034,3966,26000,May
1993,FA SPORT ROLLON 50 ML,PIECE,4,6500,22034,3966,26000,May
2064,FEELINGS SPRAY,PIECE,4,12000,40678,7322,48000,May
2284,GARDEN TEA BAGS 100G,PIECE,4,6500,22034,3966,26000,May
2294,GEISHA MORINGA OIL 125G,PIECE,4,4000,13559,2441,16000,May
2315,GIFT BAG 4500,PIECE,4,4500,15254,2746,18000,May
2454,GREEN POLYTHENE,PIECE,4,300,1017,183,1200,May
2520,HARPIC POWER PLUS 500ML,PIECE,4,14750,50000,9000,59000,May
2657,IMPERIAL LEATHER MEN 175G,PIECE,4,4500,15254,2746,18000,May
2676,INDOCAFE CAPPUCCINO CREAMY,PIECE,4,3000,10169,1831,12000,May
2724,JAMIES CAKES @ 40K,PIECE,4,40000,135593,24407,160000,May
2769,JEE NAIL REMOVER,PIECE,4,1500,5085,915,6000,May
2781,JESA FINO BOX,BOX,4,24000,81356,14644,96000,May
2831,JIK REGULAR 250MLS,PIECE,4,6500,22034,3966,26000,May
2939,KABODY OATS SOYA RICE 1KG,PIECE,4,6500,22034,3966,26000,May
2947,KABODY WHITE OATS WITH RICE,PIECE,4,6000,20339,3661,24000,May
2962,KANGARO STAPLES,PIECE,4,2000,6780,1220,8000,May
3081,KIDS SOCKS 1500,PIECE,4,1500,5085,915,6000,May
3158,KNICKERS 9000,PIECE,4,9000,30508,5492,36000,May
3234,KYOGERO HERBAL JELLY 100ML,PIECE,4,3500,11864,2136,14000,May
3239,KYOGERO HERBAL SOAP 120G,PIECE,4,3500,11864,2136,14000,May
3277,LANZO COCONUT SHEA SOAP,PIECE,4,3500,11864,2136,14000,May
3499,M&G WHITE BOARD MARKER,PIECE,4,1500,5085,915,6000,May
3535,MAGANJO BABY SOYA WITH MILK 500G,PIECE,4,8500,28814,5186,34000,May
3538,MAGANJO CORNFLAKES,PIECE,4,10000,33898,6102,40000,May
3539,MAGANJO ENERGY BOOSTER 1KG,PIECE,4,6500,22034,3966,26000,May
3552,MAGANJO SOYA MILLET,PIECE,4,6500,22034,3966,26000,May
3840,MORTEIN LEMON 180ML,PIECE,4,15000,50847,9153,60000,May
3869,MOVIT BABY JELLY 110G,PIECE,4,3000,10169,1831,12000,May
4199,NOTE BOOK 5500,PIECE,4,5500,18644,3356,22000,May
4202,NOTE BOOK SPIRAL 9000,PIECE,4,9000,30508,5492,36000,May
4204,NOTEBOOK 6500,PIECE,4,6500,22034,3966,26000,May
4214,NTALE 100G,PIECE,4,4500,15254,2746,18000,May
4219,NUMA BUSHERA 2KG,PIECE,4,12000,40678,7322,48000,May
4222,NUMA RICE FLOUR 1KG,PIECE,4,7500,25424,4576,30000,May
4244,NUTRO ORANGE WAFFERS 150G,PIECE,4,6500,22034,3966,26000,May
4284,OATIBIX 500G,PIECE,4,12000,40678,7322,48000,May
4335,OMO BLEACH COLOUR SAFE 700ML.,PIECE,4,9000,30508,5492,36000,May
4336,OMO BLEACH LEMON,PIECE,4,8000,27119,4881,32000,May
4364,ORANGES 2000,PIECE,4,2500,8475,1525,10000,May
4370,ORCHID VALLEY PASSION 1LTR,PIECE,4,7000,23729,4271,28000,May
4444,PAMPER 2 L.C,PIECE,4,9000,30508,5492,36000,May
4447,PAMPER 3 L.C PANTS,PIECE,4,9000,30508,5492,36000,May
4484,PAPERLINE EXERCISE BK,PIECE,4,4000,13559,2441,16000,May
4588,PICFARE PENCILS 3000,PIECE,4,3000,10169,1831,12000,May
4591,PICFARE RULED PAPER SMALL,PIECE,4,11000,37288,6712,44000,May
4597,PICK n PEEL MANGO 1LTR,PIECE,4,9500,32203,5797,38000,May
4706,PRADIP VANILLA ESSENCE,PIECE,4,5000,16949,3051,20000,May
4734,PRINGLES BARBEQUE 165G,PIECE,4,11000,37288,6712,44000,May
4742,PRINGLES ORIGINAL 165G BURSTING,PIECE,4,11000,37288,6712,44000,May
4778,PROTEX HERBAL 90G,PIECE,4,4000,13559,2441,16000,May
4963,RIHAM VANILLA CREAMYCRUNCH,PIECE,4,3000,10169,1831,12000,May
5022,ROYCO CHICKEN 500G,PIECE,4,12000,40678,7322,48000,May
5025,ROYCO CUBES BEEF,PIECE,4,4000,13559,2441,16000,May
5055,SAFETY PIN 300,PIECE,4,200,678,122,800,May
5168,SCHOOL SOCKS BLUE&WHITE ORIGINAL 7500,PIECE,4,7500,25424,4576,30000,May
5275,SHENKE REPELLANT ORDOLESS,PIECE,4,8000,27119,4881,32000,May
5282,SHIVA HONEY 400G,PIECE,4,13000,44068,7932,52000,May
5307,SHOWER TO SHOWER SPRING RAIN,PIECE,4,6000,20339,3661,24000,May
5313,SHOWERTO SHOWER MUSK ALIVE,PIECE,4,6000,20339,3661,24000,May
5508,SOFINE PURE OLIVE OIL 120ML,PIECE,4,7000,23729,4271,28000,May
5594,SPLASH BOX 42000,BOX,4,45000,152542,27458,180000,May
5658,STA-SOFT SPRING FRESH 750MLS,PIECE,4,12000,40678,7322,48000,May
5726,SULTAN COCONUT HAIL OIL,PIECE,4,5000,16949,3051,20000,May
5816,SUNSIP BLACKCURRANT 5LTR,PIECE,4,24000,81356,14644,96000,May
5822,SUNSIP STRAWBERRY 3LTR,PIECE,4,16000,54237,9763,64000,May
6041,TOCEBA AAA,PIECE,4,700,2373,427,2800,May
6042,TOCEBAL AA,PIECE,4,1000,3390,610,4000,May
6305,UGANDA SAFARI TEA 250G,PIECE,4,7000,23729,4271,28000,May
6651,YOUR CHOICE SAUSAGES 500G,PIECE,4,17000,57627,10373,68000,May
6675,ZESTA STRAWBERRY JAM 300GM,PIECE,4,7500,25424,4576,30000,May
6795,KATOGO 2000,PIECE,4,2000,6780,1220,8000,May
6993,DOMS WAX CRAYONS BIG,PIECE,4,5000,16949,3051,20000,May
7078,VASELINE BLUESEAL ALOEVERA 240ML,PIECE,4,9500,32203,5797,38000,May
7101,JAMIES DADDIES TIN 17000,PIECE,4,17000,57627,10373,68000,May
7427,COLGATE CLEAN MINT 10500,PIECE,4,10500,35593,6407,42000,May
7547,TOYS 15000,PIECE,4,11250,38136,6864,45000,May
7610,MARSHAL SET,PIECE,4,4000,13559,2441,16000,May
7648,COCKROACH KILLING BAIT 5G,PIECE,4,999,3386,610,3996,May
7722,JAMIES BRONCH BREAD 1KG,PIECE,4,6000,20339,3661,24000,May
7808,PICNIK CHOCOLATE 10G,PIECE,4,1000,3390,610,4000,May
7813,PETIT BEURRE 78G,PIECE,4,1300,4407,793,5200,May
7885,ROKI COOKING OIL 500ML,PIECE,4,4000,13559,2441,16000,May
16,7DAYS ANTIBACTERIAL WIPES,PIECE,5,5000,21186,3814,25000,May
93,ALWAYS V.P EXTRA LONG,PIECE,5,6500,27542,4958,32500,May
95,ALWAYS VALUE PACK LONG,PIECE,5,6500,27542,4958,32500,May
102,AMARA BODY MILK 400ML,PIECE,5,8500,36017,6483,42500,May
126,AMERICAN GARDEN KETCHUP 340G,PIECE,5,7500,31780,5720,37500,May
213,ARIEL DOWNY LAVENDER500G,PIECE,5,7800,33051,5949,39000,May
253,AROMAT 200G,PIECE,5,12000,50847,9153,60000,May
524,BALLET ACTIVE VITAMIN 300MLS,PIECE,5,9500,40254,7246,47500,May
577,BANNERS 7000,PIECE,5,7000,29661,5339,35000,May
613,BECCA COUNTERBOOK 5000,PIECE,5,3500,14831,2669,17500,May
627,BEIKU BABY SOOTHERS,PIECE,5,2500,10593,1907,12500,May
703,BLESSED KISUBI TEA 125G,PIECE,5,5000,21186,3814,25000,May
704,BLESSED KISUBI TEA 200G,PIECE,5,6000,25424,4576,30000,May
705,BLESSED KISUBI TEA 350G,PIECE,5,12000,50847,9153,60000,May
716,BLUE BAND 500G,PIECE,5,10000,42373,7627,50000,May
1017,CARAMBOLA BLACK SPOT,PIECE,5,6000,25424,4576,30000,May
1047,CB CLASSIC VANILLA 200MLS,PIECE,5,4000,16949,3051,20000,May
1097,CHAPA NYOTA BROWN 600G,PIECE,5,4000,16949,3051,20000,May
1131,CHINA GREEN TEA 50G,PIECE,5,5000,21186,3814,25000,May
1212,CLOSEUP TRIPLEFRESH 60G,PIECE,5,3000,12712,2288,15000,May
1269,COLGATE TRIPLE ACTION 140G,PIECE,5,6500,27542,4958,32500,May
1274,COLORES NEW ELITE COLOURS BIG,PIECE,5,2000,8475,1525,10000,May
1288,COMPACT NAPKINS,PIECE,5,3000,12712,2288,15000,May
1357,CREAMBELL STRAWBERRY VAN 500ML,PIECE,5,10000,42373,7627,50000,May
1444,D.L VANILLA CREAM 120MLS,PIECE,5,2000,8475,1525,10000,May
1448,DABUR CLOVE VALUE PACK,PIECE,5,11000,46610,8390,55000,May
1552,DETTOL JUNIORS GLYCERINE SOAP 100G,PIECE,5,4500,19068,3432,22500,May
1602,DISPOSABLE PLATES 9 ROUND,PIECE,5,6500,27542,4958,32500,May
1603,DISPOSABLE SPOON 4000,PIECE,5,4000,16949,3051,20000,May
1662,DOLPHIN MONDI PAPERS,PIECE,5,27000,114407,20593,135000,May
1814,EARBUDS 2500,PIECE,5,2500,10593,1907,12500,May
1823,ECLAIRS,PIECE,5,200,847,153,1000,May
1887,ELEGANT STRAWBERRY 300ML,PIECE,5,7000,29661,5339,35000,May
2150,FOOD COLOUR BLUE,PIECE,5,1000,4237,763,5000,May
2209,FRESH UP TOOTHPASTE,PIECE,5,2000,8475,1525,10000,May
2235,FRUITVILLE MANGO 500ML,PIECE,5,3500,14831,2669,17500,May
2295,GEISHA MORINGA OIL 225G,PIECE,5,5500,23305,4195,27500,May
2389,GOLDEN ALUMINIUM FOIL,PIECE,5,34000,144068,25932,170000,May
2477,HABARI SALT SMALL,PIECE,5,700,2966,534,3500,May
2538,HERMELA GUEST SOAP,PIECE,5,3500,14831,2669,17500,May
2706,JAGO 100MLS,PIECE,5,3500,14831,2669,17500,May
2714,JAGO SCRUB 250G,PIECE,5,7500,31780,5720,37500,May
2830,JIK COLOURS 250MLS,PIECE,5,7000,29661,5339,35000,May
2989,KAZIRE RED TONIC 350MLS,PIECE,5,2000,8475,1525,10000,May
3115,KIRUNGI MULONDO EXTRA 280ML,PIECE,5,1000,4237,763,5000,May
3150,KNICKERS 2000,PIECE,5,2000,8475,1525,10000,May
3290,LATO FLAVOURED BOX 23000,BOX,5,23000,97458,17542,115000,May
3295,LATO MILK 900G,PIECE,5,47000,199153,35847,235000,May
3376,LIFEBUOY TOTAL10 175G,PIECE,5,6000,25424,4576,30000,May
3493,M&G STICK GLUE 1500,PIECE,5,1500,6356,1144,7500,May
3575,MAKE UP FACIAL WIPES,PIECE,5,3500,14831,2669,17500,May
3586,MANAGEMENT FILE 2000,PIECE,5,2000,8475,1525,10000,May
3682,MESSAGE CARDS 500,PIECE,5,500,2119,381,2500,May
3750,MIRRORS 2500,PIECE,5,2500,10593,1907,12500,May
3809,MOPPER 7000,PIECE,5,7000,29661,5339,35000,May
3841,MORTEIN LEMON 300ML,PIECE,5,22000,93220,16780,110000,May
3954,MUKWANO OIL 1LTR JERRYCAN,PIECE,5,9800,41525,7475,49000,May
3964,MUSA'S COOKIES 180G,PIECE,5,3000,12712,2288,15000,May
3965,MUSA'S COOKIES 90G,PIECE,5,1500,6356,1144,7500,May
4026,NATARAJ RULER,PIECE,5,1500,6356,1144,7500,May
4223,NUMA SOYA RICE 1KG,PIECE,5,7000,29661,5339,35000,May
4263,NUVITA CHOCO BISCUITS,PIECE,5,2000,8475,1525,10000,May
4295,OFFICE GLUE 90G,PIECE,5,2000,8475,1525,10000,May
4368,ORCHID VALLEY MANGO 1LTR6161101061483,PIECE,5,7500,31780,5720,37500,May
4430,PADLOCK 3000,PIECE,5,3000,12712,2288,15000,May
4470,PANCHAVATI,PIECE,5,3200,13559,2441,16000,May
4516,PELIKAN RUBBER,PIECE,5,1000,4237,763,5000,May
4523,PENCIL BAGS 7000,PIECE,5,7000,29661,5339,35000,May
4766,PROTEX CLASSIC 100G,PIECE,5,3500,14831,2669,17500,May
4813,PURE GLUCOSE BOX,PIECE,5,1000,4237,763,5000,May
5021,ROYCO CHICKEN 200G,PIECE,5,6000,25424,4576,30000,May
5049,SAFA TOMATO PASTE 400G,PIECE,5,6000,25424,4576,30000,May
5171,SCHOOL SOCKS WHITE 7000,PIECE,5,7500,31780,5720,37500,May
5174,SCHOOL STOCKINGS WHITE,PIECE,5,4300,18220,3280,21500,May
5250,SHADES 6000,PIECE,5,6000,25424,4576,30000,May
5270,SHENKE MOSQUITO COIL LOW SMOKE,PIECE,5,6000,25424,4576,30000,May
5287,SHOE BRUSH 5000,PIECE,5,5000,21186,3814,25000,May
5724,SULFO GLYCERINE COLORLESS,PIECE,5,2000,8475,1525,10000,May
5725,SULFO GLYCERINE PINK,PIECE,5,2000,8475,1525,10000,May
5764,SUMZ SALT&VINEGAR 30G,PIECE,5,1500,6356,1144,7500,May
5767,SUMZS CRISPS 500G,PIECE,5,12000,50847,9153,60000,May
5786,SUNLIGHT LAVENDER 500G,PIECE,5,5500,23305,4195,27500,May
5803,SUNSEED OIL 2LTRS,PIECE,5,21000,88983,16017,105000,May
6103,TOP UP CHILL 260G,PIECE,5,2000,8475,1525,10000,May
6406,VASELINE BLUESEAL ORIGINAL 250ML,PIECE,5,9500,40254,7246,47500,May
6411,VASELINE COCOAGLOW LOTION 400G radiant,PIECE,5,14500,61441,11059,72500,May
6422,VASELINE MEN COOLING JELLY 240ML,PIECE,5,9500,40254,7246,47500,May
6424,VASELINE MEN EXTRA HYDRATION,PIECE,5,14500,61441,11059,72500,May
6568,WHITE CHALK 5000,PIECE,5,5000,21186,3814,25000,May
6666,ZESTA 500G,PIECE,5,10500,44492,8008,52500,May
6677,ZESTA TOMATO KETCHUP 700G,PIECE,5,12000,50847,9153,60000,May
6709,VASELINE BLUESEAL JELLY ORIGINAL 95ML,PIECE,5,5000,21186,3814,25000,May
6996,NATARAJ WAX CRAYONS 2500,PIECE,5,2500,10593,1907,12500,May
7163,SPIDERMAN SWEETS 700,PIECE,5,700,2966,534,3500,May
7174,JAMIES LIQUID SOAP 5LTR 10000,PIECE,5,10000,42373,7627,50000,May
7349,BODY SCRUBBER GLOVE,PIECE,5,2500,10593,1907,12500,May
7395,HIKMA HARD CORNS 2500,PIECE,5,2000,8475,1525,10000,May
7552,TOYS 5000,PIECE,5,5400,22881,4119,27000,May
7588,SUMZ CASHEW NUTS 75G,PIECE,5,7500,31780,5720,37500,May
7619,NICE BISCUITS ,PIECE,5,1500,6356,1144,7500,May
7687,NOTE BOOK 6500,PIECE,5,6500,27542,4958,32500,May
7705,JAMIES CAKE SLICE@8000,PIECE,5,7000,29661,5339,35000,May
7724,JAMIES DOUGHNUTS SMALL 6PCS,PIECE,5,3000,12712,2288,15000,May
7811,FLAMINGO ROSE& HONEY 200G,PIECE,5,3500,14831,2669,17500,May
7812,FLAMINGO LEMON&HONEY 200G,PIECE,5,3500,14831,2669,17500,May
7833,FANEST BEEF SAUSAGES 1KG,PIECE,5,20000,84746,15254,100000,May
7838,AMERICAN APPLE CIDER VINEGAR 473ML,PIECE,5,10000,42373,7627,50000,May
7862,ORCHID VALLEY GUAVA 250ML,PIECE,5,2000,8475,1525,10000,May
7864,ORCHID VALLEY APPLE 250ML,PIECE,5,2000,8475,1525,10000,May
7865,SWEETS 700,PIECE,5,698,2958,533,3491,May
7894,NUVITA CHOCOLATE COOKIES 100GM,PIECE,5,2500,10593,1907,12500,May
537,BALLET BUTTER BLEND 120MLS,PIECE,6,4500,22881,4119,27000,May
538,BALLET BUTTER BLEND 300ML,PIECE,6,9500,48305,8695,57000,May
672,BIRTHDAY HATS 3500,PIECE,6,3500,17797,3203,21000,May
692,BIYINZINKA LIVER 500G,PIECE,6,6000,30508,5492,36000,May
890,BUSHENYI HONEY 250G,PIECE,6,6000,30508,5492,36000,May
949,CADBURY RUM&RAISIN 80G,PIECE,6,8000,40678,7322,48000,May
1066,CERELAC 12MONTHS 400G,PIECE,6,27000,137288,24712,162000,May
1111,CHERRY COTTON BUDS,PIECE,6,2500,12712,2288,15000,May
1261,COLGATE MAXIMUM CAVITY 140G,PIECE,6,7500,38136,6864,45000,May
1428,D.L MAXIMO VAN-CHOCO FLAKES 175ML,PIECE,6,4000,20339,3661,24000,May
1453,DABUR NEEM TOOTHPASTE 150G,PIECE,6,6000,30508,5492,36000,May
1472,DAITY DARK'N'DARK ICE CREAM,PIECE,6,5000,25424,4576,30000,May
1547,DETTOL FRESH 175G,PIECE,6,6500,33051,5949,39000,May
1819,EAST AFRICAN ORGANIC HONEY 250G,PIECE,6,8000,40678,7322,48000,May
1940,F.D MANGO 250G,PIECE,6,2500,12712,2288,15000,May
1971,F.D YOGHURT MIXED BERRIES 450G,PIECE,6,3700,18814,3386,22200,May
2115,FOCUS GLASS CLEANER JASMINE,PIECE,6,7000,35593,6407,42000,May
2233,FRUITVILLE APPLE DRINK,PIECE,6,3500,17797,3203,21000,May
2283,GARDEN TEA 50G,PIECE,6,2500,12712,2288,15000,May
2765,JAMIES TWISTED BREAD 1KG,PIECE,6,6000,30508,5492,36000,May
3110,KIRINGI KAZI BOOSTER 280ML,PIECE,6,1000,5085,915,6000,May
3116,KIRUNGI PINEAPPLE 250MLS,PIECE,6,1000,5085,915,6000,May
3143,KIWI SHOE POLISH 32G,PIECE,6,5000,25424,4576,30000,May
3156,KNICKERS 7000,PIECE,6,7000,35593,6407,42000,May
3157,KNICKERS 8000,PIECE,6,8000,40678,7322,48000,May
3576,MAKE UP WIPES,PIECE,6,3500,17797,3203,21000,May
3609,MARS CHOCOLATE,PIECE,6,3500,17797,3203,21000,May
3678,MENTOS RAINBOW,PIECE,6,2000,10169,1831,12000,May
3894,MOVIT FAMILY SOAP ROSE 125G,PIECE,6,2500,12712,2288,15000,May
3913,MOVIT JELLY 200G,PIECE,6,5000,25424,4576,30000,May
3994,NACET 500 PCS,PIECE,6,500,2542,458,3000,May
4021,NATARAJ COLOR PENCILS,PIECE,6,7500,38136,6864,45000,May
4027,NATARAJ SETS,PIECE,6,10000,50847,9153,60000,May
4191,NOMI BUCKET 1KG,PIECE,6,12500,63559,11441,75000,May
4192,NOMI BUCKET 500G,PIECE,6,6500,33051,5949,39000,May
4239,NUTRO CREAM WAFERS 3,PIECE,6,6500,33051,5949,39000,May
4252,NUTRO WAFERS VANILLA,PIECE,6,3500,17797,3203,21000,May
4264,NUVITA CHOCOLATE CREAM,PIECE,6,1500,7627,1373,9000,May
4337,OMO BLEACH MULTI -PURPOSE,PIECE,6,4000,20339,3661,24000,May
4340,OMO BLEACH REGULAR 250ML,PIECE,6,3500,17797,3203,21000,May
4454,PAMPER 5 L.C PANTS,PIECE,6,9000,45763,8237,54000,May
4539,PEPSODENT CAVITY 65G,PIECE,6,2500,12712,2288,15000,May
4595,PICK n PEEL APPLE 1LTR,PIECE,6,9500,48305,8695,57000,May
4705,PRADIP VANILLA CLEAR FLAVOURING,PIECE,6,5000,25424,4576,30000,May
4898,RED COCK BASMATI 1KG,PIECE,6,14000,71186,12814,84000,May
4947,RIHAM COLA 320MLS,PIECE,6,1000,5085,915,6000,May
4958,RIHAM GINGER TIN,PIECE,6,18000,91525,16475,108000,May
4964,RIHAM WATER 1.5LTRS,PIECE,6,2000,10169,1831,12000,May
5222,SENSODYNE MULTI CARE 75MLS,PIECE,6,14000,71186,12814,84000,May
5265,SHENKE FLOWER REPELLENT,PIECE,6,8000,40678,7322,48000,May
5267,SHENKE LEMON SCENT,PIECE,6,8000,40678,7322,48000,May
5268,SHENKE LOTUS SCENT,PIECE,6,8000,40678,7322,48000,May
5272,SHENKE MOSQUITO REPELLANT,PIECE,6,16000,81356,14644,96000,May
5355,SILVER PLATE 300,PIECE,6,300,1525,275,1800,May
5381,SIMKA VANILLA 300MLS,PIECE,6,3500,17797,3203,21000,May
5567,SOY SAUCE DARK 500G,PIECE,6,10000,50847,9153,60000,May
5614,SPONGES 4500,PIECE,6,4500,22881,4119,27000,May
5766,SUMZ TANGY LEMON CRISPS 30G,PIECE,6,1500,7627,1373,9000,May
5798,SUNLIGHT TROPICAL 500G,PIECE,6,5500,27966,5034,33000,May
5802,SUNSEED OIL 1LTRS,PIECE,6,12000,61017,10983,72000,May
6470,VIM LEMON 1KG,PIECE,6,8000,40678,7322,48000,May
6471,VIM LEMON FRESH 500G,PIECE,6,5000,25424,4576,30000,May
6544,WEETABIX CORNFLAKES 500G,PIECE,6,21000,106780,19220,126000,May
6707,VASELINE BLUESEAL MEN COOLING 95ML,PIECE,6,5000,25424,4576,30000,May
6885,JAGO SCRUB 110G,PIECE,6,4000,20339,3661,24000,May
6935,SHREEJI 96 PAGES A4 ,PIECE,6,2000,10169,1831,12000,May
7025,FACE TOWELS 6000,PIECE,6,6000,30508,5492,36000,May
7137,JAMIES COOKIES 2000,PIECE,6,2000,10169,1831,12000,May
7147,JAMIES COOKIES 800G TIN 17000,PIECE,6,17000,86441,15559,102000,May
7308,COTTON EAR SWABS 4000,PIECE,6,4000,20339,3661,24000,May
7499,JAMIES SWEET CAKE WHOLESALE 500G,PIECE,6,2499,12705,2287,14992,May
7611,SUMZ ROASTED SESAME 80G,PIECE,6,2500,12712,2288,15000,May
7643,KAXUE KIDS TOOTHBRUSH,PIECE,6,2500,12712,2288,15000,May
7703,TOYS 1000,PIECE,6,1000,5085,915,6000,May
7720,SECRETS PADS ULTRA OVER NIGHT BLUE,PIECE,6,5500,27966,5034,33000,May
7860,WASH -Q KIDS TOOTH BRUSH ,PIECE,6,1000,5085,915,6000,May
354,B.D CANDLES 1500,PIECE,7,1500,8898,1602,10500,May
528,BALLET BABY JELLY 120MLS,PIECE,7,5000,29661,5339,35000,May
636,BESSA MILLET DRINK 500MLS,PIECE,7,4500,26695,4805,31500,May
689,BIYINZIKA SUPA 1KG,PIECE,7,20000,118644,21356,140000,May
729,BLUE TOILET BLOCKS DOUBLE,PIECE,7,5000,29661,5339,35000,May
891,BUSHENYI HONEY 5OOG,PIECE,7,9000,53390,9610,63000,May
892,BUSHENYI HONEY 90G,PIECE,7,3500,20763,3737,24500,May
966,CAKE WRAPPER 1000,PIECE,7,1000,5932,1068,7000,May
1045,CB CHOC-VANILLA 120MLS,PIECE,7,2500,14831,2669,17500,May
1048,CB CLASSIC VANILLA 500ML,PIECE,7,10000,59322,10678,70000,May
1427,D.L MAXIMO CARAMEL NUTS,PIECE,7,3500,20763,3737,24500,May
1527,DENTEX TOOTHBRUSH SOFT,PIECE,7,3500,20763,3737,24500,May
1558,DETTOL ORIGINAL 175G,PIECE,7,6500,38559,6941,45500,May
1775,DURU ENERGIZING HONEY,PIECE,7,4500,26695,4805,31500,May
1856,EGGS TRAY,PIECE,7,14000,83051,14949,98000,May
1936,F.D CHOCOLATE MILK 250MLS,PIECE,7,2000,11864,2136,14000,May
2154,FOOD COLOUR ORANGE,PIECE,7,1000,5932,1068,7000,May
2414,GOOD DAY CHOCO CHIP,PIECE,7,5000,29661,5339,35000,May
2479,HACO RULER,PIECE,7,2000,11864,2136,14000,May
2530,HEINZ KETCHUP 300G,PIECE,7,8000,47458,8542,56000,May
2651,IMPERIAL LEATHER 4*175,PIECE,7,13000,77119,13881,91000,May
2726,JAMIES CAKES @60K,PIECE,7,60000,355932,64068,420000,May
2987,KAZIRE ORANGE,PIECE,7,2000,11864,2136,14000,May
3131,KIWI 20G,PIECE,7,3000,17797,3203,21000,May
3224,KUAKUA TOILET BLOCKS 6PCS,PIECE,7,10000,59322,10678,70000,May
3293,LATO MILK 250G,PIECE,7,12000,71186,12814,84000,May
3494,M&G STICK GLUE 3000,PIECE,7,3000,17797,3203,21000,May
3610,MARSHMALLOW DELICIOUS ASSORTED 15G,PIECE,7,2000,11864,2136,14000,May
3625,MAYONNAISE 237ML,PIECE,7,19000,112712,20288,133000,May
3684,MIA GONJA 1000,PIECE,7,1000,5932,1068,7000,May
4036,NEEK YOGHURT 500G 3500,PIECE,7,3500,20763,3737,24500,May
4043,NESCAFE CLASSIC 100G,PIECE,7,17000,100847,18153,119000,May
4081,NICE CLEAR PENS,PIECE,7,500,2966,534,3500,May
4270,NUVITA GLUCOSE 75G,PIECE,7,1500,8898,1602,10500,May
4275,NUVITA STRAWBERRY CREAMS 75G,PIECE,7,1500,8898,1602,10500,May
4343,OMO COMFORT 500G,PIECE,7,7500,44492,8008,52500,May
4465,PANASONIC AAA,PIECE,7,2000,11864,2136,14000,May
4541,PEPSODENT HERBAL 65G,PIECE,7,2500,14831,2669,17500,May
4593,PICFARE SQUARE BKS 96PGS,PIECE,7,1500,8898,1602,10500,May
4777,PROTEX HERBAL 150G,PIECE,7,6500,38559,6941,45500,May
4950,RIHAM CREAMY CRUNCH CHOCOLATE,PIECE,7,3000,17797,3203,21000,May
5023,ROYCO CHICKEN 60G,PIECE,7,1200,7119,1281,8400,May
5189,SCRUBBING BRUSH LONG 5000,PIECE,7,6000,35593,6407,42000,May
5332,SHUYA 280MM,PIECE,7,6000,35593,6407,42000,May
5566,SOY SAUCE DARK 150G,PIECE,7,5000,29661,5339,35000,May
5660,STEEPO CHOCOLATE,PIECE,7,2000,11864,2136,14000,May
5731,SUMZ COCONUT COOKIES,PIECE,7,4000,23729,4271,28000,May
5979,TEMMY'S CORNFLAKES 250G,PIECE,7,9000,53390,9610,63000,May
6216,TROPICAL HEAT TEA MASALA 45G,PIECE,7,5000,29661,5339,35000,May
6401,VASELINE BLUESEAL COCOA BUTTER250ML,PIECE,7,9500,56356,10144,66500,May
6665,ZESTA 300 G,PIECE,7,7500,44492,8008,52500,May
7102,JAMIES DADDIES TIN 20000,PIECE,7,20000,118644,21356,140000,May
7387,HB PENCILS,PIECE,7,1500,8898,1602,10500,May
7558,HISS,PIECE,7,2500,14831,2669,17500,May
7748,BAKEMATE LOVE 1500,PIECE,7,1500,8898,1602,10500,May
7830,PICK n PEEL ORANGE JUICE 1LITRE,PIECE,7,9500,56356,10144,66500,May
7858,MOOISTE COCOA,PIECE,7,2500,14831,2669,17500,May
7861,ROYAL SHAVERS,PIECE,7,3500,20763,3737,24500,May
71,ALLIANCE LIVEN COFFEE,PIECE,8,3500,23729,4271,28000,May
254,AROMAT 75G,PIECE,8,5500,37288,6712,44000,May
313,AUNT PORRIDGE 6MONTHS,PIECE,8,14000,94915,17085,112000,May
344,AZAM BAKING FLOUR 2KG,PIECE,8,8500,57627,10373,68000,May
731,BLUEBAND LOW FAT 100G,PIECE,8,2000,13559,2441,16000,May
916,C.B RIPPLES STRAWBERRY 200ML,PIECE,8,4000,27119,4881,32000,May
946,CADBURY FRUIT & NUT 80G,PIECE,8,8000,54237,9763,64000,May
1064,CELOTAPE SMALL 1000,PIECE,8,1000,6780,1220,8000,May
1164,CLASSIC 96 PAGES,PIECE,8,2000,13559,2441,16000,May
1224,COCACOLA CAN 330ML,PIECE,8,2700,18305,3295,21600,May
1259,COLGATE MAX-FRESH 130G,PIECE,8,6500,44068,7932,52000,May
1262,COLGATE MAXIMUM CAVITY 35G,PIECE,8,2500,16949,3051,20000,May
1464,DAIRY TOP YOGHURT STRAWBERRY 250G,PIECE,8,1000,6780,1220,8000,May
1525,DENTAL FLOSS,PIECE,8,2500,16949,3051,20000,May
1718,DOVE ORIGINAL SOAP 135G,PIECE,8,5500,37288,6712,44000,May
1911,ENVELOPES 300,PIECE,8,300,2034,366,2400,May
1959,F.D STRAWBERRY MILK 500MLS,PIECE,8,4000,27119,4881,32000,May
2178,FORTUNE GOLD 500ML,PIECE,8,5000,33898,6102,40000,May
2180,FORTUNE SPAGHETTI 250G,PIECE,8,2000,13559,2441,16000,May
3171,KOFA MATHEMATICAL SET,PIECE,8,4000,27119,4881,32000,May
3584,MAMIS PEANUT PASTE 1KG,PIECE,8,15000,101695,18305,120000,May
3945,MUKISA MANDAZI,PIECE,8,3000,20339,3661,24000,May
4195,NOTE BOOK 2000,PIECE,8,2000,13559,2441,16000,May
4235,NUTRO CHOC CREAM WAFERS,PIECE,8,6500,44068,7932,52000,May
4346,OMO FAST ACTION 500G,PIECE,8,7500,50847,9153,60000,May
4581,PICFARE 48PGS,PIECE,8,500,3390,610,4000,May
4598,PICK N PEEL MANGO 250ML,PIECE,8,2500,16949,3051,20000,May
4948,RIHAM CREAM CHOCOLATE,PIECE,8,1200,8136,1464,9600,May
5095,SANTA LUCIA LUMACA,PIECE,8,5000,33898,6102,40000,May
5274,SHENKE ORANGE,PIECE,8,8000,54237,9763,64000,May
5321,SHREEJI BOOK 200PGS,PIECE,8,4000,27119,4881,32000,May
5333,SHUYA 330MM,PIECE,8,6000,40678,7322,48000,May
5760,SUMZ PUMPKIN SEEDS 70G,PIECE,8,3000,20339,3661,24000,May
5844,SUPER GLUE,PIECE,8,1000,6780,1220,8000,May
5877,SWEETS 1500 ICECREAMM LOLLIPOP,PIECE,8,1500,10169,1831,12000,May
6268,U.S.A BEAUTY SOAP BLACK,PIECE,8,6500,44068,7932,52000,May
6469,VIM LAVENDER 500G,PIECE,8,5000,33898,6102,40000,May
6598,WISDOM SMOKERS TOOTHBRUSH,PIECE,8,2688,18220,3280,21500,May
6710,VASELINE BLUESEAL COCOA BUTTER 95ML,PIECE,8,5000,33898,6102,40000,May
6936,JESA MIXED BERRY YOGHURT 500G,PIECE,8,3700,25085,4515,29600,May
6953,STRIKE NUTS CHOCOLATE BAR,PIECE,8,1500,10169,1831,12000,May
6997,PELIKAN HB PENCILS 12PCS,PIECE,8,6000,40678,7322,48000,May
7389,HIKMA YELLOW BAGIYA 2000,PIECE,8,1500,10169,1831,12000,May
7392,HIKMA DADDIES 5000,PIECE,8,4750,32203,5797,38000,May
7426,JAMIES SWEET CAKE BREAD WHOLESALE 5000,PIECE,8,5000,33898,6102,40000,May
7432,FRESCO BODY OIL 100ML 4000,PIECE,8,4000,27119,4881,32000,May
529,BALLET BABY JELLY 300MLS,PIECE,9,9500,72458,13042,85500,May
639,BEST RULER 1000,PIECE,9,1000,7627,1373,9000,May
649,BI-CARBONATE SODA,PIECE,9,1000,7627,1373,9000,May
913,C.B RIPPLES CHOCOLATE 200ML,PIECE,9,4000,30508,5492,36000,May
1247,COLGATE CHILDREN 50MLS,PIECE,9,4500,34322,6178,40500,May
1406,CUSSONS SOAP SOFT&SMOOTH,PIECE,9,3500,26695,4805,31500,May
1423,D.L FIESTA CLASSIC 100MLS,PIECE,9,3500,26695,4805,31500,May
1429,D.L MEGA CONE VANILLA,PIECE,9,3500,26695,4805,31500,May
1462,DAIRY MILK TOP DECK 80G,PIECE,9,8000,61017,10983,72000,May
1487,DATES 5000,PIECE,9,5500,41949,7551,49500,May
1687,DOUBLE A REAM,PIECE,9,29000,221186,39814,261000,May
1723,DOVE PINK ROSA SOAP 135G,PIECE,9,6000,45763,8237,54000,May
1818,EAST AFRICAN ORGANIC HONEY 100G,PIECE,9,3500,26695,4805,31500,May
2183,FOUNTAIN PEN,PIECE,9,8000,61017,10983,72000,May
2286,GEISHA ALOE VERA&HONEY,PIECE,9,4000,30508,5492,36000,May
2288,GEISHA ALOEVERA &HONEY 125G,PIECE,9,2500,19068,3432,22500,May
2302,GEISHA TRADITIONAL BLACK SOAP,PIECE,9,5500,41949,7551,49500,May
2595,HOT FRESH 20ML,PIECE,9,2500,19068,3432,22500,May
2603,HP FACIAL WIPES,PIECE,9,3500,26695,4805,31500,May
2663,IMPERIAL LEATHER SOAP RED 175G,PIECE,9,4000,30508,5492,36000,May
2916,JUMBO BLUE SWIRL 175ML,PIECE,9,4000,30508,5492,36000,May
2921,JUMBO STRAWBERRY RIPPLE 175ML,PIECE,9,4000,30508,5492,36000,May
3318,LATO VANILLA YOGHURT 250ML,PIECE,9,2500,19068,3432,22500,May
3563,MAGIC 500G BUCKET,PIECE,9,6500,49576,8924,58500,May
3608,MARLOS CHOCOLATE,PIECE,9,2000,15254,2746,18000,May
3668,MEN SOCKS,PIECE,9,3000,22881,4119,27000,May
3760,MOCACINE SOCKS 2000,PIECE,9,2000,15254,2746,18000,May
3946,MUKISA MANDAZI 1000,PIECE,9,1500,11441,2059,13500,May
3972,MUSAWO SOAP 120G,PIECE,9,1500,11441,2059,13500,May
4029,NATURAL NAPKINS,PIECE,9,2500,19068,3432,22500,May
4046,NESCAFE CLASSIC 50G,PIECE,9,12000,91525,16475,108000,May
4051,NESTLE KITKAT,PIECE,9,3500,26695,4805,31500,May
4218,NUMA BUSHERA 1KG,PIECE,9,6500,49576,8924,58500,May
4271,NUVITA GO COOKIES,PIECE,9,2000,15254,2746,18000,May
4276,NUVITA VITAMILK BISCUITS,PIECE,9,1500,11441,2059,13500,May
4589,PICFARE PENCILS PIECES 300,PIECE,9,300,2288,412,2700,May
4653,PLUTO ADVANCED AA,PIECE,9,6000,45763,8237,54000,May
4711,PREDATOR ENERGY DRINK,PIECE,9,2000,15254,2746,18000,May
5016,ROYCO BEEF 200G,PIECE,9,6000,45763,8237,54000,May
5223,SENSODYNE MULTICARE 40MLS,PIECE,9,7000,53390,9610,63000,May
5235,SESAME SNACKS,PIECE,9,5000,38136,6864,45000,May
5382,SIMKA VANILLA 500MLS,PIECE,9,4500,34322,6178,40500,May
5483,SNOWMAN MAKERS,PIECE,9,1000,7627,1373,9000,May
5609,SPONGE 2000,PIECE,9,2000,15254,2746,18000,May
5734,SUMZ CORN CRAX CHILLI80G,PIECE,9,1500,11441,2059,13500,May
5741,SUMZ CRISPS FRUIT CHUTNEY,PIECE,9,1500,11441,2059,13500,May
6068,TOOTHPICK 1000,PIECE,9,1000,7627,1373,9000,May
6307,UGANDA TEA BAGS,PIECE,9,5500,41949,7551,49500,May
6404,VASELINE BLUESEAL MEN FRESH 100ML,PIECE,9,5000,38136,6864,45000,May
6458,VICTAN SINGLE VEST,PIECE,9,5000,38136,6864,45000,May
6661,ZAR MACRON 400G,PIECE,9,4500,34322,6178,40500,May
6678,ZESTA TOMATO SAUCE 400G,PIECE,9,5000,38136,6864,45000,May
6787,VEGETABLE RICE 3500,PIECE,9,3833,29237,5263,34500,May
6960,NAN GUEST BATHING SOAP,PIECE,9,4000,30508,5492,36000,May
7295,PLASTIC SWINGING CANDLE 2500,PIECE,9,2500,19068,3432,22500,May
7361,SUMZ DADDIES 300G,PIECE,9,5000,38136,6864,45000,May
7620,SPRITE CAN 330ML,PIECE,9,2700,20593,3707,24300,May
7707,JAMIES COOKIES@20000,PIECE,9,20000,152542,27458,180000,May
7746,SWEETS 1500,PIECE,9,1500,11441,2059,13500,May
7824,BANANA JUICE 5000,PIECE,9,5000,38136,6864,45000,May
7857,MOOISTE CHOCOLATE,PIECE,9,2500,19068,3432,22500,May
7867,ROCK BOOM 500ML,PIECE,9,2944,22458,4042,26500,May
81,ALWAYS COTTON EXTRA LONG,PIECE,10,3000,25424,4576,30000,May
92,ALWAYS ULTRA V.P,PIECE,10,6500,55085,9915,65000,May
271,ART BOOK SMALL,PIECE,10,2000,16949,3051,20000,May
1290,COMPO PENS,PIECE,10,3000,25424,4576,30000,May
1356,CREAMBELL MAGIC STRAW120ML,PIECE,10,2500,21186,3814,25000,May
1785,DURU NATURAL CARE,PIECE,10,4500,38136,6864,45000,May
1932,EVERVESS 500ML,PIECE,10,1500,12712,2288,15000,May
1939,F.D MANGO 100G,PIECE,10,1000,8475,1525,10000,May
2072,FIDODIDO CHOCO-VAN 220ML,PIECE,10,2500,21186,3814,25000,May
2299,GEISHA SHEA AND ALMOND BUTTER SOAP 225G,PIECE,10,5500,46610,8390,55000,May
2303,GEISHA TRADITIONAL BLACK SOAP 125G,PIECE,10,4000,33898,6102,40000,May
2813,JESA VANILLA YOGHURT 500G,PIECE,10,3700,31356,5644,37000,May
2833,JIK REGULAR 750MLS,PIECE,10,14000,118644,21356,140000,May
2990,KAZIRE VIT FRUIT,PIECE,10,2000,16949,3051,20000,May
3152,KNICKERS 3500,PIECE,10,3500,29661,5339,35000,May
3198,KOOKSY VANILLA 220ML,PIECE,10,2000,16949,3051,20000,May
3202,KOOKSY VANILLA CHOCOLATE 220ML,PIECE,10,2000,16949,3051,20000,May
3737,MIRINDA APPLE 2LTR,PIECE,10,4500,38136,6864,45000,May
3761,MOCACINE SOCKS 2500,PIECE,10,2500,21186,3814,25000,May
4215,NTALE 25G,PIECE,10,2500,21186,3814,25000,May
4247,NUTRO TEA BISCUIT,PIECE,10,3500,29661,5339,35000,May
4341,OMO BLEACH REGULAR 70ML,PIECE,10,1200,10169,1831,12000,May
4583,PICFARE 96PGS,PIECE,10,1000,8475,1525,10000,May
5167,SCHOOL SOCKS BLUE&WHITE 4000,PIECE,10,4000,33898,6102,40000,May
5259,SHARPENER SMALL,PIECE,10,500,4237,763,5000,May
5482,SNOW SPRAYS 4500,PIECE,10,5000,42373,7627,50000,May
7475,MENTOS FRUIT 29G,PIECE,10,2000,16949,3051,20000,May
7878,BLUE BAND WITH CHOCO 250G,PIECE,10,6200,52542,9458,62000,May
7893,NUVITA SHORT CAKE 1500,PIECE,10,1500,12712,2288,15000,May
718,BLUE BAND LOW SPREAD 250G,PIECE,11,4000,37288,6712,44000,May
1227,COCACOLA ZERO 350ML,PIECE,11,1000,9322,1678,11000,May
1359,CREAMY EFFECT WIPES,PIECE,11,6000,55932,10068,66000,May
1424,D.L FIESTA SALTED CARAMEL,PIECE,11,4000,37288,6712,44000,May
1473,DAITY ICEPRESSO COFFE,PIECE,11,2500,23305,4195,27500,May
2174,FORTUNE BUTTO 1LTR,PIECE,11,8500,79237,14263,93500,May
2290,GEISHA COCONUTMILK 125G,PIECE,11,2500,23305,4195,27500,May
2317,GIFT BAG FLORAL LARGE,PIECE,11,6000,55932,10068,66000,May
2802,JESA STRAWBERRY YOGHURT 500G,PIECE,11,3700,34492,6208,40700,May
2952,KAKIRA SUGAR 2KG,PIECE,11,12000,111864,20136,132000,May
2966,KANGAROO BLACK SHOE CREAM,PIECE,11,2000,18644,3356,22000,May
2988,KAZIRE POWER TONIC,PIECE,11,2000,18644,3356,22000,May
3469,M&G GLUE STICK 15G,PIECE,11,2000,18644,3356,22000,May
3607,MARIKA ICING SUGAR 500G,PIECE,11,4000,37288,6712,44000,May
3663,MEN BOXERS 10000,PIECE,11,10000,93220,16780,110000,May
3672,MENTHOXYL,PIECE,11,500,4661,839,5500,May
3963,MUSA'S BAKERY COOKIES 360G,PIECE,11,5500,51271,9229,60500,May
4020,NATARAJ COLOR PENCIL SHORT,PIECE,11,3500,32627,5873,38500,May
4035,NEEK YOGHURT 300G 2000,PIECE,11,2500,23305,4195,27500,May
4082,NICE TOOTHBRUSH,PIECE,11,600,5593,1007,6600,May
4333,OMO 40G FRESH,PIECE,11,500,4661,839,5500,May
4965,RIHAM WATER 600ML,PIECE,11,1000,9322,1678,11000,May
5090,SANTA LUCIA 250G,PIECE,11,2500,23305,4195,27500,May
5181,SCOURING PADS 500,PIECE,11,500,4661,839,5500,May
5610,SPONGE 3000,PIECE,11,3000,27966,5034,33000,May
5630,SQUEEZERS 5000,PIECE,11,5000,46610,8390,55000,May
5750,SUMZ GONJA CRISPS 160G,PIECE,11,5500,51271,9229,60500,May
6573,WHITE VINEGAR,PIECE,11,2500,23305,4195,27500,May
7388,HIKMA YELLOW BAGIYA 4000,PIECE,11,4500,41949,7551,49500,May
7405,SUMZ FRIED SOYA BEANS 100G,PIECE,11,2500,23305,4195,27500,May
7476,MENTOS MINT 29G,PIECE,11,2500,23305,4195,27500,May
7494,FRUIT VILLE TROPICAL,PIECE,11,3500,32627,5873,38500,May
7895,NUVITA BUTTER COOKIES 100GM,PIECE,11,2500,23305,4195,27500,May
349,AZAM MALT 500MLS,PIECE,12,3000,30508,5492,36000,May
353,B.D CANDLE NUMBERS,PIECE,12,1500,15254,2746,18000,May
637,BESSA MILLET MALT DRINK 330ML,PIECE,12,3000,30508,5492,36000,May
823,BRITANIA GLUCOSE BISCUIT,PIECE,12,500,5085,915,6000,May
824,BRITANIA MILK BISCUIT,PIECE,12,500,5085,915,6000,May
1910,ENVELOPES 200,PIECE,12,200,2034,366,2400,May
1937,F.D FLAVOURED CHOCOLATE,PIECE,12,4000,40678,7322,48000,May
2636,IBON ELVAN SWEETS,PIECE,12,200,2034,366,2400,May
2725,JAMIES CAKES @50k,PIECE,12,50000,508475,91525,600000,May
2986,KAZIRE LEMON TEA,PIECE,12,2000,20339,3661,24000,May
3210,KOOKSY VAN-STRAW 120MLS,PIECE,12,1000,10169,1831,12000,May
3294,LATO MILK 400G,PIECE,12,19000,193220,34780,228000,May
3435,LUCOZADE 250MLS,PIECE,12,3000,30508,5492,36000,May
3553,MAGANJO SOYA RICE 1KGS,PIECE,12,7500,76271,13729,90000,May
3566,MAGIC SACHET 45G,PIECE,12,500,5085,915,6000,May
3997,NAIL CUTTER 2500,PIECE,12,2500,25424,4576,30000,May
4240,NUTRO DIGESTIVE,PIECE,12,6500,66102,11898,78000,May
4542,PEPSODENT HERBAL TRIPPLE140G,PIECE,12,5000,50847,9153,60000,May
4587,PICFARE HANDWRITING BOOKS,PIECE,12,2000,20339,3661,24000,May
4951,RIHAM CREAMY CRUNCH STRAWBERRY,PIECE,12,3000,30508,5492,36000,May
4992,ROKI OIL 500ML,PIECE,12,5000,50847,9153,60000,May
5611,SPONGE 4000,PIECE,12,4000,40678,7322,48000,May
5730,SUMZ COATED PEANUT 50G,PIECE,12,1200,12203,2197,14400,May
5746,SUMZ GINGER COOKIES,PIECE,12,4000,40678,7322,48000,May
5759,SUMZ PUMPKIN SEEDS 50G,PIECE,12,2500,25424,4576,30000,May
6101,TOP UP 400G,PIECE,12,2000,20339,3661,24000,May
6534,WEETABIX 112G,PIECE,12,4500,45763,8237,54000,May
7553,TOYS 3000,PIECE,12,3000,30508,5492,36000,May
7592,COLGATE CHARCOAL 210G 10000,PIECE,12,10000,101695,18305,120000,May
7701,CLEAR BAGS 1500,PIECE,12,1500,15254,2746,18000,May
7745,CHOCOLATE 800,PIECE,12,800,8136,1464,9600,May
7783,MENTOS PEACH ORANGE,PIECE,12,2500,25424,4576,30000,May
671,BIRTHDAY HATS 2500,PIECE,13,2500,27542,4958,32500,May
845,BROOKSIDE PEAR CARAMEL,PIECE,13,5000,55085,9915,65000,May
846,BROOKSIDE PEAR CARAMEL 250G,PIECE,13,3000,33051,5949,39000,May
917,C.B ROYAL MANGO 120ML,PIECE,13,2500,27542,4958,32500,May
1266,COLGATE TOOTHBRUSH 1500,PIECE,13,1500,16525,2975,19500,May
1461,DAIRY MILK PLAIN 80G,PIECE,13,8000,88136,15864,104000,May
1758,DREAM PANT LINERS,PIECE,13,2500,27542,4958,32500,May
2030,FANTA 330ML CAN,PIECE,13,2700,29746,5354,35100,May
2720,JAMIES BROWN SALT BREAD 500G,PIECE,13,3000,33051,5949,39000,May
3214,KOPIKO BROWN COFFEE,PIECE,13,1500,16525,2975,19500,May
3560,MAGIC 1KG SACHET,PIECE,13,8500,93644,16856,110500,May
3585,MAMIS PEANUT PASTE 500G,PIECE,13,8000,88136,15864,104000,May
3588,MANILA PAPERS 1000,PIECE,13,1000,11017,1983,13000,May
3674,MENTOS GRAPE,PIECE,13,2500,27542,4958,32500,May
4190,NOMI 250G BUCKET,PIECE,13,4000,44068,7932,52000,May
4585,PICFARE GRAPH BOOK 48PGS,PIECE,13,2000,22034,3966,26000,May
4952,RIHAM CREAMY ORANGE,PIECE,13,1200,13220,2380,15600,May
5334,SHUYA PANT LINERS,PIECE,13,6000,66102,11898,78000,May
5376,SIMKA STRAW-VAN 300MLS,PIECE,13,3500,38559,6941,45500,May
5765,SUMZ SIMSIM BALLS 100G,PIECE,13,2500,27542,4958,32500,May
6607,WRAPPING PAPER 1000,PIECE,13,1000,11017,1983,13000,May
6988,ELITE BALL PENS 500,PIECE,13,500,5508,992,6500,May
7065,BRITANIA SWEET MEAL BISCUITS,PIECE,13,2500,27542,4958,32500,May
51,AFIA MANGO 500MLS,PIECE,14,3000,35593,6407,42000,May
842,BROOKSIDE LEMON 250G,PIECE,14,3000,35593,6407,42000,May
1950,F.D PLAIN YOGHURT 450G,PIECE,14,3700,43898,7902,51800,May
1999,FACE TOWEL 1000,PIECE,14,1000,11864,2136,14000,May
2070,FIDODIDO CHOCOLATE 120ML,PIECE,14,1200,14237,2563,16800,May
2175,FORTUNE BUTTO 500ML,PIECE,14,4500,53390,9610,63000,May
2480,HACO RULER ORIGINAL,PIECE,14,2000,23729,4271,28000,May
3335,LAVITA PINEAPPLE 320MLS,PIECE,14,1000,11864,2136,14000,May
3378,LIGHTERS,PIECE,14,1000,11864,2136,14000,May
3381,LIMOUSINE CHOCOLATE,PIECE,14,1500,17797,3203,21000,May
3998,NAIL CUTTERS 1500,PIECE,14,1500,17797,3203,21000,May
4131,NIVANA WATER 1.5L,PIECE,14,1500,17797,3203,21000,May
4552,PERMANENT MAKER,PIECE,14,1000,11864,2136,14000,May
4896,RED BULL 250MLS,PIECE,14,7000,83051,14949,98000,May
5214,SENSITIVE BABY WIPES,PIECE,14,7000,83051,14949,98000,May
5289,SHOE BRUSHES 1500,PIECE,14,1500,17797,3203,21000,May
5345,SILKEE DESIGNER SERVIETTES,PIECE,14,2500,29661,5339,35000,May
5380,SIMKA VANILLA 230MLS,PIECE,14,2000,23729,4271,28000,May
6464,VIGOS HAZELNUT CHOCOLATE 800,PIECE,14,800,9492,1708,11200,May
6643,YOJUS MANGO 150ML,PIECE,14,1000,11864,2136,14000,May
7284,SUMZ SALT& VIEGAR,PIECE,14,600,7119,1281,8400,May
7379,SUMZ COATED PEANUTS PLAINMASALA 150G,PIECE,14,3000,35593,6407,42000,May
7524,TOYS 2000,PIECE,14,2000,23729,4271,28000,May
1046,CB CLASSIC VANILLA 120MLS,PIECE,15,2500,31780,5720,37500,May
1607,DIVINE 300MLS,PIECE,15,2500,31780,5720,37500,May
2298,GEISHA ROSE&HONEY 225G,PIECE,15,4000,50847,9153,60000,May
2450,GRAPES 12000,PIECE,15,12000,152542,27458,180000,May
3944,MUKISA CAKE 2500,PIECE,15,2500,31780,5720,37500,May
4034,NEEK YOGHURT 1LTR,PIECE,15,7000,88983,16017,105000,May
4579,PICFARE 288PAGES 8500,PIECE,15,8000,101695,18305,120000,May
5593,SPLASH APPLES 150ML,PIECE,15,1500,19068,3432,22500,May
5733,SUMZ CHOCOLATE COOKIES 200G,PIECE,15,4000,50847,9153,60000,May
5743,SUMZ CRUNCHY DADDIES 150G,PIECE,15,3000,38136,6864,45000,May
5761,SUMZ ROASTED NUTS 120G,PIECE,15,3000,38136,6864,45000,May
5763,SUMZ ROASTED NUTS 60G,PIECE,15,1500,19068,3432,22500,May
7073,SUMZ TANGY LEMON CRISPS 12G,PIECE,15,600,7627,1373,9000,May
7593,COLGATE CHARCOAL 35G 2500,PIECE,15,2500,31780,5720,37500,May
7656,JAMIES MANDAZ 1000,PIECE,15,1000,12712,2288,15000,May
273,ART PENCILS 2B,PIECE,16,1000,13559,2441,16000,May
346,AZAM EMBE MANGO,PIECE,16,1500,20339,3661,24000,May
843,BROOKSIDE LEMON BISCUITS 450G,PIECE,16,5500,74576,13424,88000,May
2028,FANSICKERS COCOA CREAM,PIECE,16,2500,33898,6102,40000,May
2292,GEISHA LEMON&HONEY 125G,PIECE,16,2500,33898,6102,40000,May
3212,KOPIKO 3 IN 1 COFFEE,PIECE,16,2000,27119,4881,32000,May
3215,KOPIKO CAPPUCCINO CHOCO,PIECE,16,1500,20339,3661,24000,May
3562,MAGIC 250G BUCKET,PIECE,16,4000,54237,9763,64000,May
4717,PRESTIGE 250G,PIECE,16,4500,61017,10983,72000,May
5667,GOLDER STICK NOTES,PIECE,16,2000,27119,4881,32000,May
7168,SPLASH TROPICAL FRUIT PUNCH 1LTR,PIECE,16,8000,108475,19525,128000,May
7296,BANANA JUICE 3000,PIECE,16,3000,40678,7322,48000,May
7364,SUMZ BAGGIA 100G,PIECE,16,3000,40678,7322,48000,May
901,C.B CHOCOLATE CHOCO CHIP 120ML,PIECE,17,2500,36017,6483,42500,May
1096,CHAPA NYOTA BLUE 600G,PIECE,17,4000,57627,10373,68000,May
1249,COLGATE DOUBLE ACTION,PIECE,17,4000,57627,10373,68000,May
1252,COLGATE HERBAL 140G,PIECE,17,7500,108051,19449,127500,May
1253,COLGATE HERBAL 230G,PIECE,17,9500,136864,24636,161500,May
1468,DAITY AMIRALDOUBLE CHOCOLATE,PIECE,17,4500,64831,11669,76500,May
1914,ERASER RUBBER,PIECE,17,500,7203,1297,8500,May
2181,FORTUNE SPAGHETTI 450,PIECE,17,3500,50424,9076,59500,May
2289,GEISHA COCONUT MILK 200G,PIECE,17,4000,57627,10373,68000,May
4464,PANASONIC AA,PIECE,17,2000,28814,5186,34000,May
4582,PICFARE 96 PGS 11000,PIECE,17,10588,152542,27458,180000,May
5371,SIMKA CHOC-VANILLA 500ML,PIECE,17,4500,64831,11669,76500,May
5481,SNICKERS CHOCOLATE,PIECE,17,3500,50424,9076,59500,May
7859,TOFFEE 500,PIECE,17,500,7203,1297,8500,May
348,AZAM MALT 300MLS,PIECE,18,1500,22881,4119,27000,May
939,CADBURY DAIRY MILK MINT CRISP 80G,PIECE,18,8000,122034,21966,144000,May
1953,F.D STRAWBERRY 150G,PIECE,18,1800,27458,4942,32400,May
2291,GEISHA LEMON&HONEY,PIECE,18,4000,61017,10983,72000,May
2719,JAMIES BROWN SALT BREAD 1KG,PIECE,18,5500,83898,15102,99000,May
3564,MAGIC 500G SACHET,PIECE,18,4500,68644,12356,81000,May
4953,RIHAM CREAMY STRAWBERRY,PIECE,18,1200,18305,3295,21600,May
5366,SIMKA CHOC- VAN 300ML,PIECE,18,3500,53390,9610,63000,May
5536,SOFTCARE PAMPERS S15,PIECE,18,7500,114407,20593,135000,May
5591,SPLASH APPLE 1LTR,PIECE,18,8000,122034,21966,144000,May
1245,COLGATE CHARCOAL GENTLE CLEAN,PIECE,19,7500,120763,21737,142500,May
2296,GEISHA ROSE&HONEY,PIECE,19,2500,40254,7246,47500,May
3204,KOOKSY VANILLA MANGO 220ML,PIECE,19,2000,32203,5797,38000,May
3323,LATO YOG STRAWBERRY 250G,PIECE,19,2500,40254,7246,47500,May
5882,SWEETS 700 BIG FIVE,PIECE,19,700,11271,2029,13300,May
7365,SUMZ BAGGIA 50G,PIECE,19,1500,24153,4347,28500,May
7486,APPLES PACKED 11000,PIECE,19,11000,177119,31881,209000,May
832,BRITANIA SHORTCAKE BISCUITS,PIECE,20,2000,33898,6102,40000,May
1485,DATES 2000,PIECE,20,2000,33898,6102,40000,May
2089,FIDODIDO STRWABERRY 220ML,PIECE,20,2500,42373,7627,50000,May
3207,KOOKSY VANILLA STRAWBERRY 220ML,PIECE,20,2000,33898,6102,40000,May
3742,MIRINDA ORANGE 2LTRS,PIECE,20,4500,76271,13729,90000,May
4718,PRESTIGE 500G,PIECE,20,7500,127119,22881,150000,May
4936,RIBENA 1LTR,PIECE,20,10000,169492,30508,200000,May
5377,SIMKA STRAW-VAN 500MLS,PIECE,20,4500,76271,13729,90000,May
5753,SUMZ POTATO CRISP BBQ 30G,PIECE,20,1500,25424,4576,30000,May
5876,SWEETS 1000,PIECE,20,1000,16949,3051,20000,May
6272,UBISCO CREAMS VANILLA,PIECE,20,1000,16949,3051,20000,May
7164,NUTRO ORANGE BISCUIT 1200,PIECE,20,1200,20339,3661,24000,May
713,BLUE BAND 100G,PIECE,21,2500,44492,8008,52500,May
943,CADBURY DREAM WHITE CREAMY 80G,PIECE,21,8000,142373,25627,168000,May
2801,JESA STRAWBERRY MILK 200MLS,PIECE,21,1500,26695,4805,31500,May
2825,JIB WATER 20LTRS REFILL,PIECE,21,8000,142373,25627,168000,May
2985,KAZIRE ALOEVERA,PIECE,21,1500,26695,4805,31500,May
3744,MIRINDA ORANGE 500ML,PIECE,21,1500,26695,4805,31500,May
6280,UBISCO KREAMY CREAMS STRAWBERRY,PIECE,21,1000,17797,3203,21000,May
6976,SUMZ POTATO CRIPS TASTY TOMATO 30G,PIECE,21,1500,31500,0,31500,May
1254,COLGATE HERBAL 35G,PIECE,22,2500,46610,8390,55000,May
3433,LUCOZADE 1LTR,PIECE,22,10000,186441,33559,220000,May
7425,JAMIES QUEEN CAKES WHOLESALE 2500,PIECE,22,2500,46610,8390,55000,May
1753,DOWNY VALLEY DEW 20ML,PIECE,23,700,13644,2456,16100,May
1915,ERASER RUBBER BIG,PIECE,23,1000,19492,3508,23000,May
2728,JAMIES COCONUT BREAD 500G,PIECE,23,3000,58475,10525,69000,May
3188,KOOKSY STRAWBERRY 120ML,PIECE,23,1000,19492,3508,23000,May
3690,MIKOSHI GREEN TEA,PIECE,23,6000,116949,21051,138000,May
4700,POWERPLAY 400MLS,PIECE,23,2000,38983,7017,46000,May
5436,SKYVIEW 320MLS,PIECE,23,1000,19492,3508,23000,May
5521,SOFT CARE BABY WIPES,PIECE,23,7000,136441,24559,161000,May
5604,SPLASH MANGO JUICE 1LTR,PIECE,23,8000,155932,28068,184000,May
5864,SWEET PEPSI,PIECE,23,100,1949,351,2300,May
7385,RIHAM X-ENERGY 320ML,PIECE,23,1500,29237,5263,34500,May
7621,MINTORE X PLUS 500,PIECE,23,500,9746,1754,11500,May
49,AFIA APPLE 500ML,PIECE,24,3000,61017,10983,72000,May
1750,DOWNY FEEL LUX 20ML,PIECE,24,700,14237,2563,16800,May
1931,EVERVESS,PIECE,24,1000,20339,3661,24000,May
2780,JESA CHOCOLATE FLAVOURED MILK 200ML,PIECE,24,1500,30508,5492,36000,May
5435,SKY VIEW ORANGE 320ML,PIECE,24,1000,20339,3661,24000,May
7239,BEEF PILAU 20000,PIECE,24,5150,104746,18854,123600,May
7789,JAMIES DANISH BREAD@3500,PIECE,24,3500,71186,12814,84000,May
1255,COLGATE HERBAL 70G,PIECE,25,4500,95339,17161,112500,May
1267,COLGATE TOOTHBRUSH CHARCOAL,PIECE,25,2500,52966,9534,62500,May
1935,EXOTIC 320MLS,PIECE,25,1000,21186,3814,25000,May
1942,F.D MANGO 450G,PIECE,25,3700,78390,14110,92500,May
5810,SUNSHINE PLAIN FLAVOR,PIECE,25,500,10593,1907,12500,May
6642,YOJUS APPLE DRINK,PIECE,25,1000,21186,3814,25000,May
7378,SUMZ COATED PEANUTS CHILLI MASALA 150G,PIECE,25,3000,63559,11441,75000,May
7870,BALEMATE LOVE CHOCO 55G 2500,PIECE,25,2500,52966,9534,62500,May
6876,"GREENS (NAKATI,DODO ETC)",PIECE,25.7,5842,127203,22897,150100,May
86,ALWAYS EXTRA LONG,PIECE,26,3500,77119,13881,91000,May
1246,COLGATE CHARCOAL TWIN TOOTHBRUSH,PIECE,26,4000,88136,15864,104000,May
2716,JAMAA WHITE WASHING BAR,PIECE,26,6000,132203,23797,156000,May
5356,SILVER PLATE 500,PIECE,26,500,11017,1983,13000,May
5735,SUMZ CORN CRAX 160G,PIECE,26,2596,57203,10297,67500,May
5808,SUNSHINE CHICKEN FLAVOR,PIECE,26,500,11017,1983,13000,May
6271,UBISCO CREAMS CHOCOLATE,PIECE,26,1000,22034,3966,26000,May
1484,DATES 1000,PIECE,27,1000,22881,4119,27000,May
1958,F.D STRAWBERRY FLAVOURED 250ML,PIECE,27,2000,45763,8237,54000,May
3221,KRYSTAL WATER 500ML,PIECE,27,1000,22881,4119,27000,May
3306,LATO PLAIN YOGHURT 500G,PIECE,27,3700,84661,15239,99900,May
3311,LATO STRAWBERRY YOGHURT 500G,PIECE,27,3700,84661,15239,99900,May
6798,CADBURY DAIRY MILK 35G,PIECE,27,4000,91525,16475,108000,May
2799,JESA STRAW YOGHURT 400G,PIECE,28,2500,59322,10678,70000,May
4945,RIHAM COFFEE MALT,PIECE,28,1500,35593,6407,42000,May
5367,SIMKA CHOCO BAR 100MLS,PIECE,28,2500,59322,10678,70000,May
5625,SPRITE 2LTR,PIECE,28,5000,118644,21356,140000,May
5739,SUMZ CRISPS CHILLI 60G,PIECE,28,2500,59322,10678,70000,May
844,BROOKSIDE MILK 500ML,PIECE,29,2300,56525,10175,66700,May
1265,COLGATE TOOTBRUSH,PIECE,29,2500,61441,11059,72500,May
2234,FRUITVILLE GUAVA 500ML,PIECE,29,3500,86017,15483,101500,May
3302,LATO MIXED BERRIES 250G,PIECE,29,3000,73729,13271,87000,May
3304,LATO PEACH&CARAMEL 250G,PIECE,29,3000,73729,13271,87000,May
3322,LATO YOG STRAWBERRY 100G,PIECE,29,1200,29492,5308,34800,May
1134,CHOCOLATE 500,PIECE,30,500,12712,2288,15000,May
1949,F.D PLAIN YOGHURT 400G,PIECE,30,2500,63559,11441,75000,May
2085,FIDODIDO STRAW-VAN 120MLS,PIECE,30,1200,30508,5492,36000,May
4023,NATARAJ PENCILS 6000,PIECE,30,6000,152542,27458,180000,May
1943,F.D MIXED BERRIES 100G,PIECE,31,1200,31525,5675,37200,May
6871,POSHO KG,PIECE,31.47,5443,145169,26131,171300,May
3194,KOOKSY VAN-CHOC 120MLS,PIECE,32,1000,27119,4881,32000,May
3217,KREST 500MLS,PIECE,32,1500,40678,7322,48000,May
1608,DIVINE 500MLS,PIECE,33,4000,111864,20136,132000,May
1946,F.D MIXED BERRIES 400G,PIECE,33,2500,69915,12585,82500,May
1961,F.D UHT MILK 2000,PIECE,33,2000,55932,10068,66000,May
3196,KOOKSY VANILLA 120MLS,PIECE,33,1000,27966,5034,33000,May
3315,LATO VANILLA 100G,PIECE,33,1200,33559,6041,39600,May
5050,SAFA TOMATO PASTE 70GM,PIECE,33,1500,41949,7551,49500,May
5673,STONEY 350MLS,PIECE,33,1000,27966,5034,33000,May
1291,COMSOFT FACIAL WIPES 1000,PIECE,34,1000,28814,5186,34000,May
3319,LATO VANILLA YOGHURT 500G,PIECE,34,3700,106610,19190,125800,May
5674,STONEY 500MLS,PIECE,34,1500,43220,7780,51000,May
6943,SUMZ POTATO CRISPS FRUIT CHUTNEY 12G,PIECE,34,600,17288,3112,20400,May
7165,ONER APPLE DRINK 1LTR,PIECE,34,5000,144068,25932,170000,May
52,AFIA MIXED FRUIT 500MLS,PIECE,35,3000,88983,16017,105000,May
1969,F.D VANILLA FLAVOURED 250ML,PIECE,35,2000,59322,10678,70000,May
2682,INDOMIE BEEF NOODLES 120G,PIECE,35,2000,59322,10678,70000,May
4534,PEPSI,PIECE,35,1500,44492,8008,52500,May
5091,SANTA LUCIA 450G,PIECE,35,5000,148305,26695,175000,May
7647,SKY VIEW APPLE 320ML,PIECE,35,1000,29661,5339,35000,May
2476,HABARI SALT BIG,PIECE,36,1000,30508,5492,36000,May
5634,SQUISHY FRUIT DRINK 200ML,PIECE,36,2000,61017,10983,72000,May
6816,BLUE BAND 250G,PIECE,36,5000,152542,27458,180000,May
1169,CLASSIC G.B.K WHOLE MILK 500ML,PIECE,37,2200,68983,12417,81400,May
1960,F.D UHT 200ML MILK,PIECE,37,1000,31356,5644,37000,May
5433,SKY VIEW FRUITII 320ML,PIECE,37,1000,31356,5644,37000,May
5633,SQUISHY BLUE RASBERRY 200ML,PIECE,37,2000,62712,11288,74000,May
6894,SQUISHY JUICE APPLE,PIECE,37,2000,62712,11288,74000,May
849,BROOKSIDE STRAWBERRIES 250G,PIECE,38,3000,96610,17390,114000,May
1941,F.D MANGO 400G,PIECE,38,2500,80508,14492,95000,May
2342,GILLETTE BLUE2 PLUS,PIECE,38,2500,80508,14492,95000,May
2727,JAMIES COCONUT BREAD 1KG,PIECE,38,5500,177119,31881,209000,May
4616,PK CHEWING GUM BIG,PIECE,38,1000,32203,5797,38000,May
5758,SUMZ POTATO CRISPS TASTY TOMATO12G,PIECE,38,600,19322,3478,22800,May
6861,CASSAVA BOILED 4PCS,PIECE,38,500,16102,2898,19000,May
7876,GRILLED GOATS MEAT 8000,PIECE,38,8000,257627,46373,304000,May
4236,NUTRO CHOCOLATE BISCUITS,PIECE,39,1200,39661,7139,46800,May
4537,PEPSI MAX,PIECE,39,1000,33051,5949,39000,May
4937,RIBENA 250MLS,PIECE,39,3000,99153,17847,117000,May
7587,ONER TAMARIND 300ML,PIECE,39,1500,49576,8924,58500,May
7877,BOILED CASSAVA 1000,PIECE,39,1000,33051,5949,39000,May
347,AZAM ENERGY DRINK 300MLS,PIECE,40,1500,50847,9153,60000,May
2498,HANKIES 3000,PIECE,40,3000,101695,18305,120000,May
3458,LUXURY TOILET PAPER,PIECE,40,600,20339,3661,24000,May
7279,JUICE 4000 500ml,PIECE,40,4000,135593,24407,160000,May
55,AFIA WHITE GUAVA,PIECE,41,3000,104237,18763,123000,May
648,BIC SHEVARS,PIECE,41,1000,34746,6254,41000,May
3361,LEMON CAKES 1000,PIECE,41,1200,41695,7505,49200,May
4956,RIHAM EXOTIC TAMARIND,PIECE,41,1000,34746,6254,41000,May
5859,SWEET IVORY PCS,PIECE,41,100,3475,625,4100,May
7770,PREDATOR ENERGY 350ML,PIECE,41,2000,69492,12508,82000,May
5354,SILVER PLATE 1000,PIECE,42,1000,35593,6407,42000,May
1923,EURO SILK 2200 ORIGINAL,PIECE,43,2200,80169,14431,94600,May
5736,SUMZ CORN CRAX 80G,PIECE,43,1500,54661,9839,64500,May
3739,MIRINDA FRUITY,PIECE,44,1500,55932,10068,66000,May
5180,SCOURER 1000,PIECE,44,1000,37288,6712,44000,May
1029,CARROT CAKE,PIECE,45,5000,190678,34322,225000,May
2812,JESA VANILLA YOGHURT 400G,PIECE,45,2500,95339,17161,112500,May
4888,REBEX RICH MILK STICK BISCUITS,PIECE,45,1200,45763,8237,54000,May
5635,SQUISHY FRUIT DRINK MANGO 200ML,PIECE,45,2000,76271,13729,90000,May
5671,STING,PIECE,45,2000,76271,13729,90000,May
5672,STING RED RUSH,PIECE,45,2000,76271,13729,90000,May
836,BROOKSIDE FRUIT STRAWBERRIES,PIECE,46,5500,214407,38593,253000,May
5602,SPLASH MANGO 150ML,PIECE,46,1500,58475,10525,69000,May
3862,MOUNTAIN DEW,PIECE,47,1500,59746,10754,70500,May
5754,SUMZ POTATO CRISPS 180G,PIECE,47,5000,199153,35847,235000,May
2809,JESA VANILLA FLAVOURED 200ML,PIECE,48,1500,61017,10983,72000,May
3299,LATO MILK PWDER STRAWBERRY 15G,PIECE,48,500,20339,3661,24000,May
3736,MIRINDA APPLE,PIECE,48,1500,61017,10983,72000,May
4209,NOVIDA 500MLS,PIECE,48,1500,61017,10983,72000,May
5539,SOFTCARE SANITARY PADS,PIECE,48,3000,122034,21966,144000,May
2755,JAMIES SWEET CAKE BREAD 500G,PIECE,49,3000,124576,22424,147000,May
7815,7UP 330ML,PIECE,49,1000,41525,7475,49000,May
2684,INDOMIE NOODLES CHICKEN 120G,PIECE,50,2000,84746,15254,100000,May
5879,SWEETS 300,PIECE,50,300,12712,2288,15000,May
7706,JAMIES MILK BREAD 500G,PIECE,50,3500,148305,26695,175000,May
2032,FANTA 500MLS,PIECE,51,1500,64831,11669,76500,May
2729,JAMIE'S COOKIE SCONES,PIECE,51,2000,86441,15559,102000,May
5592,SPLASH APPLE 250MLS,PIECE,51,2000,86441,15559,102000,May
7139,SUMZ BBQ CRISPS 12G,PIECE,51,600,25932,4668,30600,May
5809,SUNSHINE ONION FLAVOR,PIECE,53,500,22458,4042,26500,May
7423,JAMIES COOKIES WHOLESALE 700,PIECE,53,700,31441,5659,37100,May
4535,PEPSI 2LTR,PIECE,54,4500,205932,37068,243000,May
5744,SUMZ DADDIES 75G 1000,PIECE,54,1500,68644,12356,81000,May
2739,JAMIES HOT DOG BUNS 6PCS,PIECE,55,4000,186441,33559,220000,May
5369,SIMKA CHOC-VAN 230MLS,PIECE,55,2000,93220,16780,110000,May
4208,NOVIDA 350MLS,PIECE,56,1000,47458,8542,56000,May
2060,FAY TP,PIECE,57,2000,96610,17390,114000,May
2736,JAMIES COOKIES 4000,PIECE,58,4000,196610,35390,232000,May
4248,NUTRO VANILLA 30G,PIECE,58,1200,58983,10617,69600,May
5717,SUGAR 1KG,PIECE,58,5500,270339,48661,319000,May
3723,MINUTE MAID BERRY BLAST 400MLS,PIECE,59,2500,125000,22500,147500,May
3863,MOUNTAIN DEW 2LTR,PIECE,59,4500,225000,40500,265500,May
1968,F.D VANILLA 450G,PIECE,60,3700,188136,33864,222000,May
3285,LATO CHOCOLATE MILK 250MLS,PIECE,60,2000,101695,18305,120000,May
4045,NESCAFE CLASSIC 2G,PIECE,60,500,25424,4576,30000,May
1289,COMPACT T.P,PIECE,61,1000,51695,9305,61000,May
3310,LATO STRAWBERRY MILK 250MLS,PIECE,61,2000,103390,18610,122000,May
3740,MIRINDA FRUITY 2LTR,PIECE,62,4500,236441,42559,279000,May
5627,SPRITE 500MLS,PIECE,62,1500,78814,14186,93000,May
7826,JAMIES CINNAMON BREAD 500G,PIECE,63,3500,186864,33636,220500,May
3729,MINUTEMAID BERRY BLAST 1LTR,PIECE,66,5000,279661,50339,330000,May
7278,JUICE 2000 300ML,PIECE,66,2000,111864,20136,132000,May
1966,F.D VANILLA 250G,PIECE,67,2500,141949,25551,167500,May
2029,FANTA 2LTRS ORANGE,PIECE,68,5000,288136,51864,340000,May
6695,JAMIES CAKE SLICE @6k,PIECE,68,6044,348305,62695,411000,May
5636,SQUISHY STRAWBERRY 200ML,PIECE,69,2000,116949,21051,138000,May
3326,LATO YOGHURT STRAWBERRY 400G,PIECE,70,2500,148305,26695,175000,May
5811,SUNSHINE TOMATO FLAVOR,PIECE,70,500,29661,5339,35000,May
6310,UKWAJU,PIECE,71,1500,90254,16246,106500,May
5749,SUMZ GONJA 90G CRISPS,PIECE,72,3000,183051,32949,216000,May
7144,JAMIES DOUGHNUT BIG CHOCOLATE 2500,PIECE,72,2500,152542,27458,180000,May
7410,ONER TAMARIND 500ML,PIECE,73,2500,154661,27839,182500,May
826,BRITANIA MUNCHIES BISCUITS,PIECE,75,500,31780,5720,37500,May
1334,COVERTINA CHOCOLATE 500,PIECE,77,500,32627,5873,38500,May
3743,MIRINDA ORANGE 330ML,PIECE,78,1000,66102,11898,78000,May
1221,COCACOLA 2LTRS,PIECE,79,5000,334746,60254,395000,May
2033,FANTA FRUIT BLAST 350ML,PIECE,79,1000,66949,12051,79000,May
2203,FRESH DAIRY MILK UHT 500ML,PIECE,80,2000,135593,24407,160000,May
3721,MINUTE MAID 1LTRS,PIECE,80,5000,338983,61017,400000,May
4615,PK CHEWING GUM 500,PIECE,80,500,33898,6102,40000,May
1957,F.D STRAWBERRY 450G,PIECE,81,3700,253983,45717,299700,May
3747,MIRINDA PINEAPPLE 330ML,PIECE,81,1000,68644,12356,81000,May
5748,SUMZ GONJA 40G,PIECE,81,1500,102966,18534,121500,May
7398,JAMIES SWEET BROWN 500G WHOLE SALE 2500,PIECE,81,2500,171610,30890,202500,May
1955,F.D STRAWBERRY 250G,PIECE,82,2500,173729,31271,205000,May
7397,JAMIES SWEET YELLOW 500G WHOLE SALE 2500,PIECE,82,2500,173729,31271,205000,May
3324,LATO YOGHURT 400G VANILLA,PIECE,85,2500,180085,32415,212500,May
3284,LATO CHOCO PWDER MILK 15G,PIECE,87,500,36864,6636,43500,May
2514,HARMONY POT WATER 1LTR,PIECE,88,2000,149153,26847,176000,May
3296,LATO MILK CHOCOLATE 125ML FLAVOURED,PIECE,88,1000,74576,13424,88000,May
5878,SWEETS 200,PIECE,88,200,14915,2685,17600,May
2431,GORILLO'S CHILLI TOMATO 24G,PIECE,90,500,38136,6864,45000,May
4984,ROCK BOOM 320MLS,PIECE,90,2000,152542,27458,180000,May
6572,WHITE STAR SOAP 1KG,PIECE,91,6500,501271,90229,591500,May
6799,SPRING ROLLS VEGETABLE 1000,PIECE,91,1000,77119,13881,91000,May
2950,KAKIRA SUGAR 1KG,PIECE,92,6000,467797,84203,552000,May
4536,PEPSI 330ML,PIECE,92,1000,77966,14034,92000,May
3316,LATO VANILLA 125ML MILK,PIECE,93,1000,78814,14186,93000,May
4961,RIHAM ONER MANGO 300ml,PIECE,96,1500,122034,21966,144000,May
2758,JAMIES SWEET WHITE BUNS 12PCS,PIECE,97,3500,287712,51788,339500,May
5626,SPRITE 350MLS,PIECE,98,1000,83051,14949,98000,May
1223,COCACOLA 500MLS,PIECE,99,1500,125847,22653,148500,May
1963,F.D VANILLA 100G,PIECE,99,1200,100678,18122,118800,May
3298,LATO MILK POWDER 15G,PIECE,100,500,42373,7627,50000,May
5477,SMILE PENS WAVE 500,PIECE,100,500,42373,7627,50000,May
5603,SPLASH MANGO 250MLS,PIECE,100,2000,169492,30508,200000,May
7130,JAMIES MUFFINS 2000,PIECE,100,2000,169492,30508,200000,May
2740,JAMIES MANDAZ 8PCS,PIECE,101,3000,256780,46220,303000,May
7431,JAMIES MARBLE CAKE 10000,PIECE,101,10000,855932,154068,1010000,May
7396,JAMIES SWEET WHITE WHOLESALE 500G 2500,PIECE,102,2500,216102,38898,255000,May
5757,SUMZ POTATO CRISPS 90G,PIECE,103,3000,261864,47136,309000,May
5375,SIMKA STRAW-VAN 230MLS,PIECE,104,2000,176271,31729,208000,May
2681,INDOMIE BEEF 70G,PIECE,105,1200,106780,19220,126000,May
6776,KEBAB 3000,PIECE,105,3000,266949,48051,315000,May
1855,EGGS PIECES,PIECE,106,500,44915,8085,53000,May
4575,PIAO PIAO TP ORIGINAL,PIECE,107,2000,181356,32644,214000,May
2752,JAMIES SWEET BROWN BREAD 500G,PIECE,109,3000,277119,49881,327000,May
3738,MIRINDA APPLE 330ML,PIECE,109,1000,92373,16627,109000,May
1967,F.D VANILLA 400G,PIECE,110,2500,233051,41949,275000,May
4349,ONER BERRIES JUICE DRINK,PIECE,110,2500,233051,41949,275000,May
6859,ROLEX NORMAL 2EGGS,PIECE,110,2500,233051,41949,275000,May
7374,JAMIES WHOLE SALE SWEET YELLOW 5000,PIECE,110,5000,466102,83898,550000,May
4348,ONER BERRIES 300ML,PIECE,112,1500,142373,25627,168000,May
1956,F.D STRAWBERRY 400G,PIECE,113,2500,239407,43093,282500,May
4960,RIHAM ONER APPLE 300ML,PIECE,117,1500,148729,26771,175500,May
7112,PUMPKIN SLICE 1000,PIECE,117,1000,99153,17847,117000,May
2754,JAMIES SWEET CAKE BREAD 1KG,PIECE,119,5500,554661,99839,654500,May
3864,MOUNTAIN DEW 300MLS,PIECE,120,1000,101695,18305,120000,May
1952,F.D STRAWBERRY 100G,PIECE,121,1200,123051,22149,145200,May
3309,LATO STRAWBERRY MILK 125MLS,PIECE,123,1000,104237,18763,123000,May
5807,SUNSHINE BEEF FLAVOR,PIECE,123,500,52119,9381,61500,May
3327,LATO YOGHURT VANILLA 200G,PIECE,124,1000,105085,18915,124000,May
2031,FANTA 330MLS,PIECE,125,1000,105932,19068,125000,May
3725,Minute maid mango,PIECE,125,2500,264831,47669,312500,May
2763,JAMIES SWEET YELLOW BUNS 6PCS,PIECE,128,3500,379661,68339,448000,May
5368,SIMKA CHOC-VAN 120MLS,PIECE,128,1000,108475,19525,128000,May
1222,COCACOLA 350MLS,PIECE,130,1000,110169,19831,130000,May
7370,JAMIES SCONES WHOLESALE 1000,PIECE,130,1000,110169,19831,130000,May
3741,MIRINDA FRUITY 330MLS,PIECE,131,1000,111017,19983,131000,May
2792,JESA MILK 1LTR,PIECE,132,3600,402712,72488,475200,May
4351,ONER MANGO 500MLS,PIECE,133,2500,281780,50720,332500,May
4024,NATARAJ PENS,PIECE,134,700,79492,14308,93800,May
2683,INDOMIE NOODLES 70G,PIECE,135,1200,137288,24712,162000,May
2748,JAMIES QUEEN CAKES 6PCS 3000,PIECE,136,3500,403390,72610,476000,May
2761,JAMIES SWEET YELLOW BREAD 500G,PIECE,137,3000,348305,62695,411000,May
647,BIC PENS,PIECE,141,700,83644,15056,98700,May
7375,JAMIES WHOLE SALE SWEET BROWN 5000,PIECE,142,5000,601695,108305,710000,May
6784,LIVER STEW 8000,PIECE,143.73,7420,903814,162686,1066500,May
6613,YAKET 550ML,PIECE,147,500,62288,11212,73500,May
6841,PIZZA CHICKEN SLICE BIG ,PIECE,147,6000,747458,134542,882000,May
6813,GRILLED CHICKEN 7000,PIECE,150,7000,889831,160169,1050000,May
2513,HARMONY POT WATER,PIECE,151,1000,127966,23034,151000,May
3325,LATO YOGHURT SRAWBERRY 200G,PIECE,152,1000,128814,23186,152000,May
4347,ONER APPLE JUICE DRINK,PIECE,153,2500,324153,58347,382500,May
7790,JAMIES CINNAMON BREAD,PIECE,153,6000,777966,140034,918000,May
2734,JAMIES DOUGH NUTS HUGE,PIECE,158,2000,267797,48203,316000,May
7829,KICK PRINCESS CHICKEN FLAVOUR ,PIECE,159,500,67373,12127,79500,May
7704,JAMIES MILK BREAD 5500,PIECE,161,6000,818644,147356,966000,May
2427,GORILLO'S BBQ BEEF 24G,PIECE,163,500,69068,12432,81500,May
7142,JAMIES MARBLE CAKE 3000,PIECE,164,3000,416949,75051,492000,May
3060,KICK SNACKS CHICKEN,PIECE,166,500,70339,12661,83000,May
2718,JAMIES BROWN BUNS 6PCS,PIECE,170,3500,504237,90763,595000,May
7650,JAMIES SWEET WHITE BUNS @4000,PIECE,172,4000,583051,104949,688000,May
2757,JAMIES SWEET WHITE BREAD 500,PIECE,179,3000,455085,81915,537000,May
2805,JESA UHT FINO,PIECE,189,2000,320339,57661,378000,May
5036,RWENZORI 1.5LTRS,PIECE,194,2000,328814,59186,388000,May
5043,RWENZORI WATER 500ML,PIECE,199,1000,168644,30356,199000,May
2759,JAMIES SWEET WHITE BUNS 6PCS,PIECE,205,3500,608051,109449,717500,May
563,BALOON 300,PIECE,213,300,54153,9747,63900,May
5756,SUMZ POTATO CRISPS 40G,PIECE,216,1500,274576,49424,324000,May
2429,GORILLO'S CHICKEN 24G,PIECE,219,500,92797,16703,109500,May
6773,VEGETABLE SAMOSA 1000,PIECE,227,1000,192373,34627,227000,May
7143,GRAVY SOUP 1000,PIECE,227.27,1003,193135,34764,227899,May
5347,SILKEE JUMBO TP,PIECE,234,2000,396610,71390,468000,May
7376,JAMIES WHOLE SALE SWEET WHITE 5000,PIECE,237,5000,1004237,180763,1185000,May
5374,SIMKA STRAW-VAN 120MLS,PIECE,245,1000,207627,37373,245000,May
6840,GONJA FRIED 1000,PIECE,247,1000,209322,37678,247000,May
182,APPLES GREEN,PIECE,253,1500,321610,57890,379500,May
6775,CHAPS 3000,PIECE,259,3000,658475,118525,777000,May
6971,SWEET POTATOES BOILED 1000,PIECE,260,1000,220339,39661,260000,May
4128,NIVANA 500MLS,PIECE,276,500,116949,21051,138000,May
6808,CRACKERS 1500,PIECE,281,2000,476271,85729,562000,May
5755,SUMZ POTATO CRISPS 20G,PIECE,285,600,144915,26085,171000,May
6779,PILAO PLAIN 10000,PIECE,286.88,10000,2431186,437614,2868800,May
6781,VEGETABLE RICE 7000,PIECE,292.95,6891,1710720,307930,2018650,May
1286,COMFORT T.P 1000,PIECE,294,1000,249153,44847,294000,May
6790,KATOGO 4000,PIECE,295.34,3999,1000822,180148,1180970,May
6970,YAM SLICE 1000,PIECE,298,1000,252542,45458,298000,May
6868,SPAGHETI 2500,PIECE,304.28,2493,642881,115719,758600,May
2751,JAMIES SWEET BROWN BREAD1KG,PIECE,314,5500,1463559,263441,1727000,May
5881,SWEETS 500,PIECE,316,500,133898,24102,158000,May
6820,BEEF SAMOSA 1500,PIECE,319,1500,405508,72992,478500,May
6807,BEAN STEW 2000,PIECE,321.36,1994,542960,97733,640693,May
7430,JAMIES SWEET YELLOW BUNS WHOLESALE 2500,PIECE,349,2500,739407,133093,872500,May
7026,CHICKEN STEW 4000,PIECE,364,4000,1233898,222102,1456000,May
7497,JAMIES SWEET BUNS BROWN 6PCS WHOLESALE,PIECE,373,2500,790254,142246,932500,May
6792,CHIPS 2500,PIECE,446.14,2519,952203,171397,1123600,May
2744,JAMIES MUFFINS,PIECE,455,1500,578390,104110,682500,May
2760,JAMIES SWEET YELLOW BREAD 1KG,PIECE,475,5500,2213983,398517,2612500,May
7727,JAMIES SWEET WHITE BUNS WHOLESALE,PIECE,479,2500,1197500,0,1197500,May
5875,SWEETS 100,PIECE,501,100,42458,7642,50100,May
6889,EGGS BOILED 500,PIECE,523,500,221610,39890,261500,May
183,APPLES RED,PIECE,532,1500,676271,121729,798000,May
6805,PANCAKES 500,PIECE,577,500,244492,44008,288500,May
2735,JAMIES DOUGH NUTS SMALL 4000,PIECE,648,3000,1647458,296542,1944000,May
6812,BEEF STEW 6000,PIECE,648,2000,1098305,197695,1296000,May
2756,JAMIES SWEET WHITE BREAD 1KG,PIECE,659,5500,3071610,552890,3624500,May
2793,JESA MILK 500ML,PIECE,1104,1800,1684068,303132,1987200,May
6788,BEEF SAUSAGES 1000,PIECE,1484,1000,1257627,226373,1484000,May
6821,CHAPATI 1000,PIECE,2910,1000,2466102,443898,2910000,May
4,180ML DISPOSABLE GLASSES,PIECE,8,3000,20339,3661,24000,June
7,300MLS DISPOSABLE GLASSES,PIECE,9,5000,38136,6864,45000,June
9,500MLS DISPOSABLE GLASSES,PIECE,3,6000,15254,2746,18000,June
12,7 DAYS BABY WIPES,PIECE,1,8500,7203,1297,8500,June
15,7DAYS ANTIBACTERIAL BABY WIPES,PIECE,3,8500,21610,3890,25500,June
16,7DAYS ANTIBACTERIAL WIPES,PIECE,6,5000,25424,4576,30000,June
18,7DAYS PANT LINERS,PIECE,4,4000,13559,2441,16000,June
26,ABC BABY WIPES,PIECE,1,9000,7627,1373,9000,June
41,ADIDAS GET READY,PIECE,1,13000,11017,1983,13000,June
49,AFIA APPLE 500ML,PIECE,17,3000,43220,7780,51000,June
51,AFIA MANGO 500MLS,PIECE,20,3000,50847,9153,60000,June
52,AFIA MIXED FRUIT 500MLS,PIECE,12,3000,30508,5492,36000,June
54,AFIA ORANGE 500ML,PIECE,12,3000,30508,5492,36000,June
55,AFIA WHITE GUAVA,PIECE,13,3000,33051,5949,39000,June
60,AFROCARE BODY LOTION 400ML,PIECE,3,6000,15254,2746,18000,June
61,AFROCARE JELLY 100G,PIECE,4,3000,10169,1831,12000,June
63,AFROCARE PETROLEUM JELLY,PIECE,2,4500,7627,1373,9000,June
71,ALLIANCE LIVEN COFFEE,PIECE,4,3500,11864,2136,14000,June
73,ALPER DRAJE CHOCOLATE,PIECE,7,3000,17797,3203,21000,June
81,ALWAYS COTTON EXTRA LONG,PIECE,9,3000,22881,4119,27000,June
86,ALWAYS EXTRA LONG,PIECE,27,3500,80085,14415,94500,June
88,ALWAYS LONG,PIECE,9,3500,26695,4805,31500,June
91,ALWAYS ULTRA THIN,PIECE,1,3500,2966,534,3500,June
92,ALWAYS ULTRA V.P,PIECE,3,6500,16525,2975,19500,June
93,ALWAYS V.P EXTRA LONG,PIECE,2,6500,11017,1983,13000,June
95,ALWAYS VALUE PACK LONG,PIECE,1,6500,5508,992,6500,June
103,AMARA COCOA BUTTER 200ML,PIECE,1,6000,5085,915,6000,June
105,AMARA COCOA BUTTER LOTION 400ML,PIECE,1,8500,7203,1297,8500,June
108,AMARA FOR MEN 400ML,PIECE,1,10000,8475,1525,10000,June
111,AMARA HYDRATING GLYCERINE 400ML LOTION,PIECE,1,8500,7203,1297,8500,June
112,AMARA MEN 200ML,PIECE,3,6000,15254,2746,18000,June
113,AMARA MEN 400ML,PIECE,5,9000,38136,6864,45000,June
114,AMARA MEN COOLING,PIECE,3,6333,16102,2898,19000,June
116,AMARA RAW SHEA LOTION 400ML,PIECE,1,8500,7203,1297,8500,June
123,AMERICAN GARDEN BBQ SAUCE 510G,PIECE,1,17000,14407,2593,17000,June
126,AMERICAN GARDEN KETCHUP 340G,PIECE,5,7800,33051,5949,39000,June
127,AMERICAN GARDEN KETCHUP 425G,PIECE,1,13500,11441,2059,13500,June
131,AMERICAN GARDEN MUSTARD 14OZ,PIECE,1,15000,12712,2288,15000,June
136,AMERICAN GREEN GARDEN HONEY 200G,PIECE,1,8000,6780,1220,8000,June
139,AMERICAN GREEN MAYONNAISE 473ML,PIECE,1,30000,25424,4576,30000,June
146,AMLA HAIR OIL 100ML,PIECE,2,7000,11864,2136,14000,June
173,ANKLE STOCKS,PIECE,2,1500,2542,458,3000,June
179,APPLE CIDER VINEGAR 473MLS,PIECE,5,11000,46610,8390,55000,June
182,APPLES GREEN,PIECE,171,1500,217373,39127,256500,June
183,APPLES RED,PIECE,452,1500,574576,103424,678000,June
186,APTAMIL 1 400G,PIECE,1,52000,44068,7932,52000,June
195,AQUAFRESH HERBAL 50ML,PIECE,2,5000,8475,1525,10000,June
208,ARIEL COLOR 1KG,PIECE,2,14500,24576,4424,29000,June
209,Ariel color and style,PIECE,2,8000,13559,2441,16000,June
211,ARIEL DOWNY 1KG,PIECE,2,15500,26271,4729,31000,June
212,ARIEL DOWNY 500G,PIECE,3,7000,17797,3203,21000,June
213,ARIEL DOWNY LAVENDER500G,PIECE,5,7500,31780,5720,37500,June
215,ARIEL ORIGINAL 1KG,PIECE,2,15000,25424,4576,30000,June
218,ARMAF AIR FRESHNER SPRING,PIECE,1,10000,8475,1525,10000,June
219,ARMAF AIR FRESHNER SUMMER,PIECE,2,10000,16949,3051,20000,June
228,ARMAF HIGH STREET WOMEN,PIECE,1,14000,11864,2136,14000,June
240,ARMAF TAG-HIM SPRAY,PIECE,1,15000,12712,2288,15000,June
245,ARMF BEAU SPLASH FOR MEN,PIECE,1,16000,13559,2441,16000,June
253,AROMAT 200G,PIECE,3,12000,30508,5492,36000,June
254,AROMAT 75G,PIECE,4,5500,18644,3356,22000,June
270,ART BOOK BIG,PIECE,3,4000,10169,1831,12000,June
271,ART BOOK SMALL,PIECE,8,2000,13559,2441,16000,June
279,ASANTEE PAPAYA SOAP,PIECE,2,6500,11017,1983,13000,June
311,AUNT PORRIDGE 1KG,PIECE,4,14000,47458,8542,56000,June
312,AUNT PORRIDGE 2KG,PIECE,1,28000,23729,4271,28000,June
313,AUNT PORRIDGE 6MONTHS,PIECE,6,14000,71186,12814,84000,June
326,AXE BLACK,PIECE,1,13000,11017,1983,13000,June
331,AXE DARK TEMPTATION,PIECE,2,12000,20339,3661,24000,June
332,AXE EXCITE BODY SPRAY,PIECE,2,13000,22034,3966,26000,June
339,AXESS AQUA,PIECE,4,9000,30508,5492,36000,June
344,AZAM BAKING FLOUR 2KG,PIECE,2,8500,14407,2593,17000,June
346,AZAM EMBE MANGO,PIECE,25,1500,31780,5720,37500,June
347,AZAM ENERGY DRINK 300MLS,PIECE,23,1500,29237,5263,34500,June
348,AZAM MALT 300MLS,PIECE,21,1500,26695,4805,31500,June
349,AZAM MALT 500MLS,PIECE,7,3000,17797,3203,21000,June
353,B.D CANDLE NUMBERS,PIECE,9,1500,11441,2059,13500,June
354,B.D CANDLES 1500,PIECE,1,1500,1271,229,1500,June
357,B.D CROWNS 2500,PIECE,2,2500,4237,763,5000,June
374,BABY BASINS 15000,PIECE,1,15000,12712,2288,15000,June
383,BABY BOTTLE 092 6000,PIECE,1,6000,5085,915,6000,June
384,BABY BOTTLE 7000,PIECE,1,7000,5932,1068,7000,June
439,BABY JUICE CUP 15000,PIECE,1,12000,10169,1831,12000,June
440,BABY JUNIOR 50G,PIECE,1,1500,1271,229,1500,June
441,BABY JUNIOR BABY OIL 90ML,PIECE,2,3500,5932,1068,7000,June
442,BABY JUNIOR JELLY 200g,PIECE,3,6000,15254,2746,18000,June
443,BABY JUNIOR JELLY 24ML,PIECE,3,700,1780,320,2100,June
454,BABY NIPPLES 700,PIECE,3,700,1780,320,2100,June
455,BABY NIPPLES BIG 1000,PIECE,12,1000,10169,1831,12000,June
466,BABY RATTLES,PIECE,1,22000,18644,3356,22000,June
486,BABY TENDER WIPES,PIECE,3,6000,15254,2746,18000,June
501,BABY&ME JELLY 120ML,PIECE,2,3000,5085,915,6000,June
523,BALLET ACTIVE VITAMIN 120MLS,PIECE,4,5000,16949,3051,20000,June
524,BALLET ACTIVE VITAMIN 300MLS,PIECE,1,9500,8051,1449,9500,June
525,BALLET ALMOMD OIL 125ML,PIECE,5,10000,42373,7627,50000,June
526,BALLET ALOE VERA 120MLS,PIECE,2,5000,8475,1525,10000,June
527,BALLET ALOE VERA JELLY 300MLS,PIECE,4,9500,32203,5797,38000,June
528,BALLET BABY JELLY 120MLS,PIECE,10,5000,42373,7627,50000,June
529,BALLET BABY JELLY 300MLS,PIECE,3,9500,24153,4347,28500,June
533,BALLET BABY MILK SOAP,PIECE,1,4000,3390,610,4000,June
536,BALLET BABY SOAP CALENDULA,PIECE,2,4000,6780,1220,8000,June
538,BALLET BUTTER BLEND 300ML,PIECE,1,9500,8051,1449,9500,June
540,BALLET HONEY SOAP,PIECE,1,4000,3390,610,4000,June
541,BALLET POWDER 100G,PIECE,1,5000,4237,763,5000,June
542,BALLET REGULAR,PIECE,6,3500,17797,3203,21000,June
543,BALLET SHEA BUTTER SOAP,PIECE,3,3500,8898,1602,10500,June
545,BALLOON NUMBERS 1500,PIECE,1,1500,1271,229,1500,June
550,BALLS 10000N HALLET,PIECE,1,12000,10169,1831,12000,June
556,BALLS AND DOLLS LIGHTING 7000,PIECE,1,7000,5932,1068,7000,June
563,BALOON 300,PIECE,162,300,41186,7414,48600,June
570,BAMBOO TOOTHPICK 2500,PIECE,5,2500,10593,1907,12500,June
577,BANNERS 7000,PIECE,1,7000,5932,1068,7000,June
598,BEACS DADDIE TIN 20000,PIECE,2,20000,33898,6102,40000,June
613,BECCA COUNTERBOOK 5000,PIECE,9,3500,26695,4805,31500,June
620,BED SHEET 38000,PIECE,1,38000,32203,5797,38000,June
627,BEIKU BABY SOOTHERS,PIECE,3,2500,6356,1144,7500,June
636,BESSA MILLET DRINK 500MLS,PIECE,20,4500,76271,13729,90000,June
637,BESSA MILLET MALT DRINK 330ML,PIECE,4,3000,10169,1831,12000,June
639,BEST RULER 1000,PIECE,4,1000,3390,610,4000,June
647,BIC PENS,PIECE,22,700,13051,2349,15400,June
648,BIC SHEVARS,PIECE,18,1000,15254,2746,18000,June
649,BI-CARBONATE SODA,PIECE,12,1000,10169,1831,12000,June
654,BIG BOSS FOR MEN 100ML,PIECE,1,3000,2542,458,3000,June
655,BIG DADDY 300 SWEETS,PIECE,59,300,15000,2700,17700,June
659,BIKERS ST MICHAEL 10000,PIECE,2,10000,16949,3051,20000,June
664,BIRTHDAY CANDLES 3500,PIECE,1,4000,3390,610,4000,June
667,BIRTHDAY CROWNS 5000,PIECE,0,4237,0,0,0,June
670,BIRTHDAY HATS 1500,PIECE,1,1500,1271,229,1500,June
671,BIRTHDAY HATS 2500,PIECE,11,2500,23305,4195,27500,June
672,BIRTHDAY HATS 3500,PIECE,2,3500,5932,1068,7000,June
673,BIRTHDAY HATS 5000,PIECE,1,5000,4237,763,5000,June
674,BIRTHDAY LETTERS 5000,PIECE,3,4667,11864,2136,14000,June
687,BIYINZIKA MUCHOMO 1.5KG,PIECE,1,28000,23729,4271,28000,June
689,BIYINZIKA SUPA 1KG,PIECE,4,20000,67797,12203,80000,June
703,BLESSED KISUBI TEA 125G,PIECE,1,5000,4237,763,5000,June
704,BLESSED KISUBI TEA 200G,PIECE,4,6000,20339,3661,24000,June
705,BLESSED KISUBI TEA 350G,PIECE,1,12000,10169,1831,12000,June
712,BLUE 4 MEN SPRAY,PIECE,1,12000,10169,1831,12000,June
713,BLUE BAND 100G,PIECE,26,2500,55085,9915,65000,June
714,BLUE BAND 1KG,PIECE,1,19000,16102,2898,19000,June
716,BLUE BAND 500G,PIECE,5,10000,42373,7627,50000,June
717,BLUE BAND LOW FAT,PIECE,3,6500,16525,2975,19500,June
718,BLUE BAND LOW SPREAD 250G,PIECE,14,4000,47458,8542,56000,June
725,BLUE LAGOON PASSION SPLASH,PIECE,1,17000,14407,2593,17000,June
729,BLUE TOILET BLOCKS DOUBLE,PIECE,7,5000,29661,5339,35000,June
731,BLUEBAND LOW FAT 100G,PIECE,8,2000,13559,2441,16000,June
737,BODY LUXE 200G ALOEVERA,PIECE,1,4000,3390,610,4000,June
740,BODY LUXE PETROLEUM JELLY,PIECE,1,4500,3814,686,4500,June
744,BODYLUXE JELLY 100G,PIECE,1,3000,2542,458,3000,June
767,BOTTLES 10000,PIECE,2,10000,16949,3051,20000,June
769,BOTTLES 15000,PIECE,1,15000,12712,2288,15000,June
771,BOTTLES 18000,PIECE,2,18000,30508,5492,36000,June
772,BOTTLES 3000,PIECE,1,3000,2542,458,3000,June
773,BOTTLES 4000,PIECE,2,4000,6780,1220,8000,June
776,BOTTLES 7000,PIECE,2,7000,11864,2136,14000,June
781,BOUNTY CHOCOLATE,PIECE,15,4000,50847,9153,60000,June
790,BOX FILES 6000,PIECE,1,7000,5932,1068,7000,June
818,BRITANIA COCO BITE BISCUIT,PIECE,2,20000,33898,6102,40000,June
820,BRITANIA DIGESTIVE 1KG,PIECE,3,20000,50847,9153,60000,June
822,BRITANIA GINGER 1KG,PIECE,2,20000,33898,6102,40000,June
824,BRITANIA MILK BISCUIT,PIECE,95,500,40254,7246,47500,June
826,BRITANIA MUNCHIES BISCUITS,PIECE,78,500,33051,5949,39000,June
828,BRITANIA NICE BISCUITS 1KG,PIECE,1,20000,16949,3051,20000,June
832,BRITANIA SHORTCAKE BISCUITS,PIECE,10,2000,16949,3051,20000,June
833,BRITANIA SHORTCAKE BISCUITS 1KG,PIECE,1,20000,16949,3051,20000,June
836,BROOKSIDE FRUIT STRAWBERRIES,PIECE,27,5500,125847,22653,148500,June
842,BROOKSIDE LEMON 250G,PIECE,16,3000,40678,7322,48000,June
843,BROOKSIDE LEMON BISCUITS 450G,PIECE,12,5500,55932,10068,66000,June
844,BROOKSIDE MILK 500ML,PIECE,30,2280,57966,10434,68400,June
845,BROOKSIDE PEAR CARAMEL,PIECE,19,5053,81356,14644,96000,June
846,BROOKSIDE PEAR CARAMEL 250G,PIECE,13,3000,33051,5949,39000,June
849,BROOKSIDE STRAWBERRIES 250G,PIECE,25,3000,63559,11441,75000,June
888,BUILDING BLOCKS GOOD PARTNER 18000,PIECE,1,18000,15254,2746,18000,June
889,BUL STAR SOAP 600G,PIECE,2,4000,6780,1220,8000,June
890,BUSHENYI HONEY 250G,PIECE,12,6000,61017,10983,72000,June
891,BUSHENYI HONEY 5OOG,PIECE,8,9000,61017,10983,72000,June
892,BUSHENYI HONEY 90G,PIECE,13,3500,38559,6941,45500,June
901,C.B CHOCOLATE CHOCO CHIP 120ML,PIECE,18,2500,38136,6864,45000,June
904,C.B CLASSIC VANILLA 1LTR,PIECE,2,19500,33051,5949,39000,June
913,C.B RIPPLES CHOCOLATE 200ML,PIECE,9,3833,29237,5263,34500,June
914,C.B RIPPLES MIXED 200MLS,PIECE,12,4000,40678,7322,48000,June
916,C.B RIPPLES STRAWBERRY 200ML,PIECE,6,4000,20339,3661,24000,June
917,C.B ROYAL MANGO 120ML,PIECE,17,2500,36017,6483,42500,June
939,CADBURY DAIRY MILK MINT CRISP 80G,PIECE,6,8000,40678,7322,48000,June
941,CADBURY DAIRYMILK 10G CHOCOLATE,PIECE,24,1500,30508,5492,36000,June
943,CADBURY DREAM WHITE CREAMY 80G,PIECE,27,8000,183051,32949,216000,June
944,CADBURY DRINKING CHOCOLATE 125G,PIECE,7,8500,50424,9076,59500,June
946,CADBURY FRUIT & NUT 80G,PIECE,6,8000,40678,7322,48000,June
949,CADBURY RUM&RAISIN 80G,PIECE,5,8000,33898,6102,40000,June
965,CAKE TOPPER 5000,PIECE,2,5000,8475,1525,10000,June
966,CAKE WRAPPER 1000,PIECE,3,1000,2542,458,3000,June
996,CANDLES 4000 PKT,PIECE,1,4000,3390,610,4000,June
1009,CAR TOYS 8000,PIECE,1,8000,6780,1220,8000,June
1017,CARAMBOLA BLACK SPOT,PIECE,6,6083,30932,5568,36500,June
1029,CARROT CAKE,PIECE,20,5000,84746,15254,100000,June
1046,CB CLASSIC VANILLA 120MLS,PIECE,15,2500,31780,5720,37500,June
1047,CB CLASSIC VANILLA 200MLS,PIECE,5,4000,16949,3051,20000,June
1048,CB CLASSIC VANILLA 500ML,PIECE,15,10000,127119,22881,150000,June
1054,CB MAGIC STRAW 500ML,PIECE,9,10000,76271,13729,90000,June
1055,CB STRAWBERRY VANILLA,PIECE,2,20000,33898,6102,40000,June
1058,CELOTAPE 2000,PIECE,5,2500,10593,1907,12500,June
1059,CELOTAPE BIGGER 1OOOO,PIECE,3,10000,25424,4576,30000,June
1060,CELOTAPE BLACK,PIECE,1,1500,1271,229,1500,June
1062,CELOTAPE BROWN SMALL,PIECE,2,3000,5085,915,6000,June
1063,CELOTAPE MEDIUM,PIECE,2,5000,8475,1525,10000,June
1064,CELOTAPE SMALL 1000,PIECE,4,1000,3390,610,4000,June
1066,CERELAC 12MONTHS 400G,PIECE,1,27000,22881,4119,27000,June
1067,CERELAC 6MONTHS,PIECE,4,27000,91525,16475,108000,June
1068,CERELAC 7MONTHS MIXEDFRUITS,PIECE,1,27000,22881,4119,27000,June
1093,CHAMPION A4 200PAGES,PIECE,1,4000,3390,610,4000,June
1094,CHAMPION A4 96 PAGES,PIECE,1,2000,1695,305,2000,June
1095,CHAPA BAKING POWDER,PIECE,2,1500,2542,458,3000,June
1096,CHAPA NYOTA BLUE 600G,PIECE,4,4000,13559,2441,16000,June
1097,CHAPA NYOTA BROWN 600G,PIECE,6,4000,20339,3661,24000,June
1111,CHERRY COTTON BUDS,PIECE,2,2500,4237,763,5000,June
1112,CHERRY COTTON BUDS 150,PIECE,1,3000,2542,458,3000,June
1128,CHILDREN'S UNDERWEAR 20000,PIECE,1,20000,16949,3051,20000,June
1131,CHINA GREEN TEA 50G,PIECE,10,5000,42373,7627,50000,June
1134,CHOCOLATE 500,PIECE,29,500,12288,2212,14500,June
1166,PICFARE GOLD 96PGS,PIECE,4,1000,3390,610,4000,June
1169,CLASSIC G.B.K WHOLE MILK 500ML,PIECE,12,2200,22373,4027,26400,June
1176,CLEAR BAG 1000,PIECE,9,1000,7627,1373,9000,June
1186,CLERE BABY JELLY 100G,PIECE,2,3500,5932,1068,7000,June
1191,CLERE MEN ICE 100G,PIECE,1,2000,1695,305,2000,June
1193,CLERE PETROLEUM JELLY 250G,PIECE,1,6000,5085,915,6000,June
1194,CLERE PETROLEUM JELLY100G,PIECE,1,3500,2966,534,3500,June
1196,CLIMAX BERRIES 50G,PIECE,4,2500,8475,1525,10000,June
1199,CLIMAX EXOTIC TROPICAL FRUITS 170G,PIECE,1,6000,5085,915,6000,June
1202,CLIMAX TROPICAL FRUITS 50G,PIECE,5,2500,10593,1907,12500,June
1212,CLOSEUP TRIPLEFRESH 60G,PIECE,2,3000,5085,915,6000,June
1213,CLOSEUP TRIPPLE FRESH 125G,PIECE,2,5000,8475,1525,10000,June
1221,COCACOLA 2LTRS,PIECE,93,5000,394068,70932,465000,June
1222,COCACOLA 350MLS,PIECE,206,1000,174576,31424,206000,June
1223,COCACOLA 500MLS,PIECE,61,1500,77542,13958,91500,June
1224,COCACOLA CAN 330ML,PIECE,15,2700,34322,6178,40500,June
1227,COCACOLA ZERO 350ML,PIECE,1,1000,847,153,1000,June
1241,COCOS COCONUT BAR,PIECE,8,1000,6780,1220,8000,June
1244,COLGATE 0-2YEARS,PIECE,5,4000,16949,3051,20000,June
1245,COLGATE CHARCOAL GENTLE CLEAN,PIECE,10,7500,63559,11441,75000,June
1246,COLGATE CHARCOAL TWIN TOOTHBRUSH,PIECE,13,4000,44068,7932,52000,June
1247,COLGATE CHILDREN 50MLS,PIECE,5,4500,19068,3432,22500,June
1248,COLGATE DEEP CLEAN,PIECE,9,1500,11441,2059,13500,June
1249,COLGATE DOUBLE ACTION,PIECE,19,4000,64407,11593,76000,June
1252,COLGATE HERBAL 140G,PIECE,14,7500,88983,16017,105000,June
1253,COLGATE HERBAL 230G,PIECE,11,10000,93220,16780,110000,June
1254,COLGATE HERBAL 35G,PIECE,12,2500,25424,4576,30000,June
1255,COLGATE HERBAL 70G,PIECE,12,4500,45763,8237,54000,June
1256,COLGATE KIDS 2-5YEARS,PIECE,1,5000,4237,763,5000,June
1257,COLGATE MAX FRESH 65G,PIECE,5,3500,14831,2669,17500,June
1259,COLGATE MAX-FRESH 130G,PIECE,14,6500,77119,13881,91000,June
1261,COLGATE MAXIMUM CAVITY 140G,PIECE,3,7500,19068,3432,22500,June
1262,COLGATE MAXIMUM CAVITY 35G,PIECE,8,2500,16949,3051,20000,June
1263,COLGATE MAXIMUM CAVITY 70G,PIECE,4,4500,15254,2746,18000,June
1264,COLGATE NATURAL EXTRACT 75MLS,PIECE,5,9000,38136,6864,45000,June
1265,COLGATE TOOTBRUSH,PIECE,18,2500,38136,6864,45000,June
1266,COLGATE TOOTHBRUSH 1500,PIECE,2,1500,2542,458,3000,June
1267,COLGATE TOOTHBRUSH CHARCOAL,PIECE,31,2500,65678,11822,77500,June
1269,COLGATE TRIPLE ACTION 140G,PIECE,4,6500,22034,3966,26000,June
1270,COLGATE TRIPPLE ACTION 70G,PIECE,6,3917,19915,3585,23500,June
1274,COLORES NEW ELITE COLOURS BIG,PIECE,2,2000,3390,610,4000,June
1277,COMB 1500,PIECE,3,1500,3814,686,4500,June
1278,COMB 500,PIECE,5,500,2119,381,2500,June
1279,COMB WITH MIRROR 1500,PIECE,3,1500,3814,686,4500,June
1280,COMB WITH MIRROR 2500,PIECE,2,2500,4237,763,5000,June
1286,COMFORT T.P 1000,PIECE,168,1000,142373,25627,168000,June
1289,COMPACT T.P,PIECE,75,1000,63559,11441,75000,June
1290,COMPO PENS,PIECE,2,3000,5085,915,6000,June
1291,COMSOFT FACIAL WIPES 1000,PIECE,35,1000,29661,5339,35000,June
1334,COVERTINA CHOCOLATE 500,PIECE,23,500,9746,1754,11500,June
1338,COVERTINA MILK CHOCOLATE,PIECE,1,3500,2966,534,3500,June
1343,COW & GATE 1 400GM,PIECE,6,44000,223729,40271,264000,June
1352,CRANE BOOK PC 1000,PIECE,7,1000,5932,1068,7000,June
1356,CREAMBELL MAGIC STRAW120ML,PIECE,15,2500,31780,5720,37500,June
1357,CREAMBELL STRAWBERRY VAN 500ML,PIECE,7,10000,59322,10678,70000,June
1359,CREAMY EFFECT WIPES,PIECE,15,6000,76271,13729,90000,June
1376,CUPS 4000,PIECE,1,3000,2542,458,3000,June
1381,CUPS B.D 7000,PIECE,1,7000,5932,1068,7000,June
1384,CUPS STALLION 3000,PIECE,3,3000,7627,1373,9000,June
1389,CUSSON SOAP MILD&GENTLE,PIECE,5,3500,14831,2669,17500,June
1391,CUSSONS BABY OIL 100MLS,PIECE,5,9000,38136,6864,45000,June
1392,CUSSONS BABY OIL BLUE 200MLS,PIECE,3,16000,40678,7322,48000,June
1394,CUSSONS BABY PERFUMED JELLY 200ML,PIECE,2,12000,20339,3661,24000,June
1396,CUSSONS BABY UNPERFUMED JELLY 100ML,PIECE,3,5500,13983,2517,16500,June
1397,CUSSONS BABY UNPERFUMED JELLY 200ML,PIECE,1,12000,10169,1831,12000,June
1400,CUSSONS OIL PINK 100MLS,PIECE,2,9000,15254,2746,18000,June
1406,CUSSONS SOAP SOFT&SMOOTH,PIECE,6,3500,17797,3203,21000,June
1412,CUTTERS 1000,PIECE,3,1000,2542,458,3000,June
1413,CUTTERS 1500,PIECE,6,1500,7627,1373,9000,June
1423,D.L FIESTA CLASSIC 100MLS,PIECE,14,3500,41525,7475,49000,June
1424,D.L FIESTA SALTED CARAMEL,PIECE,14,4000,47458,8542,56000,June
1425,D.L MANGO 250ML,PIECE,5,5000,21186,3814,25000,June
1426,D.L MAXIMO BISCOTTI 175ML,PIECE,8,4500,30508,5492,36000,June
1427,D.L MAXIMO CARAMEL NUTS,PIECE,5,4500,19068,3432,22500,June
1428,D.L MAXIMO VAN-CHOCO FLAKES 175ML,PIECE,4,4500,15254,2746,18000,June
1429,D.L MEGA CONE VANILLA,PIECE,18,3500,53390,9610,63000,June
1430,D.L MINI FIESTA CARAMEL,PIECE,22,2500,46610,8390,55000,June
1431,D.L MINI FIESTA CLASSIC 70MLS,PIECE,32,2500,67797,12203,80000,June
1434,D.L PINACOLANDA 500ML,PIECE,5,10000,42373,7627,50000,June
1437,D.L VAN.STRAW 250ML,PIECE,10,5000,42373,7627,50000,June
1442,D.L VANILLA 250ML,PIECE,8,4875,33051,5949,39000,June
1443,D.L VANILLA 500ML,PIECE,4,9500,32203,5797,38000,June
1444,D.L VANILLA CREAM 120MLS,PIECE,22,2000,37288,6712,44000,June
1445,D.L VAN-STRAW 120ML,PIECE,18,2000,30508,5492,36000,June
1447,D.L VAN-STRAW 500ML,PIECE,7,9571,56780,10220,67000,June
1448,DABUR CLOVE VALUE PACK,PIECE,3,11000,27966,5034,33000,June
1450,DABUR HERBAL CLOVE 150G,PIECE,9,6000,45763,8237,54000,June
1453,DABUR NEEM TOOTHPASTE 150G,PIECE,7,6000,35593,6407,42000,June
1457,DAIRIES 12000,PIECE,2,15000,25424,4576,30000,June
1461,DAIRY MILK PLAIN 80G,PIECE,15,8000,101695,18305,120000,June
1462,DAIRY MILK TOP DECK 80G,PIECE,10,8000,67797,12203,80000,June
1464,DAIRY TOP YOGHURT STRAWBERRY 250G,PIECE,40,1000,33898,6102,40000,June
1471,DAITY CAPPUCCINO VANILLA ICE CREAM,PIECE,8,5563,37712,6788,44500,June
1477,DAITY VANILLA ICECREAM,PIECE,8,5500,37288,6712,44000,June
1484,DATES 1000,PIECE,6,1000,5085,915,6000,June
1485,DATES 2000,PIECE,7,2000,11864,2136,14000,June
1486,DATES 3000,PIECE,7,3500,20763,3737,24500,June
1487,DATES 5000,PIECE,3,5500,13983,2517,16500,June
1499,DEAR BODY SUNDAY BODY MIST,PIECE,1,16000,13559,2441,16000,June
1500,DEAR BODY THURSDAY BODY MIST,PIECE,2,16000,27119,4881,32000,June
1510,DELIDENT MAX 70G,PIECE,4,2000,6780,1220,8000,June
1511,DELLA CHOCOLATE,PIECE,3,3000,7627,1373,9000,June
1512,DELUXE ALUMINIUM FOIL,PIECE,14,6500,77119,13881,91000,June
1525,DENTAL FLOSS,PIECE,6,2583,13136,2364,15500,June
1527,DENTEX TOOTHBRUSH SOFT,PIECE,7,3500,20763,3737,24500,June
1538,DESSERT NOTE BOOK 4000,PIECE,4,4500,15254,2746,18000,June
1539,DETTOL 125MLS,PIECE,1,9000,7627,1373,9000,June
1540,DETTOL ACTIVE 175G,PIECE,3,6500,16525,2975,19500,June
1543,DETTOL COOL 175G,PIECE,2,6500,11017,1983,13000,June
1544,DETTOL EVENTONE 175G,PIECE,2,6500,11017,1983,13000,June
1547,DETTOL FRESH 175G,PIECE,6,6500,33051,5949,39000,June
1548,DETTOL FRESH 90G,PIECE,3,4500,11441,2059,13500,June
1550,DETTOL HERBAL 105G,PIECE,4,4500,15254,2746,18000,June
1551,DETTOL HERBAL 175G,PIECE,6,6500,33051,5949,39000,June
1552,DETTOL JUNIORS GLYCERINE SOAP 100G,PIECE,3,4500,11441,2059,13500,June
1553,DETTOL LIQUID 250 MLS,PIECE,3,15000,38136,6864,45000,June
1555,DETTOL LIQUID 50MLS,PIECE,3,4000,10169,1831,12000,June
1557,DETTOL ORIGINAL 100G,PIECE,4,4500,15254,2746,18000,June
1558,DETTOL ORIGINAL 175G,PIECE,7,6500,38559,6941,45500,June
1560,DETTOL SKINCARE 175G,PIECE,3,6500,16525,2975,19500,June
1568,DEXE BLACK HAIR SHAMPOO,PIECE,20,2000,33898,6102,40000,June
1595,DISPOSABLE FORKS 2500,PIECE,3,4000,10169,1831,12000,June
1600,DISPOSABLE PLATES 6000,PIECE,2,6000,10169,1831,12000,June
1602,DISPOSABLE PLATES 9 ROUND,PIECE,2,6500,11017,1983,13000,June
1607,DIVINE 300MLS,PIECE,40,2500,84746,15254,100000,June
1608,DIVINE 500MLS,PIECE,38,4000,128814,23186,152000,June
1633,DOLBY SPORT SPRAY,PIECE,4,12000,40678,7322,48000,June
1640,DOLL 20000,PIECE,1,20000,16949,3051,20000,June
1642,DOLL 3000,PIECE,1,3000,2542,458,3000,June
1643,DOLL 4000,PIECE,1,4000,3390,610,4000,June
1644,DOLL 8000,PIECE,5,8000,33898,6102,40000,June
1653,DOLLS 2000,PIECE,1,2000,1695,305,2000,June
1659,DOLLS MOTHER 6000,PIECE,1,6000,5085,915,6000,June
1662,DOLPHIN MONDI PAPERS,PIECE,1,27000,22881,4119,27000,June
1666,DOMS COLOUR PENCILS LONG,PIECE,3,7000,17797,3203,21000,June
1667,DOMS COLOUR PENCILS SHORT,PIECE,3,4000,10169,1831,12000,June
1687,DOUBLE A REAM,PIECE,2,29000,49153,8847,58000,June
1688,DOUBLE REFINED SALT 650G,PIECE,5,7000,29661,5339,35000,June
1698,DOVE DEEPLY NOURISHING SHOWER GEL 500ML,PIECE,1,22000,18644,3356,22000,June
1718,DOVE ORIGINAL SOAP 135G,PIECE,6,6500,33051,5949,39000,June
1721,DOVE PAMPERING SHOWER GEL 500ML,PIECE,1,22000,18644,3356,22000,June
1723,DOVE PINK ROSA SOAP 135G,PIECE,3,6500,16525,2975,19500,June
1734,DOVE ROLLON GRAPEFRUIT,PIECE,1,11000,9322,1678,11000,June
1742,DOVE SOAP CUCUMBER GO FRESH,PIECE,1,7500,6356,1144,7500,June
1743,DOVE SOAP EXFOLIACION SUAVE 135G,PIECE,1,7500,6356,1144,7500,June
1745,DOVE SOAP PURELY PAMPERING 135G,PIECE,3,7500,19068,3432,22500,June
1750,DOWNY FEEL LUX 20ML,PIECE,14,700,8305,1495,9800,June
1753,DOWNY VALLEY DEW 20ML,PIECE,68,700,40339,7261,47600,June
1758,DREAM PANT LINERS,PIECE,9,2500,19068,3432,22500,June
1759,DRINKING CHOCOLATE 225G,PIECE,1,15000,12712,2288,15000,June
1762,DRUM TOYS 3000,PIECE,1,4000,3390,610,4000,June
1768,DURACELL AA ORIGINAL,PIECE,2,7000,11864,2136,14000,June
1769,DURACELL AA PLUS,PIECE,4,6000,20339,3661,24000,June
1770,DURACELL AAA,PIECE,1,7000,5932,1068,7000,June
1773,DURU CUCUMBER,PIECE,2,4500,7627,1373,9000,June
1774,DURU DOLCE ALMOND,PIECE,3,4500,11441,2059,13500,June
1775,DURU ENERGIZING HONEY,PIECE,1,4500,3814,686,4500,June
1778,DURU FRESH SENSATION 4PC,PIECE,2,16000,27119,4881,32000,June
1784,DURU MOUNTAINAIR SOAP,PIECE,1,14000,11864,2136,14000,June
1785,DURU NATURAL CARE,PIECE,5,4500,19068,3432,22500,June
1786,DURU NATURAL OLIVE 720G,PIECE,2,18000,30508,5492,36000,June
1788,DURU OCEAN BREEZE SOAP,PIECE,2,14000,23729,4271,28000,June
1790,DURU REFRESHING LEMON,PIECE,1,14000,11864,2136,14000,June
1796,DUST PAN 7000,PIECE,1,7000,5932,1068,7000,June
1804,E.A HONEY 1LTR,PIECE,1,29000,24576,4424,29000,June
1813,EAGLE DISPOSABLE FORKS AND SPOONS,PIECE,2,4000,6780,1220,8000,June
1814,EARBUDS 2500,PIECE,3,1000,2542,458,3000,June
1816,EAST AFRICAN HONEY 350G,PIECE,3,13000,33051,5949,39000,June
1818,EAST AFRICAN ORGANIC HONEY 100G,PIECE,2,3500,5932,1068,7000,June
1819,EAST AFRICAN ORGANIC HONEY 250G,PIECE,4,8000,27119,4881,32000,June
1820,EAST AFRICAN ORGANIC HONEY 450G,PIECE,2,12000,20339,3661,24000,June
1823,ECLAIRS,PIECE,20,200,3390,610,4000,June
1833,ED PINK PEA SPLASH,PIECE,1,16000,13559,2441,16000,June
1853,EGGS HALF TRAY,PIECE,3,7000,17797,3203,21000,June
1855,EGGS PIECES,PIECE,85,500,36017,6483,42500,June
1856,EGGS TRAY,PIECE,16,14000,189831,34169,224000,June
1863,ELEGANT AIR FRESHENER,PIECE,2,7000,11864,2136,14000,June
1868,ELEGANT BAKHOUR AIR FRESHNER,PIECE,3,6500,16525,2975,19500,June
1874,ELEGANT FLORAL LEMON A.F,PIECE,2,7000,11864,2136,14000,June
1891,ELGON BLEND COFFEE 100G,PIECE,2,8000,13559,2441,16000,June
1898,EMOTION POUR FEMME SPRAY,PIECE,1,12000,10169,1831,12000,June
1908,ENVELOPE A4,PIECE,14,500,5932,1068,7000,June
1910,ENVELOPES 200,PIECE,23,200,3898,702,4600,June
1911,ENVELOPES 300,PIECE,2,300,508,92,600,June
1913,EPIDERM CREME 15G,PIECE,1,2500,2119,381,2500,June
1914,ERASER RUBBER,PIECE,9,500,3814,686,4500,June
1915,ERASER RUBBER BIG,PIECE,4,1000,3390,610,4000,June
1923,EURO SILK 2200 ORIGINAL,PIECE,120,2200,223729,40271,264000,June
1931,EVERVESS,PIECE,25,1000,21186,3814,25000,June
1932,EVERVESS 500ML,PIECE,1,1500,1271,229,1500,June
1934,EXCEL GLUCOSE 250G,PIECE,1,6500,5508,992,6500,June
1935,EXOTIC 320MLS,PIECE,20,1000,16949,3051,20000,June
1936,F.D CHOCOLATE MILK 250MLS,PIECE,29,2000,49153,8847,58000,June
1937,F.D FLAVOURED CHOCOLATE,PIECE,17,4000,57627,10373,68000,June
1941,F.D MANGO 400G,PIECE,15,2500,31780,5720,37500,June
1942,F.D MANGO 450G,PIECE,18,3700,56441,10159,66600,June
1943,F.D MIXED BERRIES 100G,PIECE,1,1200,1017,183,1200,June
1946,F.D MIXED BERRIES 400G,PIECE,35,2500,74153,13347,87500,June
1949,F.D PLAIN YOGHURT 400G,PIECE,26,2500,55085,9915,65000,June
1950,F.D PLAIN YOGHURT 450G,PIECE,17,3700,53305,9595,62900,June
1952,F.D STRAWBERRY 100G,PIECE,182,1200,185085,33315,218400,June
1955,F.D STRAWBERRY 250G,PIECE,55,2500,116525,20975,137500,June
1956,F.D STRAWBERRY 400G,PIECE,161,2500,341102,61398,402500,June
1957,F.D STRAWBERRY 450G,PIECE,65,3700,203814,36686,240500,June
1958,F.D STRAWBERRY FLAVOURED 250ML,PIECE,48,2000,81356,14644,96000,June
1959,F.D STRAWBERRY MILK 500MLS,PIECE,15,4000,50847,9153,60000,June
1960,F.D UHT 200ML MILK,PIECE,51,1000,43220,7780,51000,June
1961,F.D UHT MILK 2000,PIECE,24,2000,40678,7322,48000,June
1963,F.D VANILLA 100G,PIECE,160,1200,162712,29288,192000,June
1966,F.D VANILLA 250G,PIECE,54,2500,114407,20593,135000,June
1967,F.D VANILLA 400G,PIECE,111,2500,235169,42331,277500,June
1968,F.D VANILLA 450G,PIECE,57,3700,178729,32171,210900,June
1969,F.D VANILLA FLAVOURED 250ML,PIECE,38,2000,64407,11593,76000,June
1970,F.D VANILLA MILK 500MLS,PIECE,9,4000,30508,5492,36000,June
1971,F.D YOGHURT MIXED BERRIES 450G,PIECE,21,3700,65847,11853,77700,June
1975,FA DRY PROTECT,PIECE,1,6500,5508,992,6500,June
1982,FA INVISIBLE POWER,PIECE,2,6500,11017,1983,13000,June
1987,FA MYSTIC MOMENTS,PIECE,1,6500,5508,992,6500,June
1989,FA PINK PASSION ROLLON,PIECE,5,6500,27542,4958,32500,June
1997,FACE B.D MASKS 2000,PIECE,1,2000,1695,305,2000,June
1999,FACE TOWEL 1000,PIECE,14,1357,16102,2898,19000,June
2000,FACE TOWEL 1500,PIECE,12,1500,15254,2746,18000,June
2014,FAMILY CAREPERFUMED JELLY 500G,PIECE,1,10000,8475,1525,10000,June
2023,FAMILY TEA 250G,PIECE,1,7500,6356,1144,7500,June
2029,FANTA 2LTRS ORANGE,PIECE,39,5000,165254,29746,195000,June
2030,FANTA 330ML CAN,PIECE,11,2700,25169,4531,29700,June
2031,FANTA 330MLS,PIECE,130,1000,110169,19831,130000,June
2032,FANTA 500MLS,PIECE,43,1500,54661,9839,64500,June
2033,FANTA FRUIT BLAST 350ML,PIECE,26,1000,22034,3966,26000,June
2060,FAY TP,PIECE,24,2000,40678,7322,48000,June
2061,FEATHERS PADS REGULAR,PIECE,2,3000,5085,915,6000,June
2070,FIDODIDO CHOCOLATE 120ML,PIECE,1,1200,1017,183,1200,June
2071,FIDODIDO CHOCOLATE 250ML,PIECE,2,4000,6780,1220,8000,June
2072,FIDODIDO CHOCO-VAN 220ML,PIECE,19,2500,40254,7246,47500,June
2085,FIDODIDO STRAW-VAN 120MLS,PIECE,48,1200,48814,8786,57600,June
2087,FIDODIDO STRAW-VANI 250ML,PIECE,3,4000,10169,1831,12000,June
2088,FIDODIDO STRAW-VANI 500ML,PIECE,3,5000,12712,2288,15000,June
2089,FIDODIDO STRWABERRY 220ML,PIECE,30,2500,63559,11441,75000,June
2090,FIDODIDO VANILLA 120MLS,PIECE,18,1200,18305,3295,21600,June
2093,FIDODIDO VANILLA 500ML,PIECE,2,5000,8475,1525,10000,June
2112,FLOWERS 1500,PIECE,1,1500,1271,229,1500,June
2113,FLOWERS 2000,PIECE,2,2000,3390,610,4000,June
2114,FLYMEEGO VESTS 25000,PIECE,1,25000,21186,3814,25000,June
2120,FOGG BOLD ROLLON 50MLS,PIECE,1,8500,7203,1297,8500,June
2129,FOGG MASTER AGAR,PIECE,1,18500,15678,2822,18500,June
2131,FOGG MASTER OAK,PIECE,2,18500,31356,5644,37000,June
2132,FOGG MASTER PINE,PIECE,1,18500,15678,2822,18500,June
2133,FOGG MONARCH,PIECE,1,18000,15254,2746,18000,June
2154,FOOD COLOUR ORANGE,PIECE,2,1000,1695,305,2000,June
2155,FOOD COLOUR PINK,PIECE,2,1000,1695,305,2000,June
2174,FORTUNE BUTTO 1LTR,PIECE,11,8500,79237,14263,93500,June
2175,FORTUNE BUTTO 500ML,PIECE,8,4500,30508,5492,36000,June
2176,FORTUNE GOLD 1LTR,PIECE,3,10000,25424,4576,30000,June
2177,FORTUNE GOLD 3LTR,PIECE,3,28000,71186,12814,84000,June
2178,FORTUNE GOLD 500ML,PIECE,7,5000,29661,5339,35000,June
2180,FORTUNE SPAGHETTI 250G,PIECE,17,2000,28814,5186,34000,June
2181,FORTUNE SPAGHETTI 450,PIECE,11,3500,32627,5873,38500,June
2183,FOUNTAIN PEN,PIECE,14,8000,94915,17085,112000,June
2203,FRESH DAIRY MILK UHT 500ML,PIECE,63,2000,106780,19220,126000,June
2209,FRESH UP TOOTHPASTE,PIECE,4,2000,6780,1220,8000,June
2233,FRUITVILLE APPLE DRINK,PIECE,10,3500,29661,5339,35000,June
2234,FRUITVILLE GUAVA 500ML,PIECE,28,3500,83051,14949,98000,June
2235,FRUITVILLE MANGO 500ML,PIECE,8,3500,23729,4271,28000,June
2280,GARDEN TEA 100G,PIECE,6,5000,25424,4576,30000,June
2281,GARDEN TEA 250,PIECE,1,14000,11864,2136,14000,June
2283,GARDEN TEA 50G,PIECE,4,2500,8475,1525,10000,June
2284,GARDEN TEA BAGS 100G,PIECE,3,6500,16525,2975,19500,June
2286,GEISHA ALOE VERA&HONEY,PIECE,7,4000,23729,4271,28000,June
2288,GEISHA ALOEVERA &HONEY 125G,PIECE,5,2500,10593,1907,12500,June
2289,GEISHA COCONUT MILK 200G,PIECE,9,4000,30508,5492,36000,June
2290,GEISHA COCONUTMILK 125G,PIECE,11,2500,23305,4195,27500,June
2291,GEISHA LEMON&HONEY,PIECE,8,4000,27119,4881,32000,June
2292,GEISHA LEMON&HONEY 125G,PIECE,15,2500,31780,5720,37500,June
2294,GEISHA MORINGA OIL 125G,PIECE,5,4000,16949,3051,20000,June
2295,GEISHA MORINGA OIL 225G,PIECE,4,5500,18644,3356,22000,June
2296,GEISHA ROSE&HONEY,PIECE,8,2500,16949,3051,20000,June
2298,GEISHA ROSE&HONEY 225G,PIECE,4,4000,13559,2441,16000,June
2299,GEISHA SHEA AND ALMOND BUTTER SOAP 225G,PIECE,7,5500,32627,5873,38500,June
2302,GEISHA TRADITIONAL BLACK SOAP,PIECE,11,5500,51271,9229,60500,June
2303,GEISHA TRADITIONAL BLACK SOAP 125G,PIECE,7,4000,23729,4271,28000,June
2310,GIFT BAG 1500,PIECE,2,2000,3390,610,4000,June
2311,GIFT BAG 2500,PIECE,2,2500,4237,763,5000,June
2315,GIFT BAG 4500,PIECE,2,4500,7627,1373,9000,June
2317,GIFT BAG FLORAL LARGE,PIECE,4,6000,20339,3661,24000,June
2342,GILLETTE BLUE2 PLUS,PIECE,19,2500,40254,7246,47500,June
2344,GIRL BIKE 8000,PIECE,2,8000,13559,2441,16000,June
2345,GIRL FRIEND FANTASY LOTION 500ML,PIECE,1,7000,5932,1068,7000,June
2372,GLOW BODY MILK 250G,PIECE,1,5000,4237,763,5000,June
2389,GOLDEN ALUMINIUM FOIL,PIECE,2,34000,57627,10373,68000,June
2393,GOLDEN CLING FILM 25000,PIECE,1,25000,21186,3814,25000,June
2408,GOLDEN SPEED YEAST,PIECE,2,13000,22034,3966,26000,June
2413,GOOD DAY CASHEW COOKIES,PIECE,1,2600,2203,397,2600,June
2414,GOOD DAY CHOCO CHIP,PIECE,5,5000,21186,3814,25000,June
2416,GOOD DOCTOR KIDS TOOTH,PIECE,2,1000,1695,305,2000,June
2427,GORILLO'S BBQ BEEF 24G,PIECE,228,500,96610,17390,114000,June
2429,GORILLO'S CHICKEN 24G,PIECE,271,500,114831,20669,135500,June
2431,GORILLO'S CHILLI TOMATO 24G,PIECE,106,500,44915,8085,53000,June
2450,GRAPES 12000,PIECE,15,12467,158475,28525,187000,June
2454,GREEN POLYTHENE,PIECE,3,300,763,137,900,June
2455,GREEN RIVER POWDER 5G,PIECE,4,1000,3390,610,4000,June
2476,HABARI SALT BIG,PIECE,22,1000,18644,3356,22000,June
2477,HABARI SALT SMALL,PIECE,10,700,5932,1068,7000,June
2479,HACO RULER,PIECE,4,2000,6780,1220,8000,June
2480,HACO RULER ORIGINAL,PIECE,5,2000,8475,1525,10000,June
2489,HAND SCRUBBING BRUSH 2000,PIECE,1,2000,1695,305,2000,June
2498,HANKIES 3000,PIECE,14,3000,35593,6407,42000,June
2513,HARMONY POT WATER,PIECE,77,1000,65254,11746,77000,June
2514,HARMONY POT WATER 1LTR,PIECE,86,2000,145763,26237,172000,June
2517,HARPIC MOUNTAIN PINE,PIECE,2,15000,25424,4576,30000,June
2520,HARPIC POWER PLUS 500ML,PIECE,3,15000,38136,6864,45000,June
2528,HEINZ BAKED BEANS 415G,PIECE,1,8000,6780,1220,8000,June
2530,HEINZ KETCHUP 300G,PIECE,8,8000,54237,9763,64000,June
2538,HERMELA GUEST SOAP,PIECE,5,3500,14831,2669,17500,June
2558,HIT INSECT KILLER GREEN TEA 400ML,PIECE,1,17000,14407,2593,17000,June
2559,HIT INSECT KILLER GREENTEA 275ML,PIECE,2,12000,20339,3661,24000,June
2560,HIT INSECT KILLER LEMON 275ML,PIECE,1,12000,10169,1831,12000,June
2564,HIT LILY BLOSSOM 275ML,PIECE,2,12000,20339,3661,24000,June
2598,HOT PEPPER POWDER,PIECE,2,4000,6780,1220,8000,June
2623,HUGGIES S.4 H.C,PIECE,1,45000,38136,6864,45000,June
2628,HUGGIES WIPES NATURAL CARE,PIECE,1,9000,7627,1373,9000,June
2636,IBON ELVAN SWEETS,PIECE,21,200,3559,641,4200,June
2651,IMPERIAL LEATHER 4*175,PIECE,8,13000,88136,15864,104000,June
2657,IMPERIAL LEATHER MEN 175G,PIECE,1,4500,3814,686,4500,June
2663,IMPERIAL LEATHER SOAP RED 175G,PIECE,8,4000,27119,4881,32000,June
2666,IMPERIAL LEATHER SPORT 175G,PIECE,2,4500,7627,1373,9000,June
2673,INDO CAFE 50G,PIECE,1,10000,8475,1525,10000,June
2674,INDOCAFE 100G,PIECE,2,17500,29661,5339,35000,June
2676,INDOCAFE CAPPUCCINO CREAMY,PIECE,6,3000,15254,2746,18000,June
2681,INDOMIE BEEF 70G,PIECE,68,1200,69153,12447,81600,June
2682,INDOMIE BEEF NOODLES 120G,PIECE,46,2000,77966,14034,92000,June
2683,INDOMIE NOODLES 70G,PIECE,85,1200,86441,15559,102000,June
2684,INDOMIE NOODLES CHICKEN 120G,PIECE,19,2000,32203,5797,38000,June
2710,JAGO AFTERSHAVE 300MLS,PIECE,1,7500,6356,1144,7500,June
2712,JAGO AFTERSHAVE BALM 250MLS,PIECE,1,3500,2966,534,3500,June
2714,JAGO SCRUB 250G,PIECE,3,7500,19068,3432,22500,June
2715,JAGO SCRUB 500G,PIECE,1,13000,11017,1983,13000,June
2716,JAMAA WHITE WASHING BAR,PIECE,12,6000,61017,10983,72000,June
2718,JAMIES BROWN BUNS 6PCS,PIECE,168,3500,498305,89695,588000,June
2719,JAMIES BROWN SALT BREAD 1KG,PIECE,19,5500,88559,15941,104500,June
2720,JAMIES BROWN SALT BREAD 500G,PIECE,21,3000,53390,9610,63000,June
2721,JAMIES CAKE @70k,PIECE,1,70000,59322,10678,70000,June
2724,JAMIES CAKES @ 40K,PIECE,5,40000,169492,30508,200000,June
2725,JAMIES CAKES @50k,PIECE,11,50000,466102,83898,550000,June
2726,JAMIES CAKES @60K,PIECE,7,59286,351695,63305,415000,June
2727,JAMIES COCONUT BREAD 1KG,PIECE,43,5477,199576,35924,235500,June
2728,JAMIES COCONUT BREAD 500G,PIECE,23,3000,58475,10525,69000,June
2729,JAMIE'S COOKIE SCONES,PIECE,40,2000,67797,12203,80000,June
2730,JAMIES CROCKDILE BREAD 1KG,PIECE,9,6000,45763,8237,54000,June
2734,JAMIES DOUGH NUTS HUGE,PIECE,181,2000,306780,55220,362000,June
2735,JAMIES DOUGH NUTS SMALL 4000,PIECE,732,3000,1861017,334983,2196000,June
2736,JAMIES COOKIES 4000,PIECE,76,4000,257627,46373,304000,June
2739,JAMIES HOT DOG BUNS 6PCS,PIECE,61,4000,206780,37220,244000,June
2740,JAMIES MANDAZ 8PCS,PIECE,77,3000,195763,35237,231000,June
2744,JAMIES MUFFINS,PIECE,498,1500,633051,113949,747000,June
2748,JAMIES QUEEN CAKES 6PCS 3000,PIECE,154,3500,456780,82220,539000,June
2751,JAMIES SWEET BROWN BREAD1KG,PIECE,234,5500,1090678,196322,1287000,June
2752,JAMIES SWEET BROWN BREAD 500G,PIECE,114,3000,289831,52169,342000,June
2754,JAMIES SWEET CAKE BREAD 1KG,PIECE,126,5500,587288,105712,693000,June
2755,JAMIES SWEET CAKE BREAD 500G,PIECE,45,3000,114407,20593,135000,June
2756,JAMIES SWEET WHITE BREAD 1KG,PIECE,483,5498,2250424,405076,2655500,June
2757,JAMIES SWEET WHITE BREAD 500,PIECE,164,3000,416949,75051,492000,June
2758,JAMIES SWEET WHITE BUNS 12PCS,PIECE,119,3500,352966,63534,416500,June
2759,JAMIES SWEET WHITE BUNS 6PCS,PIECE,150,3500,444915,80085,525000,June
2760,JAMIES SWEET YELLOW BREAD 1KG,PIECE,319,5500,1486864,267636,1754500,June
2761,JAMIES SWEET YELLOW BREAD 500G,PIECE,134,3000,340678,61322,402000,June
2763,JAMIES SWEET YELLOW BUNS 6PCS,PIECE,94,3500,278814,50186,329000,June
2765,JAMIES TWISTED BREAD 1KG,PIECE,6,6000,30508,5492,36000,June
2780,JESA CHOCOLATE FLAVOURED MILK 200ML,PIECE,54,1500,68644,12356,81000,June
2781,JESA FINO BOX,BOX,5,24000,101695,18305,120000,June
2783,JESA FLAVOURED MILK BOX,BOX,3,30000,76271,13729,90000,June
2789,JESA FRUIT STRAWBERRY 500G,PIECE,18,6000,91525,16475,108000,June
2791,JESA LONGLIFE UHT BOX,BOX,2,38000,64407,11593,76000,June
2792,JESA MILK 1LTR,PIECE,164,3598,500000,90000,590000,June
2793,JESA MILK 500ML,PIECE,1153,1800,1758814,316586,2075400,June
2794,JESA MILK UHT 500ML,PIECE,52,2200,96949,17451,114400,June
2796,JESA PLAIN YOGHURT 500G,PIECE,6,3700,18814,3386,22200,June
2799,JESA STRAW YOGHURT 400G,PIECE,51,2500,108051,19449,127500,June
2802,JESA STRAWBERRY YOGHURT 500G,PIECE,21,3700,65847,11853,77700,June
2803,JESA TOFFEE 250G,PIECE,10,2500,21186,3814,25000,June
2804,JESA TOFFEE YOGHURT 500G,PIECE,16,3700,50169,9031,59200,June
2805,JESA UHT FINO,PIECE,102,2000,172881,31119,204000,June
2808,JESA VANILLA 250G YOG SACHET,PIECE,16,1000,13559,2441,16000,June
2809,JESA VANILLA FLAVOURED 200ML,PIECE,47,1500,59746,10754,70500,June
2811,JESA VANILLA YOGHURT 250G,PIECE,8,2500,16949,3051,20000,June
2812,JESA VANILLA YOGHURT 400G,PIECE,45,2500,95339,17161,112500,June
2813,JESA VANILLA YOGHURT 500G,PIECE,15,3700,47034,8466,55500,June
2815,JESA YOGHURT STRAWBERRY 250G,PIECE,20,1000,16949,3051,20000,June
2825,JIB WATER 20LTRS REFILL,PIECE,13,8000,88136,15864,104000,June
2829,JIK COLOURS 1LTRS,PIECE,2,16000,27119,4881,32000,June
2830,JIK COLOURS 250MLS,PIECE,3,7000,17797,3203,21000,June
2831,JIK REGULAR 250MLS,PIECE,6,6500,33051,5949,39000,June
2833,JIK REGULAR 750MLS,PIECE,4,14000,47458,8542,56000,June
2856,JOHN WEST SARDINES,PIECE,1,11000,9322,1678,11000,June
2866,JOHNSON EXTRA GENTLE CARE SOAP,PIECE,2,7500,12712,2288,15000,June
2917,JUMBO CHOCOLATE RIPPLE 175MLS,PIECE,4,3500,11864,2136,14000,June
2921,JUMBO STRAWBERRY RIPPLE 175ML,PIECE,4,4000,13559,2441,16000,June
2922,JUMBO WAX CRAYONS,PIECE,3,5000,12712,2288,15000,June
2932,"KABODY BABY BOOSTER,S.R WITH ENKEJJE",PIECE,2,6500,11017,1983,13000,June
2937,KABODY MUKENE SOYA RICE1KG,PIECE,5,6200,26271,4729,31000,June
2940,KABODY PUMPKIN PORRIDGE 1KG,PIECE,1,6000,5085,915,6000,June
2941,KABODY PUMPKIN SEED 1KG,PIECE,1,6500,5508,992,6500,June
2942,KABODY PURE MILLET 1KG,PIECE,1,6000,5085,915,6000,June
2943,KABODY QUICK PORRIDGE1KG,PIECE,2,6000,10169,1831,12000,June
2944,KABODY RICE FLOUR 1KG,PIECE,2,6500,11017,1983,13000,June
2945,KABODY SOYA PORRIDGE,PIECE,1,6000,5085,915,6000,June
2946,KABODY SOYA RICE 1KG,PIECE,2,6500,11017,1983,13000,June
2947,KABODY WHITE OATS WITH RICE,PIECE,1,6000,5085,915,6000,June
2950,KAKIRA SUGAR 1KG,PIECE,73,6000,371186,66814,438000,June
2952,KAKIRA SUGAR 2KG,PIECE,8,12000,81356,14644,96000,June
2962,KANGARO STAPLES,PIECE,1,2000,1695,305,2000,June
2966,KANGAROO BLACK SHOE CREAM,PIECE,11,2000,18644,3356,22000,June
2985,KAZIRE ALOEVERA,PIECE,32,1500,40678,7322,48000,June
2986,KAZIRE LEMON TEA,PIECE,15,2000,25424,4576,30000,June
2987,KAZIRE ORANGE,PIECE,18,2000,30508,5492,36000,June
2988,KAZIRE POWER TONIC,PIECE,10,2000,16949,3051,20000,June
2989,KAZIRE RED TONIC 350MLS,PIECE,1,2000,1695,305,2000,June
2990,KAZIRE VIT FRUIT,PIECE,24,2000,40678,7322,48000,June
2992,KELLOGS CORNFLAKES 500g,PIECE,1,27000,22881,4119,27000,June
2993,KELLOGS CORNFLAKES 720G,PIECE,1,35000,29661,5339,35000,June
3050,KEY HOLDERS 2500,PIECE,2,2500,4237,763,5000,June
3052,KIBIMBA RICE 2KG,PIECE,1,15500,13136,2364,15500,June
3054,KIBIMBA RICE IKG,PIECE,2,8000,13559,2441,16000,June
3060,KICK SNACKS CHICKEN,PIECE,229,500,97034,17466,114500,June
3081,KIDS SOCKS 1500,PIECE,4,1500,5085,915,6000,June
3084,KIDS TOOTH BRUSH 5000,PIECE,5,5000,21186,3814,25000,June
3103,KINGTAT 800,PIECE,21,1000,17797,3203,21000,June
3104,KINKIZI TEA 100G,PIECE,1,3500,2966,534,3500,June
3110,KIRINGI KAZI BOOSTER 280ML,PIECE,4,1000,3390,610,4000,June
3113,KIRUNGI KAZI BOOSTER 280ML,PIECE,4,1000,3390,610,4000,June
3115,KIRUNGI MULONDO EXTRA 280ML,PIECE,6,1000,5085,915,6000,June
3116,KIRUNGI PINEAPPLE 250MLS,PIECE,3,1000,2542,458,3000,June
3119,KISUBI 85GM,PIECE,12,1500,15254,2746,18000,June
3128,KITCHEN TOWELS,PIECE,5,4000,16949,3051,20000,June
3131,KIWI 20G,PIECE,1,3500,2966,534,3500,June
3133,KIWI BLACK 80G,PIECE,3,8000,20339,3661,24000,June
3140,KIWI POLISH 12G,PIECE,3,2500,6356,1144,7500,June
3142,KIWI SHOE CREME NEUTRAL 150MLS,PIECE,5,5500,23305,4195,27500,June
3143,KIWI SHOE POLISH 32G,PIECE,2,5000,8475,1525,10000,June
3144,KIWI SUEDE CLEANER BLACK,PIECE,2,7500,12712,2288,15000,June
3152,KNICKERS 3500,PIECE,7,3500,20763,3737,24500,June
3156,KNICKERS 7000,PIECE,1,7000,5932,1068,7000,June
3157,KNICKERS 8000,PIECE,5,8000,33898,6102,40000,June
3159,KNIFE 3000,PIECE,1,3000,2542,458,3000,June
3160,KNIFE 4000 KM7095,PIECE,1,5000,4237,763,5000,June
3171,KOFA MATHEMATICAL SET,PIECE,6,4000,20339,3661,24000,June
3173,KONE HENNA PASTE 50G,PIECE,1,4500,3814,686,4500,June
3212,KOPIKO 3 IN 1 COFFEE,PIECE,3,2000,5085,915,6000,June
3213,KOPIKO BLANCA CREAMY,PIECE,8,2000,13559,2441,16000,June
3214,KOPIKO BROWN COFFEE,PIECE,28,1500,35593,6407,42000,June
3217,KREST 500MLS,PIECE,36,1500,45763,8237,54000,June
3221,KRYSTAL WATER 500ML,PIECE,11,1000,9322,1678,11000,June
3224,KUAKUA TOILET BLOCKS 6PCS,PIECE,3,10000,25424,4576,30000,June
3234,KYOGERO HERBAL JELLY 100ML,PIECE,3,3500,8898,1602,10500,June
3236,KYOGERO HERBAL JELLY 250G,PIECE,1,7500,6356,1144,7500,June
3237,KYOGERO HERBAL JELLY 50G,PIECE,2,2000,3390,610,4000,June
3238,KYOGERO HERBAL JELLY40G,PIECE,2,1500,2542,458,3000,June
3239,KYOGERO HERBAL SOAP 120G,PIECE,9,3500,26695,4805,31500,June
3244,LA BELLE BABY JELLY 55G,PIECE,1,2000,1695,305,2000,June
3246,LA BELLE JELLY 250G,PIECE,1,6000,5085,915,6000,June
3248,LA BELLE SHAMPOO 1LTR,PIECE,1,7500,6356,1144,7500,June
3249,LA BELLE SHAMPOO 500MLS,PIECE,3,5000,12712,2288,15000,June
3265,LA'FRESH APRICOT SKIN TONIC SCRUB,PIECE,1,14000,11864,2136,14000,June
3275,LANZO ANTI-BACTERIAL SOAP,PIECE,3,4500,11441,2059,13500,June
3276,LANZO BUBBLY SOAP,PIECE,3,3500,8898,1602,10500,June
3277,LANZO COCONUT SHEA SOAP,PIECE,2,3500,5932,1068,7000,June
3278,LANZO MENTHOL SOAP,PIECE,3,4500,11441,2059,13500,June
3279,LANZO VANILLA SOAP,PIECE,1,3500,2966,534,3500,June
3284,LATO CHOCO PWDER MILK 15G,PIECE,44,500,18644,3356,22000,June
3285,LATO CHOCOLATE MILK 250MLS,PIECE,50,2000,84746,15254,100000,June
3290,LATO FLAVOURED BOX 23000,BOX,2,23000,38983,7017,46000,June
3291,LATO GHEE 500G,PIECE,1,16000,13559,2441,16000,June
3293,LATO MILK 250G,PIECE,9,12000,91525,16475,108000,June
3294,LATO MILK 400G,PIECE,8,19000,128814,23186,152000,June
3295,LATO MILK 900G,PIECE,2,47000,79661,14339,94000,June
3296,LATO MILK CHOCOLATE 125ML FLAVOURED,PIECE,8,1000,6780,1220,8000,June
3298,LATO MILK POWDER 15G,PIECE,77,500,32627,5873,38500,June
3299,LATO MILK PWDER STRAWBERRY 15G,PIECE,22,500,9322,1678,11000,June
3302,LATO MIXED BERRIES 250G,PIECE,17,3000,43220,7780,51000,June
3304,LATO PEACH&CARAMEL 250G,PIECE,20,3000,50847,9153,60000,June
3305,LATO PEACH&CARAMEL FRUIT 450G,PIECE,12,5250,53390,9610,63000,June
3306,LATO PLAIN YOGHURT 500G,PIECE,15,3700,47034,8466,55500,June
3309,LATO STRAWBERRY MILK 125MLS,PIECE,71,1000,60169,10831,71000,June
3310,LATO STRAWBERRY MILK 250MLS,PIECE,47,2000,79661,14339,94000,June
3311,LATO STRAWBERRY YOGHURT 500G,PIECE,17,3700,53305,9595,62900,June
3315,LATO VANILLA 100G,PIECE,16,1200,16271,2929,19200,June
3316,LATO VANILLA 125ML MILK,PIECE,141,1000,119492,21508,141000,June
3317,LATO VANILLA MILK 250MLS,PIECE,69,2000,116949,21051,138000,June
3318,LATO VANILLA YOGHURT 250ML,PIECE,11,2500,23305,4195,27500,June
3319,LATO VANILLA YOGHURT 500G,PIECE,21,3700,65847,11853,77700,June
3321,LATO YOG MIXED BERRIES 450G,PIECE,7,5357,31780,5720,37500,June
3322,LATO YOG STRAWBERRY 100G,PIECE,21,1200,21356,3844,25200,June
3323,LATO YOG STRAWBERRY 250G,PIECE,12,2500,25424,4576,30000,June
3324,LATO YOGHURT 400G VANILLA,PIECE,40,2500,84746,15254,100000,June
3325,LATO YOGHURT SRAWBERRY 200G,PIECE,132,1000,111864,20136,132000,June
3326,LATO YOGHURT STRAWBERRY 400G,PIECE,30,2500,63559,11441,75000,June
3327,LATO YOGHURT VANILLA 200G,PIECE,99,1000,83898,15102,99000,June
3335,LAVITA PINEAPPLE 320MLS,PIECE,22,1000,18644,3356,22000,June
3336,LAVITA PINEAPPLE 500ML,PIECE,3,1500,3814,686,4500,June
3361,LEMON CAKES 1000,PIECE,62,1200,63051,11349,74400,June
3362,LEMON CLEAR 125G,PIECE,1,7000,5932,1068,7000,June
3376,LIFEBUOY TOTAL10 175G,PIECE,1,6000,5085,915,6000,June
3378,LIGHTERS,PIECE,12,1000,10169,1831,12000,June
3381,LIMOUSINE CHOCOLATE,PIECE,1,1500,1271,229,1500,June
3401,LMZ HREBAL 120G,PIECE,1,5000,4237,763,5000,June
3403,LONG DUST PAN 12000,PIECE,1,12000,10169,1831,12000,June
3410,LOTUS TOOTH BRUSH DEEP CLEAN,PIECE,1,4000,3390,610,4000,June
3411,LOTUS TOOTHBRUSH EXPERT,PIECE,1,4000,3390,610,4000,June
3419,LOVE CHOCOLATE,PIECE,10,3000,25424,4576,30000,June
3434,LUCOZADE 250ML,PIECE,4,3000,10169,1831,12000,June
3435,LUCOZADE 250MLS,PIECE,49,3000,124576,22424,147000,June
3456,LUX VESTS,PIECE,2,16000,27119,4881,32000,June
3457,LUXURY CAR TISSUE,PIECE,3,4000,10169,1831,12000,June
3458,LUXURY TOILET PAPER,PIECE,20,600,10169,1831,12000,June
3465,M&G COUNTER BOOK AQUIRE,PIECE,1,5000,4237,763,5000,June
3467,M&G ERASE PEN HAPPY SCHOOL 2000,PIECE,1,2500,2119,381,2500,June
3469,M&G GLUE STICK 15G,PIECE,1,2000,1695,305,2000,June
3472,M&G HELLO BEARS PEN ERASE,PIECE,19,2500,40254,7246,47500,June
3475,M&G INK CATRIDGE,PIECE,1,4000,3390,610,4000,June
3478,M&G MATHEMATICAL SET,PIECE,1,5000,4237,763,5000,June
3493,M&G STICK GLUE 1500,PIECE,9,1500,11441,2059,13500,June
3494,M&G STICK GLUE 3000,PIECE,9,3000,22881,4119,27000,June
3495,M&G STICKY NOTES 2000,PIECE,1,8000,6780,1220,8000,June
3498,M&G WATER COLOR PAINT,PIECE,1,11000,9322,1678,11000,June
3526,MACRO DENTAL FLOSS,PIECE,12,3000,30508,5492,36000,June
3533,MAGANJO BABY SOYA 1KG,PIECE,6,6500,33051,5949,39000,June
3535,MAGANJO BABY SOYA WITH MILK 500G,PIECE,7,8500,50424,9076,59500,June
3538,MAGANJO CORNFLAKES,PIECE,2,10000,16949,3051,20000,June
3539,MAGANJO ENERGY BOOSTER 1KG,PIECE,1,6500,5508,992,6500,June
3546,MAGANJO POSHO 5KG,PIECE,2,20000,33898,6102,40000,June
3552,MAGANJO SOYA MILLET,PIECE,3,6500,16525,2975,19500,June
3553,MAGANJO SOYA RICE 1KGS,PIECE,2,7500,12712,2288,15000,June
3560,MAGIC 1KG SACHET,PIECE,5,8500,36017,6483,42500,June
3561,MAGIC 1KG BUCKET,PIECE,2,12500,21186,3814,25000,June
3562,MAGIC 250G BUCKET,PIECE,10,4000,33898,6102,40000,June
3563,MAGIC 500G BUCKET,PIECE,9,6500,49576,8924,58500,June
3564,MAGIC 500G SACHET,PIECE,13,4500,49576,8924,58500,June
3566,MAGIC SACHET 45G,PIECE,12,500,5085,915,6000,June
3584,MAMIS PEANUT PASTE 1KG,PIECE,4,15000,50847,9153,60000,June
3585,MAMIS PEANUT PASTE 500G,PIECE,7,8000,47458,8542,56000,June
3588,MANILA PAPERS 1000,PIECE,18,1000,15254,2746,18000,June
3597,MANUSCRIPT 3Q BOOK,PIECE,1,16000,13559,2441,16000,June
3598,MANUSCRIPT BOOK 2Q,PIECE,4,12000,40678,7322,48000,June
3606,MARIKA CORN FLOUR 400G,PIECE,3,5000,12712,2288,15000,June
3607,MARIKA ICING SUGAR 500G,PIECE,11,4000,37288,6712,44000,June
3608,MARLOS CHOCOLATE,PIECE,3,2000,5085,915,6000,June
3609,MARS CHOCOLATE,PIECE,10,3500,29661,5339,35000,June
3612,MASKING TAPE 2500,PIECE,1,4000,3390,610,4000,June
3622,CAR TOY 15000,PIECE,1,15000,12712,2288,15000,June
3625,MAYONNAISE 237ML,PIECE,7,19000,112712,20288,133000,June
3626,MAYONNAISE BIG 887ML,PIECE,1,30000,25424,4576,30000,June
3628,MAYONNAISE MEDIUM 473ML,PIECE,4,25000,84746,15254,100000,June
3638,MELEX DADDIES 100G 2000,PIECE,3,2000,5085,915,6000,June
3644,MELEX G.NUTS 1000,PIECE,18,1000,15254,2746,18000,June
3645,MELEX G.NUTS 2000,PIECE,7,2000,11864,2136,14000,June
3648,MELEX HARDCORNS 1000,PIECE,8,1000,6780,1220,8000,June
3649,MELEX HARDCORNS 2000,PIECE,7,2000,11864,2136,14000,June
3653,MELEX SIMSIM 170G 2000,PIECE,11,2000,18644,3356,22000,June
3654,MELEX SIMSIM 85G 1000,PIECE,13,1000,11017,1983,13000,June
3655,MELEX SIMSIM BALLS 1000,PIECE,13,1000,11017,1983,13000,June
3656,MELEX SIMSIM BALLS 2000,PIECE,16,2000,27119,4881,32000,June
3661,MELEX SOYA 250G 6500,PIECE,1,5000,4237,763,5000,June
3663,MEN BOXERS 10000,PIECE,7,10000,59322,10678,70000,June
3666,MEN BOXERS 6000,PIECE,1,8000,6780,1220,8000,June
3667,MEN BOXERS 7000,PIECE,1,7000,5932,1068,7000,June
3668,MEN SOCKS,PIECE,10,3000,25424,4576,30000,June
3672,MENTHOXYL,PIECE,1,500,424,76,500,June
3674,MENTOS GRAPE,PIECE,4,2500,8475,1525,10000,June
3678,MENTOS RAINBOW,PIECE,3,2333,5932,1068,7000,June
3682,MESSAGE CARDS 500,PIECE,1,500,424,76,500,June
3684,MIA GONJA 1000,PIECE,2,1000,1695,305,2000,June
3690,MIKOSHI GREEN TEA,PIECE,18,6000,91525,16475,108000,June
3716,MINDY PADLOCK 70MM 30000,PIECE,1,30000,25424,4576,30000,June
3721,MINUTE MAID 1LTRS,PIECE,97,5000,411017,73983,485000,June
3723,MINUTE MAID BERRY BLAST 400MLS,PIECE,58,2500,122881,22119,145000,June
3724,MINUTE MAID BOOST MANGO,PIECE,2,2500,4237,763,5000,June
3725,Minute maid mango,PIECE,140,2500,296610,53390,350000,June
3729,MINUTEMAID BERRY BLAST 1LTR,PIECE,52,5000,220339,39661,260000,June
3736,MIRINDA APPLE,PIECE,26,1481,32627,5873,38500,June
3737,MIRINDA APPLE 2LTR,PIECE,35,4500,133475,24025,157500,June
3738,MIRINDA APPLE 330ML,PIECE,109,1000,92373,16627,109000,June
3739,MIRINDA FRUITY,PIECE,31,1500,39407,7093,46500,June
3740,MIRINDA FRUITY 2LTR,PIECE,43,4500,163983,29517,193500,June
3741,MIRINDA FRUITY 330MLS,PIECE,113,1000,95763,17237,113000,June
3742,MIRINDA ORANGE 2LTRS,PIECE,16,4500,61017,10983,72000,June
3743,MIRINDA ORANGE 330ML,PIECE,97,1000,82203,14797,97000,June
3744,MIRINDA ORANGE 500ML,PIECE,18,1500,22881,4119,27000,June
3747,MIRINDA PINEAPPLE 330ML,PIECE,47,1000,39831,7169,47000,June
3748,MIRROR 1500,PIECE,2,1500,2542,458,3000,June
3750,MIRRORS 2500,PIECE,1,2500,2119,381,2500,June
3760,MOCACINE SOCKS 2000,PIECE,11,2000,18644,3356,22000,June
3761,MOCACINE SOCKS 2500,PIECE,2,2500,4237,763,5000,June
3809,MOPPER 7000,PIECE,1,7000,5932,1068,7000,June
3812,MOPPERS 12000,PIECE,1,12000,10169,1831,12000,June
3838,MORTEIN DOOM LEMON 600MLS,PIECE,2,33000,55932,10068,66000,June
3843,MORTEIN ODOURLESS 180MLS,PIECE,5,15000,63559,11441,75000,June
3845,MORTEIN ODOURLESS 400ML,PIECE,1,28000,23729,4271,28000,June
3846,MORTEIN ODOURLESS 600ML,PIECE,2,32000,54237,9763,64000,June
3847,MOSQUITO NET 13000,PIECE,1,13000,11017,1983,13000,June
3848,MOSQUITO NETS 15000,PIECE,1,15000,12712,2288,15000,June
3854,MOSQUITO SWATTERS 30000,PIECE,1,30000,25424,4576,30000,June
3862,MOUNTAIN DEW,PIECE,46,1500,58475,10525,69000,June
3863,MOUNTAIN DEW 2LTR,PIECE,36,4500,137288,24712,162000,June
3864,MOUNTAIN DEW 300MLS,PIECE,116,1000,98305,17695,116000,June
3867,MOUSE &RAT TRAPS GREEN,PIECE,4,3000,10169,1831,12000,June
3869,MOVIT BABY JELLY 110G,PIECE,1,3000,2542,458,3000,June
3875,MOVIT BABYJELLY 50g,PIECE,1,1500,1271,229,1500,June
3879,MOVIT BODY MILK CREME 250G,PIECE,5,4500,19068,3432,22500,June
3881,MOVIT BODYMILK 80G,PIECE,1,1500,1271,229,1500,June
3887,MOVIT FAMILY SOAP 230G,PIECE,6,4000,20339,3661,24000,June
3888,MOVIT FAMILY SOAP ALOE 120G,PIECE,2,2500,4237,763,5000,June
3889,MOVIT FAMILY SOAP ALOE 230G,PIECE,7,4000,23729,4271,28000,June
3890,MOVIT FAMILY SOAP ALOE V.P,PIECE,3,7000,17797,3203,21000,June
3891,MOVIT FAMILY SOAP COCOMUT 125G,PIECE,3,2500,6356,1144,7500,June
3892,MOVIT FAMILY SOAP COCONUT 230G,PIECE,6,4000,20339,3661,24000,June
3893,MOVIT FAMILY SOAP LEMON V.P,PIECE,3,7000,17797,3203,21000,June
3894,MOVIT FAMILY SOAP ROSE 125G,PIECE,4,2500,8475,1525,10000,June
3896,MOVIT FAMILY SOAP V.P COCONUT,PIECE,4,7000,23729,4271,28000,June
3897,MOVIT FAMILY SOAP V.P ROSE,PIECE,1,7000,5932,1068,7000,June
3902,MOVIT HAIR FOOD 120G,PIECE,1,3000,2542,458,3000,June
3903,MOVIT HAIR FOOD 70G,PIECE,4,3000,10169,1831,12000,June
3906,MOVIT HERBAL JELLY 120G,PIECE,1,4000,3390,610,4000,June
3909,MOVIT HERBAL JELLY 50G,PIECE,2,1500,2542,458,3000,June
3911,MOVIT HERBAL SOAP 120G,PIECE,1,3000,2542,458,3000,June
3912,MOVIT JELLY 110G,PIECE,1,3500,2966,534,3500,June
3913,MOVIT JELLY 200G,PIECE,1,5000,4237,763,5000,June
3915,MOVIT JELLY 50G,PIECE,5,1500,6356,1144,7500,June
3930,MOVIT SOAP LEMON 120G,PIECE,2,2500,4237,763,5000,June
3932,MOVIT SULPHUR 60G,PIECE,2,2500,4237,763,5000,June
3944,MUKISA CAKE 2500,PIECE,20,2500,42373,7627,50000,June
3945,MUKISA MANDAZI,PIECE,7,3000,17797,3203,21000,June
3946,MUKISA MANDAZI 1000,PIECE,13,1500,16525,2975,19500,June
3956,MUKWANO OIL 500ML JERRYCAN,PIECE,2,5500,9322,1678,11000,June
3958,MUKWANO TEA BAGS 100G,PIECE,2,5500,9322,1678,11000,June
3959,MUKWANO TEA BAGS 200G,PIECE,1,10000,8475,1525,10000,June
3963,MUSA'S BAKERY COOKIES 360G,PIECE,12,5500,55932,10068,66000,June
3964,MUSA'S COOKIES 180G,PIECE,1,3000,2542,458,3000,June
3965,MUSA'S COOKIES 90G,PIECE,6,1500,7627,1373,9000,June
3967,MUSAWO BODY JELLY,PIECE,1,2500,2119,381,2500,June
3972,MUSAWO SOAP 120G,PIECE,2,1500,2542,458,3000,June
3973,MUSAWO SOAP 240G,PIECE,7,3143,18644,3356,22000,June
3994,NACET 500 PCS,PIECE,3,500,1271,229,1500,June
3995,NACET BLADES 2500 PKT,PIECE,6,2500,12712,2288,15000,June
3996,Nail cutter,PIECE,1,1000,847,153,1000,June
3997,NAIL CUTTER 2500,PIECE,4,2500,8475,1525,10000,June
3998,NAIL CUTTERS 1500,PIECE,4,1500,5085,915,6000,June
4000,NAN OPTIPRO 1 400G,PIECE,2,62000,105085,18915,124000,June
4001,NANA HERBAL MOUTH 60MLS,PIECE,2,7500,12712,2288,15000,June
4019,NASA HAIR REMOVAL LEMON 50ML,PIECE,1,7000,5932,1068,7000,June
4020,NATARAJ COLOR PENCIL SHORT,PIECE,1,3500,2966,534,3500,June
4021,NATARAJ COLOR PENCILS,PIECE,5,7500,31780,5720,37500,June
4023,NATARAJ PENCILS 6000,PIECE,10,6000,50847,9153,60000,June
4024,NATARAJ PENS,PIECE,37,700,21949,3951,25900,June
4027,NATARAJ SETS,PIECE,1,10000,8475,1525,10000,June
4029,NATURAL NAPKINS,PIECE,3,2500,6356,1144,7500,June
4030,NATURAL SPONGE 2000,PIECE,3,2000,5085,915,6000,June
4033,NEEDLES,PIECE,1,200,169,31,200,June
4034,NEEK YOGHURT 1LTR,PIECE,21,7000,124576,22424,147000,June
4035,NEEK YOGHURT 300G 2000,PIECE,15,2500,31780,5720,37500,June
4036,NEEK YOGHURT 500G 3500,PIECE,9,3500,26695,4805,31500,June
4043,NESCAFE CLASSIC 100G,PIECE,5,17000,72034,12966,85000,June
4044,NESCAFE CLASSIC 200G,PIECE,2,29000,49153,8847,58000,June
4045,NESCAFE CLASSIC 2G,PIECE,83,500,35169,6331,41500,June
4046,NESCAFE CLASSIC 50G,PIECE,6,12000,61017,10983,72000,June
4047,NESCAFE CLASSIC SACHETS 1.6G,PIECE,3,500,1271,229,1500,June
4051,NESTLE KITKAT,PIECE,3,3500,8898,1602,10500,June
4081,NICE CLEAR PENS,PIECE,26,500,11017,1983,13000,June
4082,NICE TOOTHBRUSH,PIECE,8,600,4068,732,4800,June
4083,NICE& LOVELY ALOE 48HRS 400ML,PIECE,1,10000,8475,1525,10000,June
4085,NICE&LOVELY ALOE 200ML,PIECE,1,6000,5085,915,6000,June
4096,NIGHTROSE POWDER 1OOMLS,PIECE,2,4000,6780,1220,8000,June
4099,NIGINA SHOES 20000,PIECE,1,8000,6780,1220,8000,June
4115,NISA CAMEL MILK CARROT SOAP,PIECE,2,5000,8475,1525,10000,June
4116,NISA CAMEL SOAP SHEABUTTER,PIECE,1,5000,4237,763,5000,June
4118,NISA HAIR REMOVAL CUCUMBER 100ML,PIECE,2,10000,16949,3051,20000,June
4119,NISA HAIR REMOVAL CUCUMBER 50ML,PIECE,1,7000,5932,1068,7000,June
4120,NISA HAIR REMOVAL LEMON 100ML,PIECE,2,10000,16949,3051,20000,June
4121,NISA HAIR REMOVAL ROSE 100ML,PIECE,1,10000,8475,1525,10000,June
4122,NISA HAIR REMOVAL ROSE 50ML,PIECE,1,7000,5932,1068,7000,June
4124,NISA NORMAL SKIN,PIECE,1,5000,4237,763,5000,June
4128,NIVANA 500MLS,PIECE,221,500,93644,16856,110500,June
4131,NIVANA WATER 1.5L,PIECE,74,1500,94068,16932,111000,June
4134,NIVEA BLACK & WHITE 50ML,PIECE,8,11000,74576,13424,88000,June
4137,NIVEA BLACK&WHITE ROLLON,PIECE,3,11000,27966,5034,33000,June
4139,NIVEA COOL KICK 400MLS,PIECE,1,20000,16949,3051,20000,June
4140,NIVEA COOL KICK ROLLON,PIECE,3,11000,27966,5034,33000,June
4141,NIVEA DEEP AMAZONIA,PIECE,3,11000,27966,5034,33000,June
4142,NIVEA DRY COMFORT ROLLON,PIECE,2,11000,18644,3356,22000,June
4143,NIVEA DRY IMPACT ROLLON,PIECE,3,11000,27966,5034,33000,June
4147,NIVEA FRESH ENERGY 50ML,PIECE,2,11000,18644,3356,22000,June
4148,NIVEA FRESH NATURAL ROLLON,PIECE,3,10667,27119,4881,32000,June
4158,NIVEA MEN DEEP ROLLON,PIECE,5,11000,46610,8390,55000,June
4161,NIVEA MEN DRY IMPACT BODY SPRAY,PIECE,2,17000,28814,5186,34000,June
4162,NIVEA MEN FRESH ACTIVE 50ML,PIECE,2,11000,18644,3356,22000,June
4163,NIVEA MEN FRESH ACTIVE SPRAY,PIECE,1,17000,14407,2593,17000,June
4168,NIVEA MEN REVITALIZING,PIECE,1,20000,16949,3051,20000,June
4170,NIVEA MEN REVITALIZING 200ML,PIECE,1,15000,12712,2288,15000,June
4173,NIVEA NOURISHING COCOA LOTION 400ML,PIECE,1,20000,16949,3051,20000,June
4184,NIVEA SHEA SMOOTH 200ML,PIECE,2,12000,20339,3661,24000,June
4190,NOMI 250G BUCKET,PIECE,7,4000,23729,4271,28000,June
4191,NOMI BUCKET 1KG,PIECE,3,12500,31780,5720,37500,June
4192,NOMI BUCKET 500G,PIECE,2,6500,11017,1983,13000,June
4194,NOTE BOOK 1000,PIECE,4,1000,3390,610,4000,June
4195,NOTE BOOK 2000,PIECE,6,2000,10169,1831,12000,June
4196,NOTE BOOK 3000,PIECE,1,3000,2542,458,3000,June
4198,NOTE BOOK 4000,PIECE,2,4000,6780,1220,8000,June
4199,NOTE BOOK 5500,PIECE,4,5500,18644,3356,22000,June
4200,NOTE BOOK PICFARE,PIECE,1,5000,4237,763,5000,June
4201,NOTE BOOK SPIRAL 10000,PIECE,1,10000,8475,1525,10000,June
4204,NOTEBOOK 6500,PIECE,2,6500,11017,1983,13000,June
4207,NOVICOL WOOD GLUE,PIECE,3,5000,12712,2288,15000,June
4208,NOVIDA 350MLS,PIECE,63,1000,53390,9610,63000,June
4209,NOVIDA 500MLS,PIECE,40,1500,50847,9153,60000,June
4214,NTALE 100G,PIECE,1,4500,3814,686,4500,June
4215,NTALE 25G,PIECE,3,2500,6356,1144,7500,June
4218,NUMA BUSHERA 1KG,PIECE,16,6500,88136,15864,104000,June
4219,NUMA BUSHERA 2KG,PIECE,10,12000,101695,18305,120000,June
4220,NUMA KARO 1KG,PIECE,2,6500,11017,1983,13000,June
4222,NUMA RICE FLOUR 1KG,PIECE,8,7500,50847,9153,60000,June
4223,NUMA SOYA RICE 1KG,PIECE,3,7000,17797,3203,21000,June
4225,NUMA SOYARICE WITH NKEJJE 500G,PIECE,1,5000,4237,763,5000,June
4229,NUSS CHOCOLATE,PIECE,20,1000,16949,3051,20000,June
4235,NUTRO CHOC CREAM WAFERS,PIECE,5,6500,27542,4958,32500,June
4236,NUTRO CHOCOLATE BISCUITS,PIECE,39,1200,39661,7139,46800,June
4239,NUTRO CREAM WAFERS 3,PIECE,10,6500,55085,9915,65000,June
4245,NUTRO STRAW CREAM WAFERS,PIECE,14,3500,41525,7475,49000,June
4247,NUTRO TEA BISCUIT,PIECE,16,3500,47458,8542,56000,June
4248,NUTRO VANILLA 30G,PIECE,89,1200,90508,16292,106800,June
4252,NUTRO WAFERS VANILLA,PIECE,16,3500,47458,8542,56000,June
4263,NUVITA CHOCO BISCUITS,PIECE,11,2000,18644,3356,22000,June
4264,NUVITA CHOCOLATE CREAM,PIECE,6,1500,7627,1373,9000,June
4267,NUVITA GINGER BISCUITS 75G,PIECE,15,2000,25424,4576,30000,June
4270,NUVITA GLUCOSE 75G,PIECE,5,1500,6356,1144,7500,June
4271,NUVITA GO COOKIES,PIECE,9,2000,15254,2746,18000,June
4272,NUVITA LEMON BISCUITS 750,PIECE,4,1500,5085,915,6000,June
4274,NUVITA ORANGE CREAM BISCUITS,PIECE,4,1500,5085,915,6000,June
4275,NUVITA STRAWBERRY CREAMS 75G,PIECE,7,1500,8898,1602,10500,June
4276,NUVITA VITAMILK BISCUITS,PIECE,3,1500,3814,686,4500,June
4284,OATIBIX 500G,PIECE,2,12000,20339,3661,24000,June
4293,ODONIL DISINFECTANT,PIECE,9,7000,53390,9610,63000,June
4316,OLDSPICE FRESH DEODORANT 63G,PIECE,2,20000,33898,6102,40000,June
4322,OLITALIA OLIVE OIL POMACE 250ML,PIECE,3,25000,63559,11441,75000,June
4329,OLIVE OIL SPRAY 275ML,PIECE,1,12000,10169,1831,12000,June
4330,OLIVE OIL SPRAY 85ML,PIECE,1,7500,6356,1144,7500,June
4333,OMO 40G FRESH,PIECE,17,500,7203,1297,8500,June
4334,OMO AUTO WASHING POWDER 1KG,PIECE,3,21000,53390,9610,63000,June
4335,OMO BLEACH COLOUR SAFE 700ML.,PIECE,4,9000,30508,5492,36000,June
4336,OMO BLEACH LEMON,PIECE,1,8000,6780,1220,8000,June
4337,OMO BLEACH MULTI -PURPOSE,PIECE,3,4000,10169,1831,12000,June
4339,OMO BLEACH REGULAR,PIECE,3,8000,20339,3661,24000,June
4340,OMO BLEACH REGULAR 250ML,PIECE,2,3500,5932,1068,7000,June
4341,OMO BLEACH REGULAR 70ML,PIECE,1,1200,1017,183,1200,June
4342,OMO COMFORT 1KG,PIECE,5,12900,54661,9839,64500,June
4343,OMO COMFORT 500G,PIECE,4,7500,25424,4576,30000,June
4344,OMO FAST ACTION 1KG,PIECE,2,12750,21610,3890,25500,June
4345,OMO FAST ACTION 3.5KG,PIECE,1,40000,33898,6102,40000,June
4346,OMO FAST ACTION 500G,PIECE,9,7500,57203,10297,67500,June
4347,ONER APPLE JUICE DRINK,PIECE,144,2500,305085,54915,360000,June
4348,ONER BERRIES 300ML,PIECE,166,1500,211017,37983,249000,June
4349,ONER BERRIES JUICE DRINK,PIECE,138,2500,292373,52627,345000,June
4350,ONER MANGO 1LTR,PIECE,9,5000,38136,6864,45000,June
4351,ONER MANGO 500MLS,PIECE,111,2500,235169,42331,277500,June
4360,ORAL B EXTRA FRESH,PIECE,2,3500,5932,1068,7000,June
4363,ORAL-B TOOTHBRUSH,PIECE,3,3500,8898,1602,10500,June
4364,ORANGES 2000,PIECE,54,2324,106356,19144,125500,June
4365,ORCHID VALLEY APPLE 1LTR,PIECE,6,7500,38136,6864,45000,June
4368,ORCHID VALLEY MANGO 1LTR6161101061483,PIECE,10,7500,63559,11441,75000,June
4370,ORCHID VALLEY PASSION 1LTR,PIECE,10,7000,59322,10678,70000,June
4372,ORCHID VALLEY TROPICAL 1LTR,PIECE,2,7500,12712,2288,15000,June
4403,ORIGINALS MOISTURIZING BODY GLOSS,PIECE,1,24000,20339,3661,24000,June
4416,OX FORD SETS 11000,PIECE,1,11000,9322,1678,11000,June
4425,P.K GREEN BIG,PIECE,2,1000,1695,305,2000,June
4433,PADLOCK 5000,PIECE,2,5000,8475,1525,10000,June
4436,PADLOCK ALARM,PIECE,2,22000,37288,6712,44000,June
4437,PADLOCK C6-60 25000,PIECE,1,25000,21186,3814,25000,June
4444,PAMPER 2 L.C,PIECE,12,9000,91525,16475,108000,June
4445,PAMPER 3 H.C,PIECE,1,40000,33898,6102,40000,June
4447,PAMPER 3 L.C PANTS,PIECE,12,9000,91525,16475,108000,June
4450,PAMPER 4 L.C PANTS,PIECE,9,9000,68644,12356,81000,June
4454,PAMPER 5 L.C PANTS,PIECE,9,9000,68644,12356,81000,June
4459,PAMPER S.6 JUMBO 48DIAP,PIECE,1,73000,61864,11136,73000,June
4464,PANASONIC AA,PIECE,12,2000,20339,3661,24000,June
4466,PANASONIC BIG,PIECE,1,6000,5085,915,6000,June
4470,PANCHAVATI,PIECE,5,3000,12712,2288,15000,June
4473,PANT PEG 5000,PIECE,3,5000,12712,2288,15000,June
4475,PANT PEG COAT HANGER,PIECE,1,9000,7627,1373,9000,June
4481,PANT PEGS 9000,PIECE,1,9000,7627,1373,9000,June
4484,PAPERLINE EXERCISE BK,PIECE,8,4000,27119,4881,32000,June
4516,PELIKAN RUBBER,PIECE,3,1000,2542,458,3000,June
4517,PELIKAN RUBBERS 1000,PIECE,2,1000,1695,305,2000,June
4523,PENCIL BAGS 7000,PIECE,2,7000,11864,2136,14000,June
4525,PENCIL PIECES,PIECE,3,200,508,92,600,June
4534,PEPSI,PIECE,18,1500,22881,4119,27000,June
4535,PEPSI 2LTR,PIECE,34,4500,129661,23339,153000,June
4536,PEPSI 330ML,PIECE,93,1000,78814,14186,93000,June
4537,PEPSI MAX,PIECE,38,1000,32203,5797,38000,June
4539,PEPSODENT CAVITY 65G,PIECE,1,2500,2119,381,2500,June
4540,PEPSODENT CAVITY FIGHTER 150G,PIECE,1,5000,4237,763,5000,June
4541,PEPSODENT HERBAL 65G,PIECE,8,2500,16949,3051,20000,June
4542,PEPSODENT HERBAL TRIPPLE140G,PIECE,11,5000,46610,8390,55000,June
4546,PEPTANG KETCHUP 400G,PIECE,4,7500,25424,4576,30000,June
4549,PEPTANG TOMATO SAUCE 400G,PIECE,3,4500,11441,2059,13500,June
4552,PERMANENT MAKER,PIECE,3,1000,2542,458,3000,June
4553,PERSONAL EAR BUDS,PIECE,1,3000,2542,458,3000,June
4555,PETTI COT 5000,PIECE,3,5000,12712,2288,15000,June
4575,PIAO PIAO TP ORIGINAL,PIECE,49,2000,83051,14949,98000,June
4577,PICFARE 192 PAGES 6000,PIECE,8,6000,40678,7322,48000,June
4578,PICFARE 2 QUIRE,PIECE,1,5000,4237,763,5000,June
4579,PICFARE 288PAGES 8500,PIECE,1,8000,6780,1220,8000,June
4580,PICFARE 4 QUIRE 10000,PIECE,7,10000,59322,10678,70000,June
4581,PICFARE 48PGS,PIECE,18,500,7627,1373,9000,June
4582,PICFARE 96 PGS 11000,PIECE,3,11000,27966,5034,33000,June
4583,PICFARE 96PGS,PIECE,15,1000,12712,2288,15000,June
4585,PICFARE GRAPH BOOK 48PGS,PIECE,4,2000,6780,1220,8000,June
4588,PICFARE PENCILS 3000,PIECE,2,3000,5085,915,6000,June
4589,PICFARE PENCILS PIECES 300,PIECE,5,300,1271,229,1500,June
4591,PICFARE RULED PAPER SMALL,PIECE,1,11000,9322,1678,11000,June
4592,PICFARE SET,PIECE,1,6000,5085,915,6000,June
4594,PICH n PEEL TROPICAL MIX 1LTR,PIECE,13,9500,104661,18839,123500,June
4597,PICK n PEEL MANGO 1LTR,PIECE,9,9500,72458,13042,85500,June
4615,PK CHEWING GUM 500,PIECE,62,500,26271,4729,31000,June
4616,PK CHEWING GUM BIG,PIECE,60,1000,50847,9153,60000,June
4622,PLASTIC FOOD WRAP,PIECE,4,6500,22034,3966,26000,June
4623,PLASTIC FORKS 50PCS,PIECE,2,4000,6780,1220,8000,June
4644,PLATES CLAY 3000,PIECE,2,3500,5932,1068,7000,June
4653,PLUTO ADVANCED AA,PIECE,5,6000,25424,4576,30000,June
4663,POMEGRANATE ED PASSION,PIECE,1,16000,13559,2441,16000,June
4664,POP & CONE SWEETS,PIECE,7,500,2966,534,3500,June
4665,POPPER 4500,PIECE,1,4500,3814,686,4500,June
4667,POPPER 7000,PIECE,2,7000,11864,2136,14000,June
4683,POTATO TABLE WARE 35000,PIECE,1,35000,29661,5339,35000,June
4695,POULTRY VIENNAS 250G,PIECE,8,13000,88136,15864,104000,June
4696,POULTRY VIENNAS 500G,PIECE,6,22000,111864,20136,132000,June
4700,POWERPLAY 400MLS,PIECE,14,2000,23729,4271,28000,June
4705,PRADIP VANILLA CLEAR FLAVOURING,PIECE,6,5000,25424,4576,30000,June
4711,PREDATOR ENERGY DRINK,PIECE,7,2000,11864,2136,14000,June
4717,PRESTIGE 250G,PIECE,18,4500,68644,12356,81000,June
4718,PRESTIGE 500G,PIECE,8,7500,50847,9153,60000,June
4720,PRICETAGS 1000,PIECE,1,1000,847,153,1000,June
4721,PRIDE DISH WASHING PASTE LEMON 400G,PIECE,1,10000,8475,1525,10000,June
4722,PRIDE DISH WASHING PASTE LIME 400G,PIECE,2,10000,16949,3051,20000,June
4732,PRINCESS ULTRA PADS,PIECE,3,2700,6864,1236,8100,June
4733,PRINCESS ULTRA THIN,PIECE,1,3000,2542,458,3000,June
4734,PRINGLES BARBEQUE 165G,PIECE,1,12000,10169,1831,12000,June
4735,PRINGLES BBQ 40G,PIECE,2,5500,9322,1678,11000,June
4737,PRINGLES CHEESY CHEESE 165G,PIECE,3,12000,30508,5492,36000,June
4739,PRINGLES HOT&SPICY 40G,PIECE,2,5750,9746,1754,11500,June
4740,PRINGLES KETCHUP 165G,PIECE,1,11000,9322,1678,11000,June
4742,PRINGLES ORIGINAL 165G BURSTING,PIECE,5,11200,47458,8542,56000,June
4743,PRINGLES ORIGINAL 40G,PIECE,2,6000,10169,1831,12000,June
4746,PRINGLES SOUR CREAM 165G,PIECE,5,12000,50847,9153,60000,June
4754,PRIVE KANZ SPLASH,PIECE,1,14000,11864,2136,14000,June
4757,PRIVE MODA POUR FEMME,PIECE,1,15000,12712,2288,15000,June
4766,PROTEX CLASSIC 100G,PIECE,1,3500,2966,534,3500,June
4767,PROTEX CLASSIC 150G,PIECE,2,6500,11017,1983,13000,June
4775,PROTEX GENTAL 90G,PIECE,1,3500,2966,534,3500,June
4777,PROTEX HERBAL 150G,PIECE,4,6500,22034,3966,26000,June
4782,PUCELLE BLISSFUL SENSE 150ML,PIECE,1,7000,5932,1068,7000,June
4783,PUCELLE BLISSFUL SENSE 75ML,PIECE,1,5000,4237,763,5000,June
4784,PUCELLE ECCENTRIC BREEZE,PIECE,2,7250,12288,2212,14500,June
4787,PUCELLE FOR MY HEART,PIECE,1,7500,6356,1144,7500,June
4789,PUCELLE JOLLY RHYTHM 150MLS,PIECE,1,7500,6356,1144,7500,June
4791,PUCELLE JOYFUL SUMMER,PIECE,1,5000,4237,763,5000,June
4792,PUCELLE JOYFULSUMMER 150ML,PIECE,1,7500,6356,1144,7500,June
4794,PUCELLE PURE AROOSAH 75ML,PIECE,2,5000,8475,1525,10000,June
4796,PUCELLE SWEET FANTACY 75ML,PIECE,2,5000,8475,1525,10000,June
4798,PUCELLE TROPICAL SPIRIT 75MLS,PIECE,2,5000,8475,1525,10000,June
4799,PUCELLE WAVY OCEAN 150MLS,PIECE,1,7500,6356,1144,7500,June
4803,PUFF HOLDERS 2000,PIECE,1,2000,1695,305,2000,June
4813,PURE GLUCOSE BOX,PIECE,8,1000,6780,1220,8000,June
4814,Pure soft facial wipes,PIECE,11,3000,27966,5034,33000,June
4819,PVC CLING FILM 45CM,PIECE,1,20000,16949,3051,20000,June
4820,QUAKER WHITE OATS,PIECE,4,13000,44068,7932,52000,June
4829,RADIANT ANTIDUNDRUFF CREAM 60G,PIECE,1,3500,2966,534,3500,June
4838,RADIANT HAIR DYE 25ML,PIECE,1,3000,2542,458,3000,June
4840,RADIANT HAIR VITALIZER 100G,PIECE,1,5000,4237,763,5000,June
4841,RADIANT OLIVE OIL HAIR SPRAY 100ML,PIECE,1,6500,5508,992,6500,June
4842,RADIANT OLIVE OIL SHEEN SPRAY,PIECE,1,14000,11864,2136,14000,June
4846,RADIANT SHOWER GEL OLIVE OIL 750ML,PIECE,2,17000,28814,5186,34000,June
4852,RAHA DRINKING CHOCOLATE 200G,PIECE,2,10000,16949,3051,20000,June
4862,RANEE HERBAL ORIGINAL SOAP,PIECE,1,7500,6356,1144,7500,June
4870,RASASI ROMANCE PERFUMED TALC,PIECE,1,7500,6356,1144,7500,June
4872,RAT BOOK 3500,PIECE,1,3000,2542,458,3000,June
4888,REBEX RICH MILK STICK BISCUITS,PIECE,55,1200,55932,10068,66000,June
4896,RED BULL 250MLS,PIECE,12,7000,71186,12814,84000,June
4897,RED COCK 2KG,PIECE,4,27000,91525,16475,108000,June
4898,RED COCK BASMATI 1KG,PIECE,6,14000,71186,12814,84000,June
4919,REXONA COTTON DRY,PIECE,1,5000,4237,763,5000,June
4937,RIBENA 250MLS,PIECE,54,3000,137288,24712,162000,June
4945,RIHAM COFFEE MALT,PIECE,25,1500,31780,5720,37500,June
4947,RIHAM COLA 320MLS,PIECE,15,1000,12712,2288,15000,June
4950,RIHAM CREAMY CRUNCH CHOCOLATE,PIECE,6,3000,15254,2746,18000,June
4951,RIHAM CREAMY CRUNCH STRAWBERRY,PIECE,3,3000,7627,1373,9000,June
4952,RIHAM CREAMY ORANGE,PIECE,5,1200,5085,915,6000,June
4953,RIHAM CREAMY STRAWBERRY,PIECE,12,1200,12203,2197,14400,June
4956,RIHAM EXOTIC TAMARIND,PIECE,30,1000,25424,4576,30000,June
4960,RIHAM ONER APPLE 300ML,PIECE,120,1500,152542,27458,180000,June
4961,RIHAM ONER MANGO 300ml,PIECE,186,1500,236441,42559,279000,June
4964,RIHAM WATER 1.5LTRS,PIECE,12,2000,20339,3661,24000,June
4965,RIHAM WATER 600ML,PIECE,22,1000,18644,3356,22000,June
4973,RINJU HAND&BODY CREAM 118ML,PIECE,1,18000,15254,2746,18000,June
4984,ROCK BOOM 320MLS,PIECE,91,2000,154237,27763,182000,June
4989,ROKI 5LTRS,PIECE,1,30000,25424,4576,30000,June
4990,ROKI OIL 1LTR,PIECE,3,10000,25424,4576,30000,June
4991,ROKI OIL 3LTRS,PIECE,1,27000,22881,4119,27000,June
4992,ROKI OIL 500ML,PIECE,7,5000,29661,5339,35000,June
5007,ROTATRIM,PIECE,1,28000,23729,4271,28000,June
5016,ROYCO BEEF 200G,PIECE,10,6000,50847,9153,60000,June
5018,ROYCO BEEF 500G,PIECE,7,12000,71186,12814,84000,June
5020,ROYCO BEEF 60G,PIECE,2,1200,2034,366,2400,June
5021,ROYCO CHICKEN 200G,PIECE,8,6000,40678,7322,48000,June
5022,ROYCO CHICKEN 500G,PIECE,1,12000,10169,1831,12000,June
5023,ROYCO CHICKEN 60G,PIECE,5,1200,5085,915,6000,June
5024,ROYCO CUBE CHICKEN FLAVOUR,PIECE,4,5000,16949,3051,20000,June
5025,ROYCO CUBES BEEF,PIECE,10,4000,33898,6102,40000,June
5026,ROYCO CURRY+MCHUZI,PIECE,3,6500,16525,2975,19500,June
5029,RUBEE LOTION 113G,PIECE,1,7000,5932,1068,7000,June
5030,RUBEE LOTION 59ML,PIECE,1,5000,4237,763,5000,June
5032,RULED PAPER SHEETS 500,PIECE,1,14000,11864,2136,14000,June
5036,RWENZORI 1.5LTRS,PIECE,213,2000,361017,64983,426000,June
5043,RWENZORI WATER 500ML,PIECE,112,1000,94915,17085,112000,June
5049,SAFA TOMATO PASTE 400G,PIECE,5,6000,25424,4576,30000,June
5050,SAFA TOMATO PASTE 70GM,PIECE,52,1500,66102,11898,78000,June
5053,SAFARI TEA 50G,PIECE,2,1500,2542,458,3000,June
5060,SAFISHA DISINFECTOR 200G,PIECE,5,7800,33051,5949,39000,June
5063,SAF-LEVURE 125G,PIECE,3,8500,21610,3890,25500,June
5072,SALT SHAKERS 4000,PIECE,3,4000,10169,1831,12000,June
5078,SAMONA HERBAL JELLY 150G,PIECE,1,5000,4237,763,5000,June
5087,SANDALS 6000,PIECE,4,6000,20339,3661,24000,June
5091,SANTA LUCIA 450G,PIECE,27,5000,114407,20593,135000,June
5105,SAPIL PINK NANCY,PIECE,1,15000,12712,2288,15000,June
5113,SAUCEPAN 13000,PIECE,1,13000,11017,1983,13000,June
5145,SAVANNAH LEMON 3LTR,PIECE,1,22000,18644,3356,22000,June
5153,SAVANNAH PINEAPPLE 5LTR,PIECE,1,35000,29661,5339,35000,June
5159,SCARLET CARAMEL CHOCOLATE,PIECE,11,3000,27966,5034,33000,June
5167,SCHOOL SOCKS BLUE&WHITE 4000,PIECE,5,4000,16949,3051,20000,June
5170,SCHOOL SOCKS RED/GREEN YELLOW,PIECE,3,4000,10169,1831,12000,June
5173,SCHOOL STOCKINGS RED,PIECE,3,3000,7627,1373,9000,June
5174,SCHOOL STOCKINGS WHITE,PIECE,3,4500,11441,2059,13500,June
5175,SCISSORS 4000,PIECE,2,4000,6780,1220,8000,June
5176,SCISSORS 1500,PIECE,6,1500,7627,1373,9000,June
5180,SCOURER 1000,PIECE,29,1000,24576,4424,29000,June
5187,SCRATCHERS 1000,PIECE,2,1000,1695,305,2000,June
5189,SCRUBBING BRUSH LONG 5000,PIECE,1,6000,5085,915,6000,June
5190,SCRUBBING HAND BRUSH 5000,PIECE,1,5000,4237,763,5000,June
5196,SCRUBING BRUSHES WHITE 9000,PIECE,3,9000,22881,4119,27000,June
5198,SCRUBING HAND BRUSH 3000,PIECE,1,3000,2542,458,3000,June
5209,SECRETS PADS,PIECE,1,4000,3390,610,4000,June
5214,SENSITIVE BABY WIPES,PIECE,10,7000,59322,10678,70000,June
5218,SENSODYNE EXTRA FRESH GEL 75ML,PIECE,4,15000,50847,9153,60000,June
5223,SENSODYNE MULTICARE 40MLS,PIECE,8,8000,54237,9763,64000,June
5235,SESAME SNACKS,PIECE,7,5000,29661,5339,35000,June
5236,SESAME SNACKS 100G,PIECE,4,2500,8475,1525,10000,June
5250,SHADES 6000,PIECE,1,6000,5085,915,6000,June
5252,SHAKERS 1000,PIECE,1,1000,847,153,1000,June
5259,SHARPENER SMALL,PIECE,11,500,4661,839,5500,June
5260,SHARPENERS,PIECE,1,1000,847,153,1000,June
5265,SHENKE FLOWER REPELLENT,PIECE,4,8000,27119,4881,32000,June
5266,SHENKE LEMON REPELLANT 18000,PIECE,3,18000,45763,8237,54000,June
5267,SHENKE LEMON SCENT,PIECE,2,8000,13559,2441,16000,June
5268,SHENKE LOTUS SCENT,PIECE,2,8000,13559,2441,16000,June
5270,SHENKE MOSQUITO COIL LOW SMOKE,PIECE,1,6000,5085,915,6000,June
5272,SHENKE MOSQUITO REPELLANT,PIECE,5,16400,69492,12508,82000,June
5273,SHENKE MOSQUITO REPELLANT DOUBLE 20000,PIECE,6,22000,111864,20136,132000,June
5274,SHENKE ORANGE,PIECE,1,8000,6780,1220,8000,June
5275,SHENKE REPELLANT ORDOLESS,PIECE,1,8000,6780,1220,8000,June
5282,SHIVA HONEY 400G,PIECE,1,13000,11017,1983,13000,June
5287,SHOE BRUSH 5000,PIECE,6,5000,25424,4576,30000,June
5289,SHOE BRUSHES 1500,PIECE,7,1500,8898,1602,10500,June
5290,SHOE BRUSHES 2000,PIECE,2,2000,3390,610,4000,June
5301,SHOWER 2 SHOWER CONFIDENT,PIECE,1,6000,5085,915,6000,June
5302,SHOWER CAPS,PIECE,7,2000,11864,2136,14000,June
5303,SHOWER TO SHOWER HAPPY DAYS,PIECE,3,6000,15254,2746,18000,June
5306,SHOWER TO SHOWER SENSITIVE,PIECE,2,6000,10169,1831,12000,June
5307,SHOWER TO SHOWER SPRING RAIN,PIECE,5,6000,25424,4576,30000,June
5308,SHOWER TOSHOWER FRESH MORNING,PIECE,3,6000,15254,2746,18000,June
5314,SHOWERTOSHOWER FRESH DAWN,PIECE,1,6000,5085,915,6000,June
5316,SHREEJI 96PGS 1000,PIECE,1,1000,847,153,1000,June
5321,SHREEJI BOOK 200PGS,PIECE,6,4000,20339,3661,24000,June
5324,SHREEJI GRAPH BOOK 96,PIECE,3,3000,7627,1373,9000,June
5329,SHREEJI SQUARE BOOKS P6PGS,PIECE,1,2000,1695,305,2000,June
5331,SHUYA 240 MM,PIECE,2,6000,10169,1831,12000,June
5332,SHUYA 280MM,PIECE,3,6000,15254,2746,18000,June
5333,SHUYA 330MM,PIECE,13,6000,66102,11898,78000,June
5334,SHUYA PANT LINERS,PIECE,1,6000,5085,915,6000,June
5345,SILKEE DESIGNER SERVIETTES,PIECE,40,2500,84746,15254,100000,June
5347,SILKEE JUMBO TP,PIECE,220,2000,372881,67119,440000,June
5354,SILVER PLATE 1000,PIECE,45,1000,38136,6864,45000,June
5355,SILVER PLATE 300,PIECE,18,300,4576,824,5400,June
5356,SILVER PLATE 500,PIECE,28,500,11864,2136,14000,June
5360,SIMBA MBILI 100G,PIECE,3,7000,17797,3203,21000,June
5363,SIMBA MBILI 50G,PIECE,2,5500,9322,1678,11000,June
5366,SIMKA CHOC- VAN 300ML,PIECE,14,3500,41525,7475,49000,June
5367,SIMKA CHOCO BAR 100MLS,PIECE,23,2500,48729,8771,57500,June
5368,SIMKA CHOC-VAN 120MLS,PIECE,169,1000,143220,25780,169000,June
5369,SIMKA CHOC-VAN 230MLS,PIECE,90,2000,152542,27458,180000,June
5371,SIMKA CHOC-VANILLA 500ML,PIECE,11,4500,41949,7551,49500,June
5373,SIMKA PINE-VANILLA 120ML,PIECE,1,1000,847,153,1000,June
5374,SIMKA STRAW-VAN 120MLS,PIECE,245,1000,207627,37373,245000,June
5375,SIMKA STRAW-VAN 230MLS,PIECE,73,2000,123729,22271,146000,June
5376,SIMKA STRAW-VAN 300MLS,PIECE,12,3500,35593,6407,42000,June
5377,SIMKA STRAW-VAN 500MLS,PIECE,16,4500,61017,10983,72000,June
5379,SIMKA VANILLA 120MLS,PIECE,34,1000,28814,5186,34000,June
5380,SIMKA VANILLA 230MLS,PIECE,23,2000,38983,7017,46000,June
5381,SIMKA VANILLA 300MLS,PIECE,10,3500,29661,5339,35000,June
5382,SIMKA VANILLA 500MLS,PIECE,6,4500,22881,4119,27000,June
5389,SKALA CARROT BODY CREAM,PIECE,1,4000,3390,610,4000,June
5393,SKALA MEN CREME,PIECE,1,4000,3390,610,4000,June
5396,SKALA PERFUMED JELLY 200G,PIECE,1,4500,3814,686,4500,June
5399,SKIN CARE 100G,PIECE,2,3000,5085,915,6000,June
5400,SKIN CARE 150G,PIECE,2,4500,7627,1373,9000,June
5402,SKIN CARE 250G,PIECE,2,6500,11017,1983,13000,June
5408,SKIN DOCTOR HERBAL 250G,PIECE,2,7000,11864,2136,14000,June
5410,SKIN GUARD HAND WASH 550ML,PIECE,4,7000,23729,4271,28000,June
5433,SKY VIEW FRUITII 320ML,PIECE,42,1000,35593,6407,42000,June
5435,SKY VIEW ORANGE 320ML,PIECE,42,1000,35593,6407,42000,June
5436,SKYVIEW 320MLS,PIECE,46,1000,38983,7017,46000,June
5438,SKYVIEW ORANGE 500ML,PIECE,3,1500,3814,686,4500,June
5477,SMILE PENS WAVE 500,PIECE,13,500,5508,992,6500,June
5481,SNICKERS CHOCOLATE,PIECE,16,3500,47458,8542,56000,June
5482,SNOW SPRAYS 4500,PIECE,5,5000,21186,3814,25000,June
5483,SNOWMAN MAKERS,PIECE,3,1000,2542,458,3000,June
5497,SOAP DISH KENPOLY 1000,PIECE,1,2000,1695,305,2000,June
5508,SOFINE PURE OLIVE OIL 120ML,PIECE,4,7000,23729,4271,28000,June
5514,SOFT BROOM 10000,PIECE,3,10000,25424,4576,30000,June
5515,SOFT BROOM 15000,PIECE,2,15000,25424,4576,30000,June
5521,SOFT CARE BABY WIPES,PIECE,23,7000,136441,24559,161000,June
5527,SOFTCARE BABY PANTS L40,PIECE,3,27000,68644,12356,81000,June
5528,SOFTCARE BABY PANTS M44,PIECE,3,27000,68644,12356,81000,June
5530,SOFTCARE L40,PIECE,2,25000,42373,7627,50000,June
5531,SOFTCARE M42 GOLD,PIECE,3,25000,63559,11441,75000,June
5532,SOFTCARE MAXITHICK PADS,PIECE,1,3000,2542,458,3000,June
5535,SOFTCARE PAMPERS M12,PIECE,1,7000,5932,1068,7000,June
5536,SOFTCARE PAMPERS S15,PIECE,2,7500,12712,2288,15000,June
5539,SOFTCARE SANITARY PADS,PIECE,23,3000,58475,10525,69000,June
5558,SOSOFT BABY 750MLS,PIECE,3,11000,27966,5034,33000,June
5561,SOSOFT LUXURY 750MLS,PIECE,3,11000,27966,5034,33000,June
5566,SOY SAUCE DARK 150G,PIECE,8,5000,33898,6102,40000,June
5567,SOY SAUCE DARK 500G,PIECE,13,10000,110169,19831,130000,June
5568,SOY SAUCE LIGHT 150G,PIECE,6,5000,25424,4576,30000,June
5569,SOY SAUCE LIGHT 500G,PIECE,1,10000,8475,1525,10000,June
5574,SPARKLING CANDLES 8000,PIECE,1,7000,5932,1068,7000,June
5575,SPARKLING CANDLES 9000,PIECE,2,8500,14407,2593,17000,June
5589,SPIRAL NOTE BOOK 70S,PIECE,1,4500,3814,686,4500,June
5591,SPLASH APPLE 1LTR,PIECE,13,8000,88136,15864,104000,June
5592,SPLASH APPLE 250MLS,PIECE,73,2000,123729,22271,146000,June
5593,SPLASH APPLES 150ML,PIECE,7,1500,8898,1602,10500,June
5594,SPLASH BOX 42000,BOX,1,45000,38136,6864,45000,June
5597,SPLASH GUAVA 1LTR,PIECE,1,8000,6780,1220,8000,June
5602,SPLASH MANGO 150ML,PIECE,39,1500,49576,8924,58500,June
5603,SPLASH MANGO 250MLS,PIECE,64,2000,108475,19525,128000,June
5604,SPLASH MANGO JUICE 1LTR,PIECE,23,8000,155932,28068,184000,June
5609,SPONGE 2000,PIECE,14,2000,23729,4271,28000,June
5610,SPONGE 3000,PIECE,6,3000,15254,2746,18000,June
5611,SPONGE 4000,PIECE,5,4000,16949,3051,20000,June
5614,SPONGES 4500,PIECE,3,4500,11441,2059,13500,June
5615,SPONGES WHITE 3000,PIECE,6,3000,15254,2746,18000,June
5624,SPRING FILE 3000,PIECE,14,3000,35593,6407,42000,June
5625,SPRITE 2LTR,PIECE,27,5000,114407,20593,135000,June
5626,SPRITE 350MLS,PIECE,90,1000,76271,13729,90000,June
5627,SPRITE 500MLS,PIECE,38,1500,48305,8695,57000,June
5629,SQUEEZER 11000,PIECE,3,11000,27966,5034,33000,June
5630,SQUEEZERS 5000,PIECE,5,5000,21186,3814,25000,June
5631,SQUEEZERS DOULBLE 10000,PIECE,1,10000,8475,1525,10000,June
5633,SQUISHY BLUE RASBERRY 200ML,PIECE,28,2000,47458,8542,56000,June
5634,SQUISHY FRUIT DRINK 200ML,PIECE,29,2000,49153,8847,58000,June
5635,SQUISHY FRUIT DRINK MANGO 200ML,PIECE,22,2000,37288,6712,44000,June
5636,SQUISHY STRAWBERRY 200ML,PIECE,24,2000,40678,7322,48000,June
5642,STA SOFT SPRINGFRESH 2LTR,PIECE,2,27000,45763,8237,54000,June
5649,STAR COFFEE 250G B. CHOICE,PIECE,1,10000,8475,1525,10000,June
5651,STAR COFFEE 50G,PIECE,2,9000,15254,2746,18000,June
5655,STA-SOF-FRO CURL HAIR SPRAY,PIECE,2,11000,18644,3356,22000,June
5656,STA-SOFT LAVENDER 750ML,PIECE,2,12500,21186,3814,25000,June
5660,STEEPO CHOCOLATE,PIECE,4,2000,6780,1220,8000,June
5667,GOLDER STICK NOTES,PIECE,6,2000,10169,1831,12000,June
5668,STICK NOTES 8000,PIECE,1,8000,6780,1220,8000,June
5671,STING,PIECE,62,2000,105085,18915,124000,June
5672,STING RED RUSH,PIECE,46,2000,77966,14034,92000,June
5673,STONEY 350MLS,PIECE,7,1000,5932,1068,7000,June
5674,STONEY 500MLS,PIECE,33,1500,41949,7551,49500,June
5693,STRAWBERRY PRADIP COLORED,PIECE,2,5000,8475,1525,10000,June
5697,STREPSILS ORIGINAL,PIECE,20,1000,16949,3051,20000,June
5717,SUGAR 1KG,PIECE,55,5500,256356,46144,302500,June
5724,SULFO GLYCERINE COLORLESS,PIECE,1,2000,1695,305,2000,June
5725,SULFO GLYCERINE PINK,PIECE,9,2167,16525,2975,19500,June
5726,SULTAN COCONUT HAIL OIL,PIECE,6,5000,25424,4576,30000,June
5730,SUMZ COATED PEANUT 50G,PIECE,8,1200,8136,1464,9600,June
5731,SUMZ COCONUT COOKIES,PIECE,4,4000,13559,2441,16000,June
5733,SUMZ CHOCOLATE COOKIES 200G,PIECE,3,4000,10169,1831,12000,June
5735,SUMZ CORN CRAX 160G,PIECE,8,3000,20339,3661,24000,June
5736,SUMZ CORN CRAX 80G,PIECE,25,1500,31780,5720,37500,June
5739,SUMZ CRISPS CHILLI 60G,PIECE,18,2944,44915,8085,53000,June
5741,SUMZ CRISPS FRUIT CHUTNEY,PIECE,25,1500,31780,5720,37500,June
5743,SUMZ CRUNCHY DADDIES 150G,PIECE,8,3000,20339,3661,24000,June
5744,SUMZ DADDIES 75G 1000,PIECE,35,1500,44492,8008,52500,June
5746,SUMZ GINGER COOKIES,PIECE,6,4000,20339,3661,24000,June
5748,SUMZ GONJA 40G,PIECE,63,1500,80085,14415,94500,June
5749,SUMZ GONJA 90G CRISPS,PIECE,57,3000,144915,26085,171000,June
5750,SUMZ GONJA CRISPS 160G,PIECE,19,5500,88559,15941,104500,June
5753,SUMZ POTATO CRISP BBQ 30G,PIECE,20,1500,25424,4576,30000,June
5754,SUMZ POTATO CRISPS 180G,PIECE,35,5000,148305,26695,175000,June
5755,SUMZ POTATO CRISPS 20G,PIECE,292,600,148475,26725,175200,June
5756,SUMZ POTATO CRISPS 40G,PIECE,291,1500,369915,66585,436500,June
5757,SUMZ POTATO CRISPS 90G,PIECE,73,3000,185593,33407,219000,June
5758,SUMZ POTATO CRISPS TASTY TOMATO12G,PIECE,97,600,49322,8878,58200,June
5759,SUMZ PUMPKIN SEEDS 50G,PIECE,14,2500,29661,5339,35000,June
5760,SUMZ PUMPKIN SEEDS 70G,PIECE,5,3000,12712,2288,15000,June
5761,SUMZ ROASTED NUTS 120G,PIECE,21,3000,53390,9610,63000,June
5762,SUMZ ROASTED NUTS 400G,PIECE,4,8000,27119,4881,32000,June
5763,SUMZ ROASTED NUTS 60G,PIECE,23,1500,29237,5263,34500,June
5764,SUMZ SALT&VINEGAR 30G,PIECE,14,1500,17797,3203,21000,June
5766,SUMZ TANGY LEMON CRISPS 30G,PIECE,19,1500,24153,4347,28500,June
5767,SUMZS CRISPS 500G,PIECE,5,12000,50847,9153,60000,June
5768,SUN L DISH WASHING LIQUID400 ML,PIECE,2,7000,11864,2136,14000,June
5773,SUN SIP PASSION 3LTR,PIECE,3,16000,40678,7322,48000,June
5777,SUNLIGHT DISH LIQUID LEMON 400MLS,PIECE,1,7000,5932,1068,7000,June
5778,SUNLIGHT DISH PASTE,PIECE,1,6000,5085,915,6000,June
5780,SUNLIGHT DISHWASHING PASTE,PIECE,1,9000,7627,1373,9000,June
5782,SUNLIGHT DISHWASJING STRAWBERRY 400ML,PIECE,3,6500,16525,2975,19500,June
5784,SUNLIGHT LAVENDER 1KG,PIECE,3,11000,27966,5034,33000,June
5786,SUNLIGHT LAVENDER 500G,PIECE,1,5500,4661,839,5500,June
5792,SUNLIGHT SOAP 175G,PIECE,3,2500,6356,1144,7500,June
5794,SUNLIGHT SPRING IKG,PIECE,5,11000,46610,8390,55000,June
5795,SUNLIGHT SPRING SENSATIONS 500G,PIECE,2,5500,9322,1678,11000,June
5796,SUNLIGHT TROPICAL 1KG,PIECE,4,11000,37288,6712,44000,June
5797,SUNLIGHT TROPICAL 3.5KGS,PIECE,1,34000,28814,5186,34000,June
5798,SUNLIGHT TROPICAL 500G,PIECE,1,5500,4661,839,5500,June
5802,SUNSEED OIL 1LTRS,PIECE,15,12000,152542,27458,180000,June
5803,SUNSEED OIL 2LTRS,PIECE,2,22000,37288,6712,44000,June
5804,SUNSEED OIL 3LTRS,PIECE,1,28000,23729,4271,28000,June
5805,SUNSEED OIL 5LTRS,PIECE,1,45000,38136,6864,45000,June
5807,SUNSHINE BEEF FLAVOR,PIECE,116,500,49153,8847,58000,June
5808,SUNSHINE CHICKEN FLAVOR,PIECE,94,500,39831,7169,47000,June
5809,SUNSHINE ONION FLAVOR,PIECE,98,500,41525,7475,49000,June
5810,SUNSHINE PLAIN FLAVOR,PIECE,90,500,38136,6864,45000,June
5811,SUNSHINE TOMATO FLAVOR,PIECE,89,500,37712,6788,44500,June
5813,SUNSIP APPLE 3LTRS,PIECE,2,16000,27119,4881,32000,June
5814,SUNSIP APPLE 5LTR,PIECE,1,24000,20339,3661,24000,June
5815,SUNSIP BLACKCURRANT 3LTR,PIECE,1,16000,13559,2441,16000,June
5816,SUNSIP BLACKCURRANT 5LTR,PIECE,1,24000,20339,3661,24000,June
5817,SUN-SIP COCOPINE 3LTR,PIECE,2,16000,27119,4881,32000,June
5818,SUNSIP MANGO 3LTRS,PIECE,1,16000,13559,2441,16000,June
5822,SUNSIP STRAWBERRY 3LTR,PIECE,2,16000,27119,4881,32000,June
5844,SUPER GLUE,PIECE,8,1000,6780,1220,8000,June
5852,SUPREME BAKING FLOUR,PIECE,7,9000,53390,9610,63000,June
5859,SWEET IVORY PCS,PIECE,88,100,7458,1342,8800,June
5864,SWEET PEPSI,PIECE,72,100,6102,1098,7200,June
5875,SWEETS 100,PIECE,350,100,29661,5339,35000,June
5876,SWEETS 1000,PIECE,15,1000,12712,2288,15000,June
5878,SWEETS 200,PIECE,174,200,29492,5308,34800,June
5879,SWEETS 300,PIECE,111,300,28220,5080,33300,June
5881,SWEETS 500,PIECE,326,500,138136,24864,163000,June
5882,SWEETS 700 BIG FIVE,PIECE,20,700,11864,2136,14000,June
5904,SWT CHENAB 2KG,PIECE,4,28000,94915,17085,112000,June
5906,SWT LONG GRAIN 5KG/JASONS 5KG,PIECE,3,43000,109322,19678,129000,June
5909,SWT-1 RICE 1KG GREEN,PIECE,1,7500,6356,1144,7500,June
5999,TIAMO SWEETS,PIECE,3,200,508,92,600,June
6042,TOCEBAL AA,PIECE,3,1000,2542,458,3000,June
6045,TOILET BLUE BLOCKS 4PCS,PIECE,5,7500,31780,5720,37500,June
6048,TOILET BRUSH 7000,PIECE,3,7000,17797,3203,21000,June
6049,TOILET BRUSH TEEPEE10000,PIECE,3,10000,25424,4576,30000,June
6050,TOILET BRUSHES 12000,PIECE,2,12000,20339,3661,24000,June
6068,TOOTHPICK 1000,PIECE,20,1000,16949,3051,20000,June
6069,TOOTHPICK NATURAL,PIECE,2,2500,4237,763,5000,June
6101,TOP UP 400G,PIECE,15,2000,25424,4576,30000,June
6102,TOP UP 700G,PIECE,7,3500,20763,3737,24500,June
6103,TOP UP CHILL 260G,PIECE,8,2000,13559,2441,16000,June
6139,TOTO'S VESTLINE JELLY 500G,PIECE,1,10000,8475,1525,10000,June
6171,TRI-CIRCLE 262,PIECE,2,6000,10169,1831,12000,June
6172,TRI-CIRCLE 263,PIECE,1,7500,6356,1144,7500,June
6183,TROPICAL AIR F LAVENDER 300ML,PIECE,2,12000,20339,3661,24000,June
6185,TROPICAL HEAT BEEF MASALA 100G,PIECE,2,5000,8475,1525,10000,June
6186,TROPICAL HEAT BLACK PEPPER 100G,PIECE,1,8500,7203,1297,8500,June
6187,TROPICAL HEAT BLACK PEPPER 50G,PIECE,2,5500,9322,1678,11000,June
6188,TROPICAL HEAT CHICKEN MASALA 100G,PIECE,4,5000,16949,3051,20000,June
6189,TROPICAL HEAT CINNAMON 100G,PIECE,1,9500,8051,1449,9500,June
6190,TROPICAL HEAT CINNAMON 50G,PIECE,5,4500,19068,3432,22500,June
6192,TROPICAL HEAT CORIANDER 50G,PIECE,2,4500,7627,1373,9000,June
6197,TROPICAL HEAT FISH MASALA 100G,PIECE,1,5000,4237,763,5000,June
6199,TROPICAL HEAT GARLIC POWDER 100G,PIECE,4,7000,23729,4271,28000,June
6200,TROPICAL HEAT GARLIC POWDER 50G,PIECE,1,4500,3814,686,4500,June
6203,TROPICAL HEAT MEAT TENDERISER50G,PIECE,1,4000,3390,610,4000,June
6208,TROPICAL HEAT PAPRIKA,PIECE,1,3500,2966,534,3500,June
6209,TROPICAL HEAT PILAU MASALA 100G,PIECE,2,11000,18644,3356,22000,June
6210,TROPICAL HEAT PILAU MASALA 50G,PIECE,9,6000,45763,8237,54000,June
6215,TROPICAL HEAT TEA MASALA 100G,PIECE,2,10000,16949,3051,20000,June
6216,TROPICAL HEAT TEA MASALA 45G,PIECE,5,5000,21186,3814,25000,June
6218,TROPICAL HEAT TURMERIC 50G,PIECE,2,3500,5932,1068,7000,June
6233,TRUCK CAR 15000,PIECE,1,15000,12712,2288,15000,June
6239,TRUCK TOYS 12000,PIECE,1,12000,10169,1831,12000,June
6268,U.S.A BEAUTY SOAP BLACK,PIECE,2,6500,11017,1983,13000,June
6271,UBISCO CREAMS CHOCOLATE,PIECE,5,1000,4237,763,5000,June
6272,UBISCO CREAMS VANILLA,PIECE,6,1000,5085,915,6000,June
6280,UBISCO KREAMY CREAMS STRAWBERRY,PIECE,5,1000,4237,763,5000,June
6288,U-FRESH MANGO,PIECE,2,700,1186,214,1400,June
6290,UGACHICK DRUMSTICK WHOLE 500G,PIECE,1,13000,11017,1983,13000,June
6291,UGACHICK DRUMSTICKS 500G,PIECE,3,16500,41949,7551,49500,June
6292,UGACHICK FAMILY PACK 2KG,PIECE,1,42000,35593,6407,42000,June
6296,UGACHICK LIVER 500G,PIECE,4,4600,15593,2807,18400,June
6299,UGACHICK SUPA 1KG,PIECE,8,22000,149153,26847,176000,June
6300,UGACHICK THIGHS 500G,PIECE,3,13000,33051,5949,39000,June
6301,UGACHICK WINGS 500G,PIECE,1,13000,11017,1983,13000,June
6304,UGANDA SAFARI TEA 100G,PIECE,3,3500,8898,1602,10500,June
6305,UGANDA SAFARI TEA 250G,PIECE,1,7000,5932,1068,7000,June
6306,UGANDA SAFARI TEA 500G,PIECE,1,11000,9322,1678,11000,June
6307,UGANDA TEA BAGS,PIECE,5,5500,23305,4195,27500,June
6308,UGANDA TEA BAGS 100BAGS,PIECE,1,9000,7627,1373,9000,June
6310,UKWAJU,PIECE,81,1500,102966,18534,121500,June
6318,UMBRELLAS 8000,PIECE,3,8000,20339,3661,24000,June
6322,UMOJA SANDALS 6000,PIECE,1,7000,5932,1068,7000,June
6323,UMOJA SANDALS 8000,PIECE,8,8750,59322,10678,70000,June
6334,URBAN GWEKE 350G,PIECE,8,6000,40678,7322,48000,June
6366,V.L EXTRA HYDRATION LOTION 200ML,PIECE,3,8000,20339,3661,24000,June
6384,VALUE MAX PREP RAZOR,PIECE,1,3500,2966,534,3500,June
6385,VANILLA ED PASSION,PIECE,1,16000,13559,2441,16000,June
6397,VASELINE ALOESOOTHE 200ML,PIECE,1,8000,6780,1220,8000,June
6398,VASELINE ALOESOOTHE LOTION 400ML,PIECE,2,14500,24576,4424,29000,June
6401,VASELINE BLUESEAL COCOA BUTTER250ML,PIECE,3,9500,24153,4347,28500,June
6404,VASELINE BLUESEAL MEN FRESH 100ML,PIECE,5,5000,21186,3814,25000,June
6406,VASELINE BLUESEAL ORIGINAL 250ML,PIECE,4,9500,32203,5797,38000,June
6407,VASELINE COCOA GLOW 200ML,PIECE,1,8000,6780,1220,8000,June
6412,VASELINE DRY SKIN REPAIR 200ML,PIECE,1,8000,6780,1220,8000,June
6413,VASELINE DRY SKIN REPAIR LOTION 400ML,PIECE,3,15000,38136,6864,45000,June
6421,VASELINE MEN COOLING 400MLS,PIECE,1,14500,12288,2212,14500,June
6422,VASELINE MEN COOLING JELLY 240ML,PIECE,4,9500,32203,5797,38000,June
6423,VASELINE MEN COOLING LOTION 200ML,PIECE,1,8000,6780,1220,8000,June
6427,VASELINE MEN JELLY FRESH 240ML,PIECE,5,9500,40254,7246,47500,June
6437,VENUS MOROCCAN ARGAN OIL LOTION 400ML,PIECE,2,10000,16949,3051,20000,June
6440,VENUS SMOOTHING 400ML,PIECE,2,10000,16949,3051,20000,June
6450,VESTLINE ALOEVERA 400ML,PIECE,2,6500,11017,1983,13000,June
6452,VESTLINE GARLIC 200G,PIECE,1,4000,3390,610,4000,June
6453,VESTLINE GARLIC JELLY 200G,PIECE,2,5000,8475,1525,10000,June
6464,VIGOS HAZELNUT CHOCOLATE 800,PIECE,16,800,10847,1953,12800,June
6468,VIM LAVENDER 1KG,PIECE,2,8000,13559,2441,16000,June
6469,VIM LAVENDER 500G,PIECE,8,5000,33898,6102,40000,June
6470,VIM LEMON 1KG,PIECE,2,8000,13559,2441,16000,June
6471,VIM LEMON FRESH 500G,PIECE,5,5000,21186,3814,25000,June
6474,VINEGAR WHITE 700MLS,PIECE,1,2500,2119,381,2500,June
6491,WALMUS MUKENE SNACKS,PIECE,6,4500,22881,4119,27000,June
6496,WANDAZ PETROLEUM JELLY 250G,PIECE,3,6000,15254,2746,18000,June
6497,WANDAZ PETROLEUM JELLY 500G,PIECE,1,11500,9746,1754,11500,June
6520,WATER GUN TOYS 20000,PIECE,1,20000,16949,3051,20000,June
6533,WEET CORNFLAKES 750G,PIECE,1,30000,25424,4576,30000,June
6534,WEETABIX 112G,PIECE,5,4500,19068,3432,22500,June
6535,WEETABIX 225G,PIECE,5,8500,36017,6483,42500,June
6537,WEETABIX 450G,PIECE,5,15500,65678,11822,77500,June
6543,WEETABIX CORNFLAKES 250G,PIECE,2,12000,20339,3661,24000,June
6544,WEETABIX CORNFLAKES 500G,PIECE,8,16000,108475,19525,128000,June
6559,WHAT'S UP 320ML,PIECE,10,1000,8475,1525,10000,June
6564,WHISPPEX SHAVERS,PIECE,6,3167,16102,2898,19000,June
6572,WHITE STAR SOAP 1KG,PIECE,72,6500,396610,71390,468000,June
6573,WHITE VINEGAR,PIECE,10,2500,21186,3814,25000,June
6581,WHITEDENT HERBAL 250G,PIECE,5,8000,33898,6102,40000,June
6588,WIG CAP HAIR NET,PIECE,1,1500,1271,229,1500,June
6598,WISDOM SMOKERS TOOTHBRUSH,PIECE,9,2778,21186,3814,25000,June
6606,WRAPPERS 500,PIECE,17,500,7203,1297,8500,June
6607,WRAPPING PAPER 1000,PIECE,1,1000,847,153,1000,June
6612,YAKET 1.5LTR,PIECE,11,1500,13983,2517,16500,June
6613,YAKET 550ML,PIECE,129,500,54661,9839,64500,June
6614,YANAH COFFEE 5OG,PIECE,1,6000,5085,915,6000,June
6618,YARRISON BOXERS 3PCS 22000,PIECE,1,22000,18644,3356,22000,June
6620,YARRISON VESTS 3PCS 27000,PIECE,3,27000,68644,12356,81000,June
6642,YOJUS APPLE DRINK,PIECE,44,1000,37288,6712,44000,June
6643,YOJUS MANGO 150ML,PIECE,4,1000,3390,610,4000,June
6650,YOUR CHOICE SAUSAGE 1KG,PIECE,4,30000,101695,18305,120000,June
6651,YOUR CHOICE SAUSAGES 500G,PIECE,4,17000,57627,10373,68000,June
6665,ZESTA 300 G,PIECE,4,7500,25424,4576,30000,June
6666,ZESTA 500G,PIECE,2,10500,17797,3203,21000,June
6672,ZESTA MIXED FRUIT JAM,PIECE,1,7500,6356,1144,7500,June
6673,ZESTA MIXED FRUIT JAM 500G,PIECE,2,10500,17797,3203,21000,June
6674,ZESTA STRAWBERRY JAM,PIECE,2,10500,17797,3203,21000,June
6675,ZESTA STRAWBERRY JAM 300GM,PIECE,3,7500,19068,3432,22500,June
6676,ZESTA TOMATO KETCHUP,PIECE,13,7000,77119,13881,91000,June
6677,ZESTA TOMATO KETCHUP 700G,PIECE,4,12000,40678,7322,48000,June
6678,ZESTA TOMATO SAUCE 400G,PIECE,3,5000,12712,2288,15000,June
6695,JAMIES CAKE SLICE @6k,PIECE,22,6091,113559,20441,134000,June
6698,SOFINE GENLESE ROSE NOURISH 1L,PIECE,3,20000,50847,9153,60000,June
6701,MUSAWO JEZA BODY JELLY 60GMS,PIECE,1,2500,2119,381,2500,June
6704,BERTINI SPANISH OIL 250ML,PIECE,2,18000,30508,5492,36000,June
6707,VASELINE BLUESEAL MEN COOLING 95ML,PIECE,7,5000,29661,5339,35000,June
6708,VASELINE BLUESEAL BABY 95ML,PIECE,4,5000,16949,3051,20000,June
6709,VASELINE BLUESEAL JELLY ORIGINAL 95ML,PIECE,8,5000,33898,6102,40000,June
6710,VASELINE BLUESEAL COCOA BUTTER 95ML,PIECE,9,5000,38136,6864,45000,June
6711,NIVEA RICH NOURISHING 200ML,PIECE,1,14000,11864,2136,14000,June
6724,US MUSTARD 227G-8000,PIECE,2,8000,13559,2441,16000,June
6729,CHOFN TOOTHBRUSH 5000,PIECE,3,5000,12712,2288,15000,June
6736,JESA STRAWBERRY 450G,PIECE,12,6000,61017,10983,72000,June
6764,TRI CIRCLR 264 5K,PIECE,1,5000,4237,763,5000,June
6765,BIRTHDAY CANDLE 2K,PIECE,5,2000,8475,1525,10000,June
6770,SUNLIGHT SPRING 2KG,PIECE,1,20000,16949,3051,20000,June
6773,VEGETABLE SAMOSA 1000,PIECE,227,1000,192373,34627,227000,June
6775,CHAPS 3000,PIECE,261,3000,663559,119441,783000,June
6776,KEBAB 3000,PIECE,88.67,3000,225424,40576,266000,June
6778,PILAO PLAIN 5000,PIECE,8,4650,31525,5675,37200,June
6779,PILAO PLAIN 10000,PIECE,237.26,10000,2010678,361922,2372600,June
6781,VEGETABLE RICE 7000,PIECE,233.98,6957,1379534,248316,1627850,June
6784,LIVER STEW 8000,PIECE,117.28,7787,773898,139302,913200,June
6786,KABODY YELLOW PORRIDGE 1KG,PIECE,3,6500,16525,2975,19500,June
6787,VEGETABLE RICE 3500,PIECE,8,3125,21186,3814,25000,June
6788,BEEF SAUSAGES 1000,PIECE,1531,1000,1297458,233542,1531000,June
6790,KATOGO 4000,PIECE,237.98,3993,805220,144940,950160,June
6792,CHIPS 2500,PIECE,486.06,2502,1030695,185525,1216220,June
6793,LIVER 4000,PIECE,2,3000,5085,915,6000,June
6794,KATOGO 2500,PIECE,3,2700,6864,1236,8100,June
6795,KATOGO 2000,PIECE,1,2000,1695,305,2000,June
6798,CADBURY DAIRY MILK 35G,PIECE,34,4000,115254,20746,136000,June
6799,SPRING ROLLS VEGETABLE 1000,PIECE,18,1000,15254,2746,18000,June
6805,PANCAKES 500,PIECE,472,500,200000,36000,236000,June
6807,BEAN STEW 2000,PIECE,216,1996,365305,65755,431060,June
6808,CRACKERS 1500,PIECE,275,2000,466102,83898,550000,June
6810,PIZZA CHICKEN SLICE SMALL ,PIECE,1,3500,2966,534,3500,June
6812,BEEF STEW 6000,PIECE,517,2000,876271,157729,1034000,June
6813,GRILLED CHICKEN 7000,PIECE,146,7000,866102,155898,1022000,June
6816,BLUE BAND 250G,PIECE,36,5000,152542,27458,180000,June
6817,BALLET BABY SOAP ALOEVERA,PIECE,4,4000,13559,2441,16000,June
6820,BEEF SAMOSA 1500,PIECE,336,1500,427119,76881,504000,June
6821,CHAPATI 1000,PIECE,2547,996,2150000,387000,2537000,June
6831,JESA MIXED BERRY YOGHURT 250G,PIECE,4,2500,8475,1525,10000,June
6833,BEAUTION OIL,PIECE,3,5000,12712,2288,15000,June
6835,PREMIUM BLADE RAZOR 6PACK,PIECE,1,11000,9322,1678,11000,June
6840,GONJA FRIED 1000,PIECE,125.5,1028,109322,19678,129000,June
6841,PIZZA CHICKEN SLICE BIG ,PIECE,124,6000,630508,113492,744000,June
6847,PIZZA 14'' CHICKEN ,PIECE,1,25000,21186,3814,25000,June
6848,PIZZA 16'' CHICKEN ,PIECE,2,35000,59322,10678,70000,June
6851,PIZZA 16'' BEEF,PIECE,1,35000,29661,5339,35000,June
6859,ROLEX NORMAL 2EGGS,PIECE,74,2500,156780,28220,185000,June
6864,SWEET POTATOES FRIED,PIECE,1,1000,847,153,1000,June
6867,IRISH POTATOES ,PIECE,0.1,10000,847,153,1000,June
6868,SPAGHETI 2500,PIECE,240.12,2496,507881,91419,599300,June
6871,POSHO KG,PIECE,30.63,5010,130051,23409,153460,June
6876,"GREENS (NAKATI,DODO ETC)",PIECE,9.5,9084,73102,13158,86260,June
6882,SUMZ FRIED PEAS,PIECE,2,2500,4237,763,5000,June
6885,JAGO SCRUB 110G,PIECE,2,4000,6780,1220,8000,June
6889,EGGS BOILED 500,PIECE,526,500,222881,40119,263000,June
6892,RAHA DRINKING CHOCOLATE 10G,PIECE,5,500,2119,381,2500,June
6894,SQUISHY JUICE APPLE,PIECE,28,2000,47458,8542,56000,June
6913,MELEX CORN CRAX 160GM,PIECE,2,2500,4237,763,5000,June
6921,ZENDEN PLASTIC PLAYING CARDS ,PIECE,5,5000,21186,3814,25000,June
6935,SHREEJI 96 PAGES A4 ,PIECE,1,2000,1695,305,2000,June
6936,JESA MIXED BERRY YOGHURT 500G,PIECE,25,3700,78390,14110,92500,June
6943,SUMZ POTATO CRISPS FRUIT CHUTNEY 12G,PIECE,41,600,20847,3753,24600,June
6948,NIVEA DOULBLE EFFECT 48HRS,PIECE,2,11000,18644,3356,22000,June
6953,STRIKE NUTS CHOCOLATE BAR,PIECE,3,1500,3814,686,4500,June
6960,NAN GUEST BATHING SOAP,PIECE,2,4000,6780,1220,8000,June
6964,FROST BIKE DOLL 35000,PIECE,1,35000,29661,5339,35000,June
6970,YAM SLICE 1000,PIECE,203,1000,172034,30966,203000,June
6971,SWEET POTATOES BOILED 1000,PIECE,181,1000,153390,27610,181000,June
6976,SUMZ POTATO CRIPS TASTY TOMATO 30G,PIECE,24,1500,36000,0,36000,June
6985,LA BELLE BODY LOTION SHEA BUTTER 250ML,PIECE,1,6000,5085,915,6000,June
6988,ELITE BALL PENS 500,PIECE,2,500,847,153,1000,June
6993,DOMS WAX CRAYONS BIG,PIECE,2,5000,8475,1525,10000,June
6996,NATARAJ WAX CRAYONS 2500,PIECE,6,2500,12712,2288,15000,June
7000,MASTER MATH SET A006 5000,PIECE,7,5000,29661,5339,35000,June
7002,M&G OFFICE SCISSORS 190MM,PIECE,2,6500,11017,1983,13000,June
7015,JESA STRAWBERRY&CHOCOLATE 450G,PIECE,4,6000,20339,3661,24000,June
7021,RIGGS LONDON POWER ,PIECE,2,16000,27119,4881,32000,June
7025,FACE TOWELS 6000,PIECE,4,6000,20339,3661,24000,June
7026,CHICKEN STEW 4000,PIECE,280,4000,949153,170847,1120000,June
7036,SOAP DISH 3500,PIECE,1,3500,2966,534,3500,June
7037,POTTIES 15000,PIECE,1,15000,12712,2288,15000,June
7051,KELLOGGS CORN FLAKES 750G ORIGINAL,PIECE,2,34000,57627,10373,68000,June
7053,TREET SHAVER 1000,PIECE,2,1000,1695,305,2000,June
7063,"AXE ICE CHILL, GOLD, ADRENALIN",PIECE,1,13000,11017,1983,13000,June
7064,ARMAF ELEGANT WOMEN SPLASH,PIECE,1,16000,13559,2441,16000,June
7065,BRITANIA SWEET MEAL BISCUITS,PIECE,4,2500,8475,1525,10000,June
7073,SUMZ TANGY LEMON CRISPS 12G,PIECE,23,600,11695,2105,13800,June
7077,VASELINE BLUESEAL ALOEVERA 95ML,PIECE,1,5000,4237,763,5000,June
7078,VASELINE BLUESEAL ALOEVERA 240ML,PIECE,2,9500,16102,2898,19000,June
7101,JAMIES DADDIES TIN 17000,PIECE,5,17000,72034,12966,85000,June
7102,JAMIES DADDIES TIN 20000,PIECE,6,20000,101695,18305,120000,June
7108,RASASI YOYALE BLUE SPRAY ,PIECE,1,12000,10169,1831,12000,June
7112,PUMPKIN SLICE 1000,PIECE,82,1000,69492,12508,82000,June
7115,CLAIRMEN CREAM 300ML,PIECE,1,14000,11864,2136,14000,June
7118,LEMON CLEAR CREME 250ML,PIECE,1,11000,9322,1678,11000,June
7120,JAMIES DADDIES 500G 10000,PIECE,9,10000,76271,13729,90000,June
7130,JAMIES MUFFINS 2000,PIECE,77,2000,130508,23492,154000,June
7139,SUMZ BBQ CRISPS 12G,PIECE,54,600,27458,4942,32400,June
7141,AXION LIME 350G,PIECE,2,10000,16949,3051,20000,June
7142,JAMIES MARBLE CAKE 3000,PIECE,170,3000,432203,77797,510000,June
7143,GRAVY SOUP 1000,PIECE,215.81,996,182076,32774,214850,June
7144,JAMIES DOUGHNUT BIG CHOCOLATE 2500,PIECE,65,2500,137712,24788,162500,June
7146,JAMIES COOKIES TIN 500G 10000,PIECE,7,10000,59322,10678,70000,June
7147,JAMIES COOKIES 800G TIN 17000,PIECE,3,17000,43220,7780,51000,June
7150,HIT LILY BLOSSOM 400ML,PIECE,1,17000,14407,2593,17000,June
7163,SPIDERMAN SWEETS 700,PIECE,3,700,1780,320,2100,June
7164,NUTRO ORANGE BISCUIT 1200,PIECE,22,1200,22373,4027,26400,June
7165,ONER APPLE DRINK 1LTR,PIECE,21,5000,88983,16017,105000,June
7168,SPLASH TROPICAL FRUIT PUNCH 1LTR,PIECE,15,8000,101695,18305,120000,June
7174,JAMIES LIQUID SOAP 5LTR 10000,PIECE,2,10000,16949,3051,20000,June
7175,JAMIES LIQUID SOAP 3LTR,PIECE,3,3000,7627,1373,9000,June
7182,PLAIN OMLETTE 8000,PIECE,1,2000,1695,305,2000,June
7270,FRIED EGGS 5000,PIECE,2,2000,3390,610,4000,June
7277,DOUGHNUTS WHOLESALE 2500,PIECE,2,2500,4237,763,5000,June
7278,JUICE 2000 300ML,PIECE,60,2000,101695,18305,120000,June
7279,JUICE 4000 500ml,PIECE,46,4000,155932,28068,184000,June
7284,SUMZ SALT& VIEGAR,PIECE,38,600,19322,3478,22800,June
7295,PLASTIC SWINGING CANDLE 2500,PIECE,4,2500,8475,1525,10000,June
7296,BANANA JUICE 3000,PIECE,10,3000,25424,4576,30000,June
7308,COTTON EAR SWABS 4000,PIECE,3,4667,11864,2136,14000,June
7313,SAPIL PINK LACE 15000,PIECE,1,15000,12712,2288,15000,June
7330,SUMZ GONJA CRISP 400G,PIECE,5,12000,50847,9153,60000,June
7332,SWT-P 5KG,PIECE,1,43000,36441,6559,43000,June
7337,LUX PREMIUMS MENS UNDER WEAR,PIECE,1,16000,13559,2441,16000,June
7339,SOFTCARE GOLD S48,PIECE,2,25000,42373,7627,50000,June
7349,BODY SCRUBBER GLOVE,PIECE,13,2500,27542,4958,32500,June
7351,WATER GUN 10000,PIECE,1,10000,8475,1525,10000,June
7361,SUMZ DADDIES 300G,PIECE,2,5000,8475,1525,10000,June
7363,SUMZ PUMPKIN SEEDS 100G,PIECE,1,5000,4237,763,5000,June
7364,SUMZ BAGGIA 100G,PIECE,8,3000,20339,3661,24000,June
7365,SUMZ BAGGIA 50G,PIECE,25,1500,31780,5720,37500,June
7373,VASELINE BLUESEAL BABY 240ML,PIECE,1,9500,8051,1449,9500,June
7374,JAMIES WHOLE SALE SWEET YELLOW 5000,PIECE,75,5000,317797,57203,375000,June
7375,JAMIES WHOLE SALE SWEET BROWN 5000,PIECE,49,5000,207627,37373,245000,June
7376,JAMIES WHOLE SALE SWEET WHITE 5000,PIECE,65,5000,275424,49576,325000,June
7378,SUMZ COATED PEANUTS CHILLI MASALA 150G,PIECE,8,3000,20339,3661,24000,June
7379,SUMZ COATED PEANUTS PLAINMASALA 150G,PIECE,8,3000,20339,3661,24000,June
7380,AFROCARE PERFUMED JELLY 500G,PIECE,2,10000,16949,3051,20000,June
7382,RIGGS PATROL BODY SPRAY 250ML,PIECE,1,16000,13559,2441,16000,June
7383,MOVIT BABY JELLY 200G,PIECE,2,5000,8475,1525,10000,June
7385,RIHAM X-ENERGY 320ML,PIECE,2,1500,2542,458,3000,June
7388,HIKMA YELLOW BAGIYA 4000,PIECE,5,4500,19068,3432,22500,June
7389,HIKMA YELLOW BAGIYA 2000,PIECE,14,1500,17797,3203,21000,June
7390,HIKMA BAGIYA 1500,PIECE,2,1000,1695,305,2000,June
7392,HIKMA DADDIES 5000,PIECE,11,5000,46610,8390,55000,June
7393,HIKMA DADDIES 2000,PIECE,11,2000,18644,3356,22000,June
7396,JAMIES SWEET WHITE WHOLESALE 500G 2500,PIECE,80,2500,169492,30508,200000,June
7397,JAMIES SWEET YELLOW 500G WHOLE SALE 2500,PIECE,84,2500,177966,32034,210000,June
7398,JAMIES SWEET BROWN 500G WHOLE SALE 2500,PIECE,85,2500,180085,32415,212500,June
7400,NUTRO DIGESTIVE LIGHT 400G,PIECE,1,13000,11017,1983,13000,June
7404,MELEX SIMSIM BALLS 250G,PIECE,26,5000,110169,19831,130000,June
7406,COLGATE TOOTHBRUSH 6+,PIECE,1,6000,5085,915,6000,June
7410,ONER TAMARIND 500ML,PIECE,88,2500,186441,33559,220000,June
7411,PAMPERS PANTS 6,PIECE,2,40000,67797,12203,80000,June
7414,AMERICAN CROWN SHOWER GEL ALOEVERA& CUCUMBER 1000ML,PIECE,2,18000,30508,5492,36000,June
7417,DOVE NOURISHING SILK 500ML,PIECE,1,22000,18644,3356,22000,June
7419,Sandals,PIECE,4,8001,27120,4882,32002,June
7426,JAMIES SWEET CAKE BREAD WHOLESALE 5000,PIECE,6,5000,25424,4576,30000,June
7427,COLGATE CLEAN MINT 10500,PIECE,1,10500,8898,1602,10500,June
7429,TROPICAL HEAT PAPRIKA SPICE 100G,PIECE,4,6000,20339,3661,24000,June
7430,JAMIES SWEET YELLOW BUNS WHOLESALE 2500,PIECE,105,2500,222458,40042,262500,June
7431,JAMIES MARBLE CAKE 10000,PIECE,2,15000,25424,4576,30000,June
7432,FRESCO BODY OIL 100ML 4000,PIECE,5,4500,19068,3432,22500,June
7438,YARRISON KIDS VESTS18000,PIECE,2,18000,30508,5492,36000,June
7446,DOWNY VALLEY DEW 1L 22000,PIECE,1,24000,20339,3661,24000,June
7455,CANDLE NUMBER BIG 3500,PIECE,1,3500,2966,534,3500,June
7473,ARTIN MASSAGE OIL OLIVE OIL 1LTR,PIECE,1,13000,11017,1983,13000,June
7476,MENTOS MINT 29G,PIECE,1,2500,2119,381,2500,June
7486,APPLES PACKED 11000,PIECE,19,11000,177119,31881,209000,June
7488,VERSMAN ACTIVE LOTION 400ML,PIECE,1,17000,14407,2593,17000,June
7494,FRUIT VILLE TROPICAL,PIECE,17,3500,50424,9076,59500,June
7497,JAMIES SWEET BUNS BROWN 6PCS WHOLESALE,PIECE,153,2500,324153,58347,382500,June
7498,JAMIES SWT WHITE BUNS 6PCS WHOLESALE,PIECE,50,2500,105932,19068,125000,June
7499,JAMIES SWEET CAKE WHOLESALE 500G,PIECE,2,2500,4237,763,5000,June
7515,CROWN NEBRAS 35ML,PIECE,1,12000,10169,1831,12000,June
7516,CROWN SULTAN 35ML,PIECE,1,12000,10169,1831,12000,June
7523,SPARKING CANDLE 7000,PIECE,1,7000,5932,1068,7000,June
7524,TOYS 2000,PIECE,7,2000,11864,2136,14000,June
7525,KIDS GLASSES 2500,PIECE,1,2500,2119,381,2500,June
7533,DOCTORS KIT 21000,PIECE,1,20000,16949,3051,20000,June
7539,Bottles 20000,PIECE,1,10000,8475,1525,10000,June
7540,NUMA KARO 2KG 12000,PIECE,1,12000,10169,1831,12000,June
7543,DOLLS3000,PIECE,1,2000,1695,305,2000,June
7547,TOYS 15000,PIECE,2,15000,25424,4576,30000,June
7550,TOYS 20000,PIECE,2,22500,38136,6864,45000,June
7553,TOYS 3000,PIECE,5,3200,13559,2441,16000,June
7554,AFIA LEMON 500ML,PIECE,22,3000,55932,10068,66000,June
7568,RIGGS VOYAGE,PIECE,1,16000,13559,2441,16000,June
7580,COSMO ALOEVERA 100%,PIECE,1,13000,11017,1983,13000,June
7588,SUMZ CASHEW NUTS 75G,PIECE,2,7500,12712,2288,15000,June
7590,WEETABIX SUPER SAVER 850G,PIECE,3,26000,66102,11898,78000,June
7592,COLGATE CHARCOAL 210G 10000,PIECE,9,11000,83898,15102,99000,June
7593,COLGATE CHARCOAL 35G 2500,PIECE,13,2500,27542,4958,32500,June
7595,NISA PAPAYA OIL LOTION 400ML,PIECE,1,13000,11017,1983,13000,June
7606,BEYOGLU BISCUITO,PIECE,2,1500,2542,458,3000,June
7607,LABELLE BABY JELLY 450G,PIECE,1,10000,8475,1525,10000,June
7614,DUSTER 2500,PIECE,1,2500,2119,381,2500,June
7615,NOVICOL WOOD GLUE 500G,PIECE,1,8000,6780,1220,8000,June
7617,NUVITA COOKIES COCONUT 100GM,PIECE,4,2300,7797,1403,9200,June
7620,SPRITE CAN 330ML,PIECE,14,2700,32034,5766,37800,June
7621,MINTORE X PLUS 500,PIECE,5,500,2119,381,2500,June
7624,COSMO GELTEMPTATION OUD 1000ML,PIECE,1,18000,15254,2746,18000,June
7627,NIVEA MEN FRESH OCEAN 150ML,PIECE,1,16000,13559,2441,16000,June
7633,CLERE COCOA BUTTER 400ML,PIECE,1,8000,6780,1220,8000,June
7643,KAXUE KIDS TOOTHBRUSH,PIECE,9,2500,19068,3432,22500,June
7644,FANEST CHICKEN SAUSAGES 500G,PIECE,1,15000,12712,2288,15000,June
7647,SKY VIEW APPLE 320ML,PIECE,40,1000,33898,6102,40000,June
7650,JAMIES SWEET WHITE BUNS @4000,PIECE,143,4000,484746,87254,572000,June
7658,HANDSOME BOXER 18000,PIECE,1,18000,15254,2746,18000,June
7687,NOTE BOOK 6500,PIECE,2,6500,11017,1983,13000,June
7693,HAND BRUSH 2500,PIECE,1,2500,2119,381,2500,June
7701,CLEAR BAGS 1500,PIECE,7,1500,8898,1602,10500,June
7703,TOYS 1000,PIECE,8,1000,6780,1220,8000,June
7704,JAMIES MILK BREAD 5500,PIECE,162,5981,821186,147814,969000,June
7705,JAMIES CAKE SLICE@8000,PIECE,41,8000,277966,50034,328000,June
7706,JAMIES MILK BREAD 500G,PIECE,48,3500,142373,25627,168000,June
7707,JAMIES COOKIES@20000,PIECE,4,20000,67797,12203,80000,June
7719,SECRETS PADS ULTRA DAY&NIGHT PINK,PIECE,2,5500,9322,1678,11000,June
7720,SECRETS PADS ULTRA OVER NIGHT BLUE,PIECE,3,5500,13983,2517,16500,June
7721,SECRETS PANT LINERS PURPLE,PIECE,1,5500,4661,839,5500,June
7724,JAMIES DOUGHNUTS SMALL 6PCS,PIECE,3,3000,7627,1373,9000,June
7727,JAMIES SWEET WHITE BUNS WHOLESALE,PIECE,70,2500,175000,0,175000,June
7733,SUMZ MATOOKE CRISPS BBQ 20G,PIECE,1,600,508,92,600,June
7745,CHOCOLATE 800,PIECE,6,800,4068,732,4800,June
7746,SWEETS 1500,PIECE,2,1500,2542,458,3000,June
7748,BAKEMATE LOVE 1500,PIECE,3,1500,3814,686,4500,June
7749,SENIOR AVIATION 787,PIECE,1,30000,25424,4576,30000,June
7750,TOYS 4000,PIECE,1,4000,3390,610,4000,June
7755,DOLL 5000,PIECE,1,5000,4237,763,5000,June
7761,LOVE HEART 2000,PIECE,2,2000,3390,610,4000,June
7762,PRINGLES PAPRIKA,PIECE,2,5500,9322,1678,11000,June
7765,PRINGLES PAPRIKA 165G,PIECE,2,12000,20339,3661,24000,June
7766,JAMIES CAKE 45000,PIECE,1,45000,38136,6864,45000,June
7770,PREDATOR ENERGY 350ML,PIECE,18,2000,30508,5492,36000,June
7774,SUMZ TANGY LEMON 60G,PIECE,1,3000,2542,458,3000,June
7785,JINBO NOTEBOOK 15000,PIECE,3,15000,38136,6864,45000,June
7789,JAMIES DANISH BREAD@3500,PIECE,35,3500,103814,18686,122500,June
7790,JAMIES CINNAMON BREAD,PIECE,177,5986,897881,161619,1059500,June
7797,VERSMAN TRENDY 10000,PIECE,2,9500,16102,2898,19000,June
7798,NISA PAPAYA 200ML 8000,PIECE,1,8000,6780,1220,8000,June
7803,FACE MASK BLACK 120ML 10000,PIECE,1,10000,8475,1525,10000,June
7808,PICNIK CHOCOLATE 10G,PIECE,8,1000,6780,1220,8000,June
7815,7UP 330ML,PIECE,90,1000,76271,13729,90000,June
7817,ODEON CUCUMBER&MINT 300ML,PIECE,1,11000,9322,1678,11000,June
7824,BANANA JUICE 5000,PIECE,7,5000,29661,5339,35000,June
7826,JAMIES CINNAMON BREAD 500G,PIECE,36,3500,106780,19220,126000,June
7829,KICK PRINCESS CHICKEN FLAVOUR ,PIECE,211,500,89407,16093,105500,June
7830,PICK n PEEL ORANGE JUICE 1LITRE,PIECE,1,9500,8051,1449,9500,June
7831,7UP 500ML,PIECE,24,1500,30508,5492,36000,June
7832,FANEST BEEF SAUSAGES 500G,PIECE,6,13000,66102,11898,78000,June
7833,FANEST BEEF SAUSAGES 1KG,PIECE,4,21000,71186,12814,84000,June
7837,TEMMYS CRISP RICE 250G,PIECE,1,10000,8475,1525,10000,June
7839,RIGGS CHIEF 250ML,PIECE,1,16000,13559,2441,16000,June
7842,DOVE SECRETS 250ML,PIECE,2,20500,34746,6254,41000,June
7843,DOVE INVISIBLE CARE 250ML SPRAY,PIECE,1,20000,16949,3051,20000,June
7846,HOBBY ROMANTIC HAND WASH 400ML,PIECE,1,7500,6356,1144,7500,June
7849,ELEGANT LEGEND AF 300ML,PIECE,1,7000,5932,1068,7000,June
7853,U BEATY GEL 1.8L,PIECE,3,20000,50847,9153,60000,June
7857,MOOISTE CHOCOLATE,PIECE,7,2500,14831,2669,17500,June
7859,TOFFEE 500,PIECE,28,500,11864,2136,14000,June
7860,WASH -Q KIDS TOOTH BRUSH ,PIECE,2,1000,1695,305,2000,June
7861,ROYAL SHAVERS,PIECE,9,3500,26695,4805,31500,June
7862,ORCHID VALLEY GUAVA 250ML,PIECE,1,2000,1695,305,2000,June
7863,ORCHID VALLEY MANGO 250ML,PIECE,3,2000,5085,915,6000,June
7869,CLEAN SPONGE 5500,PIECE,2,5500,9322,1678,11000,June
7871,DOVE ESSENTIAL CARE LOTION 400ML,PIECE,2,19000,32203,5797,38000,June
7875,DOVE PAMPERING CARE 400ML,PIECE,1,19000,16102,2898,19000,June
7876,GRILLED GOATS MEAT 8000,PIECE,47,8000,318644,57356,376000,June
7878,BLUE BAND WITH CHOCO 250G,PIECE,16,6256,84831,15269,100100,June
7879,WEETABIX VANILLA 230G,PIECE,1,9500,8051,1449,9500,June
7883,ELEGANT FANTAOIA A.R 300ML,PIECE,2,6500,11017,1983,13000,June
7884,ROKI COOKING OIL 1L,PIECE,4,8000,27119,4881,32000,June
7885,ROKI COOKING OIL 500ML,PIECE,6,4000,20339,3661,24000,June
7886,PAKA MATCH BOX,PIECE,4,1000,3390,610,4000,June
7888,REXONA INVISIBLE DRY FRESH ROLLON 72JAM,PIECE,3,10000,25424,4576,30000,June
7889,DOVE GO FRESH ROLLON 48HR,PIECE,3,11000,27966,5034,33000,June
7893,NUVITA SHORT CAKE 1500,PIECE,2,1500,2542,458,3000,June
7894,NUVITA CHOCOLATE COOKIES 100GM,PIECE,11,2500,23305,4195,27500,June
7895,NUVITA BUTTER COOKIES 100GM,PIECE,6,2500,12712,2288,15000,June
7896,NUVITA CHOCO CHIP COOKIES 100GM,PIECE,9,2500,19068,3432,22500,June
7898,PRETTY BE WILD STRAWBERRY 250ML,PIECE,1,16000,13559,2441,16000,June
7899,PRETTY BE PINK PETALS PERFUMED 250ML,PIECE,1,16000,13559,2441,16000,June
7900,PRETTY BE COCONUT& WARM VANILLA 250ML,PIECE,1,16000,13559,2441,16000,June
7901,YULU CLASSIC BOXERS 3PCS 22000,PIECE,4,21000,71186,12814,84000,June
7902,NIVEA FRESH CHERRY ROLL ON ,PIECE,1,11000,9322,1678,11000,June
7903,BLUE BAND WITH CHOCO 500G,PIECE,4,11000,37288,6712,44000,June
7904,SAFEGUAD SOFTCARE SOAP JUMBO,PIECE,2,3000,5085,915,6000,June
7905,SAFEGUARD LEMON SOAP,PIECE,5,1500,6356,1144,7500,June
7906,SAFEGUARD PURE WHITE ,PIECE,2,1500,2542,458,3000,June
7907,WEETABIX CORNFLAKES CRUNCHY 250G,PIECE,4,9750,33051,5949,39000,June
7909,ONER APPLE DRINK 200ML,PIECE,45,1000,38136,6864,45000,June
7910,ONER MANGO 200ML,PIECE,85,1000,72034,12966,85000,June
7911,RIHAM X ENERGY 400ML,PIECE,23,2000,38983,7017,46000,June
7912,COSMO SHOWERGELS MIX VAN.STRAW.TROPICAL 1LTR,PIECE,2,20000,33898,6102,40000,June
7913,CLERE BABY JELLY 50G,PIECE,1,2000,1695,305,2000,June
7914,SHOWER TO SHOWER MEN 48H,PIECE,2,6000,10169,1831,12000,June
7915,"AMERICAN CROWN LAVENDER A.F, CITRU, LEMON",PIECE,6,7000,35593,6407,42000,June
7916,SIMKA MANGO-VAN 500ML,PIECE,1,4500,3814,686,4500,June
7917,SAFEGUARD LEMON FRESH JUMBO,PIECE,2,3000,5085,915,6000,June
7918,JAMIES MILK BREAD WHOLESALE 1KG,PIECE,5,5500,23305,4195,27500,June
7919,JAMIES CINNAMON BREAD WHOLESALE 1KG,PIECE,1,5500,4661,839,5500,June
7921,SOFTCARE BABY PANTS M9,PIECE,3,9000,22881,4119,27000,June
7922,AKABOGA ONION CHILI PASTE 200ML,PIECE,1,6500,5508,992,6500,June
7923,7UP SODA 2LTR,PIECE,4,4500,15254,2746,18000,June
7924,CHICKEN WHOLE 1.3-1.4KG 25000,PIECE,3,25000,63559,11441,75000,June
7925,MASREYA PENNE PASTA 3500,PIECE,3,3500,8898,1602,10500,June
7926,MASREYA ELBOW PASTA 3500,PIECE,6,3500,17797,3203,21000,June
7933,WEETABIX CORNFLAKES 50G,PIECE,5,2000,8475,1525,10000,June
4,180ML DISPOSABLE GLASSES,PIECE,4.1,3000,10169,1831,12000,July
7,300MLS DISPOSABLE GLASSES,PIECE,5,5000,21186,3814,25000,July
8,354 HONEY,PIECE,1,3500,2966,534,3500,July
9,500MLS DISPOSABLE GLASSES,PIECE,6,6000,30508,5492,36000,July
11,60K DIARY NOTE BOOK,PIECE,1,4500,3814,686,4500,July
12,7 DAYS BABY WIPES,PIECE,3,8500,21610,3890,25500,July
14,7 DAYS WIPES,PIECE,4,5000,16949,3051,20000,July
15,7DAYS ANTIBACTERIAL BABY WIPES,PIECE,4,8500,28814,5186,34000,July
16,7DAYS ANTIBACTERIAL WIPES,PIECE,4,5000,16949,3051,20000,July
18,7DAYS PANT LINERS,PIECE,1,4000,3390,610,4000,July
26,ABC BABY WIPES,PIECE,4,9000,30508,5492,36000,July
35,ACTIVE MAN SPRAY,PIECE,1,10000,8475,1525,10000,July
43,ADIDAS PURE GAME SPRAY,PIECE,1,13000,11017,1983,13000,July
49,AFIA APPLE 500ML,PIECE,19,3000,48305,8695,57000,July
51,AFIA MANGO 500MLS,PIECE,17,3000,43220,7780,51000,July
52,AFIA MIXED FRUIT 500MLS,PIECE,14,3000,35593,6407,42000,July
55,AFIA WHITE GUAVA,PIECE,13,3000,33051,5949,39000,July
58,AFRICANA TEA BAGS 50,PIECE,1,5000,4237,763,5000,July
60,AFROCARE BODY LOTION 400ML,PIECE,3,6000,15254,2746,18000,July
61,AFROCARE JELLY 100G,PIECE,1,3000,2542,458,3000,July
62,AFROCARE PERFUMED GLYCERINE,PIECE,2,2500,4237,763,5000,July
63,AFROCARE PETROLEUM JELLY,PIECE,4,4500,15254,2746,18000,July
73,ALPER DRAJE CHOCOLATE,PIECE,5,3200,13559,2441,16000,July
81,ALWAYS COTTON EXTRA LONG,PIECE,5,3000,12712,2288,15000,July
85,ALWAYS DREAMZZZ VALUE PACK,PIECE,1,6500,5508,992,6500,July
86,ALWAYS EXTRA LONG,PIECE,17,3500,50424,9076,59500,July
88,ALWAYS LONG,PIECE,6,3500,17797,3203,21000,July
91,ALWAYS ULTRA THIN,PIECE,10,3500,29661,5339,35000,July
92,ALWAYS ULTRA V.P,PIECE,4,6500,22034,3966,26000,July
93,ALWAYS V.P EXTRA LONG,PIECE,4,6500,22034,3966,26000,July
98,AMARA ALOEVERA 400ML,PIECE,1,8500,7203,1297,8500,July
103,AMARA COCOA BUTTER 200ML,PIECE,4,6000,20339,3661,24000,July
107,AMARA COCONUT 400ML,PIECE,4,8500,28814,5186,34000,July
108,AMARA FOR MEN 400ML,PIECE,1,10000,8475,1525,10000,July
112,AMARA MEN 200ML,PIECE,3,6000,15254,2746,18000,July
113,AMARA MEN 400ML,PIECE,3,9000,22881,4119,27000,July
114,AMARA MEN COOLING,PIECE,1,6500,5508,992,6500,July
115,AMARA RAW SHEA 200ML,PIECE,2,6000,10169,1831,12000,July
116,AMARA RAW SHEA LOTION 400ML,PIECE,1,8500,7203,1297,8500,July
118,AMARA REJUVENATING ALOE 200ML,PIECE,2,6000,10169,1831,12000,July
119,AMARA UNSCENTED 100G,PIECE,1,3500,2966,534,3500,July
123,AMERICAN GARDEN BBQ SAUCE 510G,PIECE,1,17000,14407,2593,17000,July
125,AMERICAN GARDEN KETCHUP 340G,PIECE,2,8000,13559,2441,16000,July
126,AMERICAN GARDEN KETCHUP 340G,PIECE,3,8000,20339,3661,24000,July
129,AMERICAN GARDEN KETCHUP 680G,PIECE,1,19000,16102,2898,19000,July
131,AMERICAN GARDEN MUSTARD 14OZ,PIECE,1,15000,12712,2288,15000,July
136,AMERICAN GREEN GARDEN HONEY 200G,PIECE,2,8500,14407,2593,17000,July
146,AMLA HAIR OIL 100ML,PIECE,2,7000,11864,2136,14000,July
179,APPLE CIDER VINEGAR 473MLS,PIECE,1,11000,9322,1678,11000,July
182,APPLES GREEN,PIECE,206,1500,261864,47136,309000,July
183,APPLES RED,PIECE,650,1500,826271,148729,975000,July
186,APTAMIL 1 400G,PIECE,1,52000,44068,7932,52000,July
208,ARIEL COLOR 1KG,PIECE,1,14500,12288,2212,14500,July
209,Ariel color and style,PIECE,2,7500,12712,2288,15000,July
211,ARIEL DOWNY 1KG,PIECE,1,14500,12288,2212,14500,July
212,ARIEL DOWNY 500G,PIECE,1,7000,5932,1068,7000,July
213,ARIEL DOWNY LAVENDER500G,PIECE,2,7500,12712,2288,15000,July
216,ARIEL ORIGINAL 500G,PIECE,3,7667,19492,3508,23000,July
224,ARMAF ENCHANTED BEAUTY A.F,PIECE,2,8000,13559,2441,16000,July
228,ARMAF HIGH STREET WOMEN,PIECE,1,14000,11864,2136,14000,July
248,AROMA BEEF SAUSAGES 500G,PIECE,3,8500,21610,3890,25500,July
253,AROMAT 200G,PIECE,1,12000,10169,1831,12000,July
254,AROMAT 75G,PIECE,10,5500,46610,8390,55000,July
270,ART BOOK BIG,PIECE,2,4000,6780,1220,8000,July
271,ART BOOK SMALL,PIECE,7,2000,11864,2136,14000,July
273,ART PENCILS 2B,PIECE,2,1000,1695,305,2000,July
276,ART PENCILS 5B,PIECE,5,1000,4237,763,5000,July
277,ART PENCILS 6B,PIECE,3,1000,2542,458,3000,July
279,ASANTEE PAPAYA SOAP,PIECE,2,6500,11017,1983,13000,July
311,AUNT PORRIDGE 1KG,PIECE,6,14000,71186,12814,84000,July
313,AUNT PORRIDGE 6MONTHS,PIECE,8,14000,94915,17085,112000,July
334,AXE MUSK,PIECE,1,13000,11017,1983,13000,July
339,AXESS AQUA,PIECE,7,9000,53390,9610,63000,July
344,AZAM BAKING FLOUR 2KG,PIECE,5,8500,36017,6483,42500,July
346,AZAM EMBE MANGO,PIECE,26,1500,33051,5949,39000,July
347,AZAM ENERGY DRINK 300MLS,PIECE,38,1500,48305,8695,57000,July
348,AZAM MALT 300MLS,PIECE,25,1500,31780,5720,37500,July
349,AZAM MALT 500MLS,PIECE,7,3000,17797,3203,21000,July
350,B.D BALOON CHART,PIECE,1,3000,2542,458,3000,July
353,B.D CANDLE NUMBERS,PIECE,19,1500,24153,4347,28500,July
354,B.D CANDLES 1500,PIECE,2,1500,2542,458,3000,July
357,B.D CROWNS 2500,PIECE,2,2500,4237,763,5000,July
414,BABY CUPS 3500,PIECE,1,3500,2966,534,3500,July
417,BABY CUPS 6000,PIECE,1,6000,5085,915,6000,July
440,BABY JUNIOR 50G,PIECE,2,1500,2542,458,3000,July
441,BABY JUNIOR BABY OIL 90ML,PIECE,1,3500,2966,534,3500,July
443,BABY JUNIOR JELLY 24ML,PIECE,1,700,593,107,700,July
444,BABY JUNIOR JELLY 500G,PIECE,1,11000,9322,1678,11000,July
455,BABY NIPPLES BIG 1000,PIECE,8,1000,6780,1220,8000,July
486,BABY TENDER WIPES,PIECE,3,6000,15254,2746,18000,July
497,BABY& ME BABYJELLY 240ML,PIECE,2,5000,8475,1525,10000,July
498,BABY&ME BABY CREAM,PIECE,1,4000,3390,610,4000,July
501,BABY&ME JELLY 120ML,PIECE,4,3000,10169,1831,12000,July
523,BALLET ACTIVE VITAMIN 120MLS,PIECE,4,5500,18644,3356,22000,July
524,BALLET ACTIVE VITAMIN 300MLS,PIECE,3,10000,25424,4576,30000,July
525,BALLET ALMOMD OIL 125ML,PIECE,4,10000,33898,6102,40000,July
526,BALLET ALOE VERA 120MLS,PIECE,2,5250,8898,1602,10500,July
527,BALLET ALOE VERA JELLY 300MLS,PIECE,2,10000,16949,3051,20000,July
528,BALLET BABY JELLY 120MLS,PIECE,2,5500,9322,1678,11000,July
529,BALLET BABY JELLY 300MLS,PIECE,3,10000,25424,4576,30000,July
533,BALLET BABY MILK SOAP,PIECE,2,4000,6780,1220,8000,July
536,BALLET BABY SOAP CALENDULA,PIECE,1,4000,3390,610,4000,July
540,BALLET HONEY SOAP,PIECE,3,4000,10169,1831,12000,July
541,BALLET POWDER 100G,PIECE,2,5000,8475,1525,10000,July
542,BALLET REGULAR,PIECE,3,3500,8898,1602,10500,July
543,BALLET SHEA BUTTER SOAP,PIECE,1,4000,3390,610,4000,July
563,BALOON 300,PIECE,119,300,30254,5446,35700,July
566,BALOONS FULL PACKET,PIECE,1,15000,12712,2288,15000,July
570,BAMBOO TOOTHPICK 2500,PIECE,4,2500,8475,1525,10000,July
571,BAMBOO TOOTHPICKS,PIECE,1,2500,2119,381,2500,July
577,BANNERS 7000,PIECE,3,7000,17797,3203,21000,July
588,BASKETS 2500,PIECE,1,2500,2119,381,2500,July
589,BASKETS 3000,PIECE,1,3000,2542,458,3000,July
610,BEAUTY DOLL 12000,PIECE,1,12000,10169,1831,12000,July
612,BECCA COUNTER BOOKS 6500,PIECE,1,6500,5508,992,6500,July
614,BECCA COUNTERBOOKS 6000,PIECE,1,5000,4237,763,5000,July
620,BED SHEET 38000,PIECE,1,38000,32203,5797,38000,July
636,BESSA MILLET DRINK 500MLS,PIECE,10,4500,38136,6864,45000,July
637,BESSA MILLET MALT DRINK 330ML,PIECE,7,3000,17797,3203,21000,July
639,BEST RULER 1000,PIECE,5,1000,4237,763,5000,July
647,BIC PENS,PIECE,10,700,5932,1068,7000,July
648,BIC SHEVARS,PIECE,8,1000,6780,1220,8000,July
649,BI-CARBONATE SODA,PIECE,1,1000,847,153,1000,July
654,BIG BOSS FOR MEN 100ML,PIECE,1,3000,2542,458,3000,July
655,BIG DADDY 300 SWEETS,PIECE,7,300,1780,320,2100,July
664,BIRTHDAY CANDLES 3500,PIECE,1,4000,3390,610,4000,July
665,BIRTHDAY CANDLES 4000,PIECE,2,3500,5932,1068,7000,July
671,BIRTHDAY HATS 2500,PIECE,6,2500,12712,2288,15000,July
672,BIRTHDAY HATS 3500,PIECE,13,3500,38559,6941,45500,July
674,BIRTHDAY LETTERS 5000,PIECE,1,5000,4237,763,5000,July
683,BIYINZIKA CHICKENLEGS 1KGS,PIECE,3,19000,48305,8695,57000,July
684,BIYINZIKA DRUMSTICKS 500G,PIECE,4,15000,50847,9153,60000,July
689,BIYINZIKA SUPA 1KG,PIECE,5,20000,84746,15254,100000,July
690,BIYINZIKA THIGHS 500G,PIECE,4,11000,37288,6712,44000,July
691,BIYINZIKA WINGS 500G,PIECE,2,13000,22034,3966,26000,July
703,BLESSED KISUBI TEA 125G,PIECE,2,5000,8475,1525,10000,July
704,BLESSED KISUBI TEA 200G,PIECE,2,6000,10169,1831,12000,July
705,BLESSED KISUBI TEA 350G,PIECE,1,12000,10169,1831,12000,July
713,BLUE BAND 100G,PIECE,23,2500,48729,8771,57500,July
714,BLUE BAND 1KG,PIECE,3,19000,48305,8695,57000,July
716,BLUE BAND 500G,PIECE,10,10000,84746,15254,100000,July
717,BLUE BAND LOW FAT,PIECE,4,6500,22034,3966,26000,July
718,BLUE BAND LOW SPREAD 250G,PIECE,12,4000,40678,7322,48000,July
725,BLUE LAGOON PASSION SPLASH,PIECE,2,17000,28814,5186,34000,July
729,BLUE TOILET BLOCKS DOUBLE,PIECE,11,5000,46610,8390,55000,July
731,BLUEBAND LOW FAT 100G,PIECE,6,2000,10169,1831,12000,July
763,BOTTLE WASHER 10000,PIECE,1,10000,8475,1525,10000,July
770,BOTTLES 16000,PIECE,1,16000,13559,2441,16000,July
781,BOUNTY CHOCOLATE,PIECE,33,3939,110169,19831,130000,July
816,BRITANIA BONJOUR CASHEWNUT JAR,PIECE,1,20000,16949,3051,20000,July
817,BRITANIA BUTTER 1KG,PIECE,2,20000,33898,6102,40000,July
818,BRITANIA COCO BITE BISCUIT,PIECE,4,20000,67797,12203,80000,July
820,BRITANIA DIGESTIVE 1KG,PIECE,2,20000,33898,6102,40000,July
824,BRITANIA MILK BISCUIT,PIECE,81,500,34322,6178,40500,July
826,BRITANIA MUNCHIES BISCUITS,PIECE,20,500,8475,1525,10000,July
828,BRITANIA NICE BISCUITS 1KG,PIECE,1,20000,16949,3051,20000,July
833,BRITANIA SHORTCAKE BISCUITS 1KG,PIECE,1,20000,16949,3051,20000,July
836,BROOKSIDE FRUIT STRAWBERRIES,PIECE,20,5500,93220,16780,110000,July
838,BROOKSIDE FRUIT VANILLA 250G,PIECE,2,3000,5085,915,6000,July
842,BROOKSIDE LEMON 250G,PIECE,20,3000,50847,9153,60000,July
843,BROOKSIDE LEMON BISCUITS 450G,PIECE,19,5526,88983,16017,105000,July
844,BROOKSIDE MILK 500ML,PIECE,23,2300,44831,8069,52900,July
845,BROOKSIDE PEAR CARAMEL,PIECE,6,5000,25424,4576,30000,July
846,BROOKSIDE PEAR CARAMEL 250G,PIECE,17,3000,43220,7780,51000,July
849,BROOKSIDE STRAWBERRIES 250G,PIECE,15,3000,38136,6864,45000,July
862,BUCKET 11000,PIECE,2,11000,18644,3356,22000,July
889,BUL STAR SOAP 600G,PIECE,1,4000,3390,610,4000,July
890,BUSHENYI HONEY 250G,PIECE,5,6000,25424,4576,30000,July
891,BUSHENYI HONEY 5OOG,PIECE,10,9000,76271,13729,90000,July
892,BUSHENYI HONEY 90G,PIECE,4,3500,11864,2136,14000,July
901,C.B CHOCOLATE CHOCO CHIP 120ML,PIECE,3,2500,6356,1144,7500,July
913,C.B RIPPLES CHOCOLATE 200ML,PIECE,5,4000,16949,3051,20000,July
914,C.B RIPPLES MIXED 200MLS,PIECE,5,4000,16949,3051,20000,July
916,C.B RIPPLES STRAWBERRY 200ML,PIECE,3,4000,10169,1831,12000,July
917,C.B ROYAL MANGO 120ML,PIECE,4,2500,8475,1525,10000,July
939,CADBURY DAIRY MILK MINT CRISP 80G,PIECE,2,8000,13559,2441,16000,July
941,CADBURY DAIRYMILK 10G CHOCOLATE,PIECE,35,1500,44492,8008,52500,July
943,CADBURY DREAM WHITE CREAMY 80G,PIECE,18,8000,122034,21966,144000,July
944,CADBURY DRINKING CHOCOLATE 125G,PIECE,5,8500,36017,6483,42500,July
946,CADBURY FRUIT & NUT 80G,PIECE,11,8000,74576,13424,88000,July
949,CADBURY RUM&RAISIN 80G,PIECE,10,8000,67797,12203,80000,July
951,CADBURY TOPDECK MINT,PIECE,5,8000,33898,6102,40000,July
965,CAKE TOPPER 5000,PIECE,2,5000,8475,1525,10000,July
966,CAKE WRAPPER 1000,PIECE,3,1000,2542,458,3000,July
988,CAMLIN ERASERS,PIECE,1,2500,2119,381,2500,July
997,CANDLES 500,PIECE,24,500,10169,1831,12000,July
1009,CAR TOYS 8000,PIECE,1,8000,6780,1220,8000,July
1011,CAR TOYS 3000,PIECE,2,3000,5085,915,6000,July
1014,CAR TOYS 5000,PIECE,2,5000,8475,1525,10000,July
1023,CAROLIGHT CREME 120ML;,PIECE,1,6500,5508,992,6500,July
1029,CARROT CAKE,PIECE,13,5000,55085,9915,65000,July
1037,CASHO CALC,PIECE,1,15000,12712,2288,15000,July
1046,CB CLASSIC VANILLA 120MLS,PIECE,2,2500,4237,763,5000,July
1047,CB CLASSIC VANILLA 200MLS,PIECE,2,4000,6780,1220,8000,July
1054,CB MAGIC STRAW 500ML,PIECE,2,10000,16949,3051,20000,July
1055,CB STRAWBERRY VANILLA,PIECE,2,20000,33898,6102,40000,July
1060,CELOTAPE BLACK,PIECE,2,1500,2542,458,3000,July
1093,CHAMPION A4 200PAGES,PIECE,6,4000,20339,3661,24000,July
1094,CHAMPION A4 96 PAGES,PIECE,13,2000,22034,3966,26000,July
1095,CHAPA BAKING POWDER,PIECE,4,1500,5085,915,6000,July
1096,CHAPA NYOTA BLUE 600G,PIECE,2,4000,6780,1220,8000,July
1097,CHAPA NYOTA BROWN 600G,PIECE,1,4000,3390,610,4000,July
1110,CHELSEA CROWN PERFUME,PIECE,2,10000,16949,3051,20000,July
1111,CHERRY COTTON BUDS,PIECE,2,1000,1695,305,2000,July
1112,CHERRY COTTON BUDS 150,PIECE,3,3000,7627,1373,9000,July
1122,CHICKSTAX SILVER FISH POWDER,PIECE,1,7000,5932,1068,7000,July
1131,CHINA GREEN TEA 50G,PIECE,6,6000,30508,5492,36000,July
1134,CHOCOLATE 500,PIECE,9,500,3814,686,4500,July
1163,CLAIRMEN CREAM 120ML,PIECE,1,7000,5932,1068,7000,July
1166,PICFARE GOLD 96PGS,PIECE,2,1000,1695,305,2000,July
1172,CLASSIC SHORTHAND NOTEBOOK,PIECE,2,2000,3390,610,4000,July
1176,CLEAR BAG 1000,PIECE,4,1000,3390,610,4000,July
1182,CLEOS HOT SAUCE 125G,PIECE,1,3500,2966,534,3500,July
1185,CLERE ALOEVERA 250G,PIECE,1,6000,5085,915,6000,July
1186,CLERE BABY JELLY 100G,PIECE,2,3500,5932,1068,7000,July
1187,CLERE BABY JELLY 250G,PIECE,1,5000,4237,763,5000,July
1189,CLERE FOR MEN ICE 250G,PIECE,1,6000,5085,915,6000,July
1195,CLIMAX BERRIES 170G,PIECE,1,6000,5085,915,6000,July
1196,CLIMAX BERRIES 50G,PIECE,2,2500,4237,763,5000,July
1199,CLIMAX EXOTIC TROPICAL FRUITS 170G,PIECE,1,6000,5085,915,6000,July
1201,CLIMAX FOREST FRUITS 50G,PIECE,3,2500,6356,1144,7500,July
1202,CLIMAX TROPICAL FRUITS 50G,PIECE,2,2500,4237,763,5000,July
1209,CLOCKS SONAM 30000,PIECE,1,30000,25424,4576,30000,July
1212,CLOSEUP TRIPLEFRESH 60G,PIECE,5,3000,12712,2288,15000,July
1213,CLOSEUP TRIPPLE FRESH 125G,PIECE,2,5000,8475,1525,10000,July
1219,COBWEB 7000,PIECE,1,7000,5932,1068,7000,July
1221,COCACOLA 2LTRS,PIECE,81,5000,343220,61780,405000,July
1222,COCACOLA 350MLS,PIECE,109,1000,92373,16627,109000,July
1223,COCACOLA 500MLS,PIECE,74,1500,94068,16932,111000,July
1224,COCACOLA CAN 330ML,PIECE,16,3000,40678,7322,48000,July
1227,COCACOLA ZERO 350ML,PIECE,11,1000,9322,1678,11000,July
1235,COCONUT PRADIP,PIECE,2,4750,8051,1449,9500,July
1238,COCOPULP 300ML CREME,PIECE,2,13000,22034,3966,26000,July
1239,COCOPULP CREME 100ML,PIECE,1,8000,6780,1220,8000,July
1241,COCOS COCONUT BAR,PIECE,19,1000,16102,2898,19000,July
1244,COLGATE 0-2YEARS,PIECE,10,4000,33898,6102,40000,July
1245,COLGATE CHARCOAL GENTLE CLEAN,PIECE,19,7500,120763,21737,142500,July
1246,COLGATE CHARCOAL TWIN TOOTHBRUSH,PIECE,22,4000,74576,13424,88000,July
1247,COLGATE CHILDREN 50MLS,PIECE,11,4500,41949,7551,49500,July
1248,COLGATE DEEP CLEAN,PIECE,2,1500,2542,458,3000,July
1249,COLGATE DOUBLE ACTION,PIECE,15,4000,50847,9153,60000,July
1252,COLGATE HERBAL 140G,PIECE,21,7500,133475,24025,157500,July
1253,COLGATE HERBAL 230G,PIECE,7,10000,59322,10678,70000,July
1254,COLGATE HERBAL 35G,PIECE,11,2500,23305,4195,27500,July
1255,COLGATE HERBAL 70G,PIECE,17,4500,64831,11669,76500,July
1256,COLGATE KIDS 2-5YEARS,PIECE,4,5000,16949,3051,20000,July
1257,COLGATE MAX FRESH 65G,PIECE,3,3500,8898,1602,10500,July
1259,COLGATE MAX-FRESH 130G,PIECE,6,6500,33051,5949,39000,July
1261,COLGATE MAXIMUM CAVITY 140G,PIECE,4,7500,25424,4576,30000,July
1262,COLGATE MAXIMUM CAVITY 35G,PIECE,5,2500,10593,1907,12500,July
1263,COLGATE MAXIMUM CAVITY 70G,PIECE,4,4500,15254,2746,18000,July
1264,COLGATE NATURAL EXTRACT 75MLS,PIECE,3,9000,22881,4119,27000,July
1265,COLGATE TOOTBRUSH,PIECE,16,2500,33898,6102,40000,July
1266,COLGATE TOOTHBRUSH 1500,PIECE,5,1500,6356,1144,7500,July
1267,COLGATE TOOTHBRUSH CHARCOAL,PIECE,18,2500,38136,6864,45000,July
1269,COLGATE TRIPLE ACTION 140G,PIECE,4,6500,22034,3966,26000,July
1270,COLGATE TRIPPLE ACTION 70G,PIECE,9,4000,30508,5492,36000,July
1277,COMB 1500,PIECE,1,1500,1271,229,1500,July
1278,COMB 500,PIECE,1,500,424,76,500,July
1286,COMFORT T.P 1000,PIECE,143,1000,121186,21814,143000,July
1289,COMPACT T.P,PIECE,129,1000,109322,19678,129000,July
1290,COMPO PENS,PIECE,4,3000,10169,1831,12000,July
1291,COMSOFT FACIAL WIPES 1000,PIECE,12,1500,15254,2746,18000,July
1305,CONTAINERS 2500,PIECE,1,2500,2119,381,2500,July
1329,COTTO SWABS EAR BUDS,PIECE,2,1500,2542,458,3000,July
1330,COTTON BUDS WOODEN,PIECE,2,3000,5085,915,6000,July
1334,COVERTINA CHOCOLATE 500,PIECE,24,500,10169,1831,12000,July
1343,COW & GATE 1 400GM,PIECE,7,44000,261017,46983,308000,July
1344,COW & GATE 2,PIECE,1,44000,37288,6712,44000,July
1349,COWBOY 500G,PIECE,2,7500,12712,2288,15000,July
1357,CREAMBELL STRAWBERRY VAN 500ML,PIECE,1,10000,8475,1525,10000,July
1359,CREAMY EFFECT WIPES,PIECE,6,6000,30508,5492,36000,July
1373,CUPS 1000,PIECE,5,1000,4237,763,5000,July
1389,CUSSON SOAP MILD&GENTLE,PIECE,5,3500,14831,2669,17500,July
1391,CUSSONS BABY OIL 100MLS,PIECE,4,9000,30508,5492,36000,July
1393,CUSSONS BABY OIL PINK 200MLS,PIECE,1,16000,13559,2441,16000,July
1394,CUSSONS BABY PERFUMED JELLY 200ML,PIECE,2,12000,20339,3661,24000,July
1397,CUSSONS BABY UNPERFUMED JELLY 200ML,PIECE,1,12000,10169,1831,12000,July
1400,CUSSONS OIL PINK 100MLS,PIECE,3,9000,22881,4119,27000,July
1401,CUSSONS PERFUMED JELLY A&R 100ML,PIECE,6,5500,27966,5034,33000,July
1406,CUSSONS SOAP SOFT&SMOOTH,PIECE,6,3500,17797,3203,21000,July
1410,CUTE BABY DOLL 15000,PIECE,1,15000,12712,2288,15000,July
1412,CUTTERS 1000,PIECE,2,1000,1695,305,2000,July
1423,D.L FIESTA CLASSIC 100MLS,PIECE,19,3500,56356,10144,66500,July
1424,D.L FIESTA SALTED CARAMEL,PIECE,15,4000,50847,9153,60000,July
1425,D.L MANGO 250ML,PIECE,10,5000,42373,7627,50000,July
1426,D.L MAXIMO BISCOTTI 175ML,PIECE,7,4500,26695,4805,31500,July
1427,D.L MAXIMO CARAMEL NUTS,PIECE,7,4500,26695,4805,31500,July
1428,D.L MAXIMO VAN-CHOCO FLAKES 175ML,PIECE,14,4500,53390,9610,63000,July
1429,D.L MEGA CONE VANILLA,PIECE,5,3500,14831,2669,17500,July
1430,D.L MINI FIESTA CARAMEL,PIECE,25,2740,58051,10449,68500,July
1431,D.L MINI FIESTA CLASSIC 70MLS,PIECE,27,2944,67373,12127,79500,July
1434,D.L PINACOLANDA 500ML,PIECE,9,10000,76271,13729,90000,July
1437,D.L VAN.STRAW 250ML,PIECE,7,5000,29661,5339,35000,July
1440,D.L VAN-CHOC 500ML,PIECE,4,9500,32203,5797,38000,July
1442,D.L VANILLA 250ML,PIECE,4,5000,16949,3051,20000,July
1443,D.L VANILLA 500ML,PIECE,5,9500,40254,7246,47500,July
1444,D.L VANILLA CREAM 120MLS,PIECE,3,2000,5085,915,6000,July
1445,D.L VAN-STRAW 120ML,PIECE,27,2000,45763,8237,54000,July
1447,D.L VAN-STRAW 500ML,PIECE,4,9500,32203,5797,38000,July
1448,DABUR CLOVE VALUE PACK,PIECE,2,11000,18644,3356,22000,July
1450,DABUR HERBAL CLOVE 150G,PIECE,11,6000,55932,10068,66000,July
1453,DABUR NEEM TOOTHPASTE 150G,PIECE,3,6000,15254,2746,18000,July
1457,DAIRIES 12000,PIECE,1,12000,10169,1831,12000,July
1461,DAIRY MILK PLAIN 80G,PIECE,16,8000,108475,19525,128000,July
1462,DAIRY MILK TOP DECK 80G,PIECE,4,8000,27119,4881,32000,July
1464,DAIRY TOP YOGHURT STRAWBERRY 250G,PIECE,145,1000,122881,22119,145000,July
1471,DAITY CAPPUCCINO VANILLA ICE CREAM,PIECE,4,5500,18644,3356,22000,July
1477,DAITY VANILLA ICECREAM,PIECE,4,5500,18644,3356,22000,July
1484,DATES 1000,PIECE,12,1000,10169,1831,12000,July
1485,DATES 2000,PIECE,11,2000,18644,3356,22000,July
1486,DATES 3000,PIECE,7,3500,20763,3737,24500,July
1500,DEAR BODY THURSDAY BODY MIST,PIECE,1,16000,13559,2441,16000,July
1501,DEAR BODY TUESDAY BODY MIST,PIECE,1,16000,13559,2441,16000,July
1510,DELIDENT MAX 70G,PIECE,3,2000,5085,915,6000,July
1511,DELLA CHOCOLATE,PIECE,16,3000,40678,7322,48000,July
1512,DELUXE ALUMINIUM FOIL,PIECE,4,6500,22034,3966,26000,July
1525,DENTAL FLOSS,PIECE,1,3000,2542,458,3000,July
1527,DENTEX TOOTHBRUSH SOFT,PIECE,1,3500,2966,534,3500,July
1538,DESSERT NOTE BOOK 4000,PIECE,2,4500,7627,1373,9000,July
1539,DETTOL 125MLS,PIECE,2,9000,15254,2746,18000,July
1540,DETTOL ACTIVE 175G,PIECE,4,6500,22034,3966,26000,July
1543,DETTOL COOL 175G,PIECE,7,6500,38559,6941,45500,July
1544,DETTOL EVENTONE 175G,PIECE,2,6500,11017,1983,13000,July
1547,DETTOL FRESH 175G,PIECE,2,6500,11017,1983,13000,July
1550,DETTOL HERBAL 105G,PIECE,5,4500,19068,3432,22500,July
1551,DETTOL HERBAL 175G,PIECE,3,6500,16525,2975,19500,July
1552,DETTOL JUNIORS GLYCERINE SOAP 100G,PIECE,6,4500,22881,4119,27000,July
1553,DETTOL LIQUID 250 MLS,PIECE,4,15000,50847,9153,60000,July
1555,DETTOL LIQUID 50MLS,PIECE,8,4000,27119,4881,32000,July
1557,DETTOL ORIGINAL 100G,PIECE,3,4500,11441,2059,13500,July
1558,DETTOL ORIGINAL 175G,PIECE,8,6500,44068,7932,52000,July
1568,DEXE BLACK HAIR SHAMPOO,PIECE,12,2000,20339,3661,24000,July
1594,DISPOSABLE BOWLS 3500,PIECE,1,3500,2966,534,3500,July
1599,DISPOSABLE PLATES 12000,PIECE,1,12000,10169,1831,12000,July
1600,DISPOSABLE PLATES 6000,PIECE,1,6000,5085,915,6000,July
1603,DISPOSABLE SPOON 4000,PIECE,4,4000,13559,2441,16000,July
1605,DISPOSABLES COFFEE GLASSES 16000,PIECE,1,16000,13559,2441,16000,July
1607,DIVINE 300MLS,PIECE,29,2500,61441,11059,72500,July
1608,DIVINE 500MLS,PIECE,21,4000,71186,12814,84000,July
1634,DOLBY SPRAY,PIECE,1,10000,8475,1525,10000,July
1641,DOLL 25000,PIECE,1,25000,21186,3814,25000,July
1651,DOLLAR CHOCOLATE 3.5OZ,PIECE,11,3091,28814,5186,34000,July
1653,DOLLS 2000,PIECE,1,2000,1695,305,2000,July
1661,DOLLS YONG 17000,PIECE,1,17000,14407,2593,17000,July
1666,DOMS COLOUR PENCILS LONG,PIECE,1,7000,5932,1068,7000,July
1667,DOMS COLOUR PENCILS SHORT,PIECE,1,4000,3390,610,4000,July
1670,DOMS PENCILS A1 5000,PIECE,2,5000,8475,1525,10000,July
1678,DOORMATS 18000,PIECE,1,18000,15254,2746,18000,July
1679,DORCO BLADES 200,PIECE,1,300,254,46,300,July
1681,DORCO TITAN RAZORBLADE,PIECE,1,1000,847,153,1000,July
1688,DOUBLE REFINED SALT 650G,PIECE,1,7000,5932,1068,7000,July
1697,DOVE CUCUMBER&GREENTEA SHOWERGEL,PIECE,1,22000,18644,3356,22000,July
1718,DOVE ORIGINAL SOAP 135G,PIECE,1,7500,6356,1144,7500,July
1723,DOVE PINK ROSA SOAP 135G,PIECE,3,7500,19068,3432,22500,July
1731,DOVE ROLL ON MIX,PIECE,2,11000,18644,3356,22000,July
1742,DOVE SOAP CUCUMBER GO FRESH,PIECE,3,7500,19068,3432,22500,July
1743,DOVE SOAP EXFOLIACION SUAVE 135G,PIECE,2,7500,12712,2288,15000,July
1750,DOWNY FEEL LUX 20ML,PIECE,25,700,14831,2669,17500,July
1753,DOWNY VALLEY DEW 20ML,PIECE,31,700,18390,3310,21700,July
1758,DREAM PANT LINERS,PIECE,6,2500,12712,2288,15000,July
1768,DURACELL AA ORIGINAL,PIECE,2,6500,11017,1983,13000,July
1769,DURACELL AA PLUS,PIECE,4,6000,20339,3661,24000,July
1770,DURACELL AAA,PIECE,2,7000,11864,2136,14000,July
1771,DURACELL AAA PLUS,PIECE,1,6000,5085,915,6000,July
1772,DURU CARING MILK,PIECE,1,4500,3814,686,4500,July
1774,DURU DOLCE ALMOND,PIECE,2,4500,7627,1373,9000,July
1775,DURU ENERGIZING HONEY,PIECE,3,4500,11441,2059,13500,July
1776,DURU FLORAL INFUSION,PIECE,1,14000,11864,2136,14000,July
1780,DURU GLYCERINE,PIECE,2,5000,8475,1525,10000,July
1783,DURU MISKET 4PCS,PIECE,1,16000,13559,2441,16000,July
1784,DURU MOUNTAINAIR SOAP,PIECE,2,14000,23729,4271,28000,July
1785,DURU NATURAL CARE,PIECE,5,4500,19068,3432,22500,July
1791,DURU SHOWERGEL JASMIN AMBER,PIECE,1,17000,14407,2593,17000,July
1804,E.A HONEY 1LTR,PIECE,2,29000,49153,8847,58000,July
1814,EARBUDS 2500,PIECE,4,1000,3390,610,4000,July
1818,EAST AFRICAN ORGANIC HONEY 100G,PIECE,6,3500,17797,3203,21000,July
1819,EAST AFRICAN ORGANIC HONEY 250G,PIECE,2,8000,13559,2441,16000,July
1820,EAST AFRICAN ORGANIC HONEY 450G,PIECE,2,12000,20339,3661,24000,July
1823,ECLAIRS,PIECE,6,200,1017,183,1200,July
1825,ECO STYLING GEL 236ML,PIECE,2,13000,22034,3966,26000,July
1837,EDEN APRICOT SCRUB 454G,PIECE,1,22000,18644,3356,22000,July
1855,EGGS PIECES,PIECE,132,500,55932,10068,66000,July
1856,EGGS TRAY,PIECE,12,14000,142373,25627,168000,July
1861,ELEGANCE COCOA BUTTER,PIECE,3,6000,15254,2746,18000,July
1863,ELEGANT AIR FRESHENER,PIECE,7,7000,41525,7475,49000,July
1874,ELEGANT FLORAL LEMON A.F,PIECE,1,7000,5932,1068,7000,July
1890,ELGON BLEND 250G,PIECE,1,16000,13559,2441,16000,July
1891,ELGON BLEND COFFEE 100G,PIECE,2,9000,15254,2746,18000,July
1892,ELGON BLEND SASACOFFEE 500G,PIECE,1,26500,22458,4042,26500,July
1908,ENVELOPE A4,PIECE,4,500,1695,305,2000,July
1910,ENVELOPES 200,PIECE,9,200,1525,275,1800,July
1911,ENVELOPES 300,PIECE,1,300,254,46,300,July
1914,ERASER RUBBER,PIECE,5,500,2119,381,2500,July
1915,ERASER RUBBER BIG,PIECE,3,1000,2542,458,3000,July
1923,EURO SILK 2200 ORIGINAL,PIECE,132,2200,246102,44298,290400,July
1931,EVERVESS,PIECE,23,1000,19492,3508,23000,July
1935,EXOTIC 320MLS,PIECE,20,1000,16949,3051,20000,July
1936,F.D CHOCOLATE MILK 250MLS,PIECE,32,2000,54237,9763,64000,July
1937,F.D FLAVOURED CHOCOLATE,PIECE,13,4000,44068,7932,52000,July
1940,F.D MANGO 250G,PIECE,15,2500,31780,5720,37500,July
1941,F.D MANGO 400G,PIECE,39,2500,82627,14873,97500,July
1942,F.D MANGO 450G,PIECE,16,3700,50169,9031,59200,July
1945,F.D MIXED BERRIES 250G,PIECE,8,2500,16949,3051,20000,July
1946,F.D MIXED BERRIES 400G,PIECE,22,2500,46610,8390,55000,July
1948,F.D PLAIN 250G,PIECE,11,2500,23305,4195,27500,July
1949,F.D PLAIN YOGHURT 400G,PIECE,15,2500,31780,5720,37500,July
1950,F.D PLAIN YOGHURT 450G,PIECE,12,3700,37627,6773,44400,July
1952,F.D STRAWBERRY 100G,PIECE,143,1200,145424,26176,171600,July
1954,F.D STRAWBERRY 200G,PIECE,3,1200,3051,549,3600,July
1955,F.D STRAWBERRY 250G,PIECE,63,2500,133475,24025,157500,July
1956,F.D STRAWBERRY 400G,PIECE,133,2500,281780,50720,332500,July
1957,F.D STRAWBERRY 450G,PIECE,90,3700,282203,50797,333000,July
1958,F.D STRAWBERRY FLAVOURED 250ML,PIECE,53,2000,89831,16169,106000,July
1959,F.D STRAWBERRY MILK 500MLS,PIECE,9,4000,30508,5492,36000,July
1960,F.D UHT 200ML MILK,PIECE,44,1000,37288,6712,44000,July
1961,F.D UHT MILK 2000,PIECE,26,2000,44068,7932,52000,July
1962,F.D UNSALTED BUTTER 250G,PIECE,2,11000,18644,3356,22000,July
1963,F.D VANILLA 100G,PIECE,125,1200,127119,22881,150000,July
1966,F.D VANILLA 250G,PIECE,47,2500,99576,17924,117500,July
1967,F.D VANILLA 400G,PIECE,109,2500,230932,41568,272500,July
1968,F.D VANILLA 450G,PIECE,60,3700,188136,33864,222000,July
1969,F.D VANILLA FLAVOURED 250ML,PIECE,54,2000,91525,16475,108000,July
1970,F.D VANILLA MILK 500MLS,PIECE,11,4000,37288,6712,44000,July
1971,F.D YOGHURT MIXED BERRIES 450G,PIECE,21,3700,65847,11853,77700,July
1973,FA AQUA 50MLS,PIECE,3,6500,16525,2975,19500,July
1974,FA CARRIEAN LEMON,PIECE,2,6500,11017,1983,13000,July
1978,FA FLORAL PROTECT 50MLS,PIECE,2,6500,11017,1983,13000,July
1983,FA MEN ATTRACTION FORCE,PIECE,3,6500,16525,2975,19500,July
1987,FA MYSTIC MOMENTS,PIECE,1,6500,5508,992,6500,July
1989,FA PINK PASSION ROLLON,PIECE,1,6500,5508,992,6500,July
1993,FA SPORT ROLLON 50 ML,PIECE,4,6500,22034,3966,26000,July
1999,FACE TOWEL 1000,PIECE,3,1000,2542,458,3000,July
2000,FACE TOWEL 1500,PIECE,1,1500,1271,229,1500,July
2002,FACE TOWEL 3000 WHITE,PIECE,4,3000,10169,1831,12000,July
2005,FACIALES PURE & ROSE,PIECE,1,3000,2542,458,3000,July
2006,FAMEN FRESHLY FREE,PIECE,1,6500,5508,992,6500,July
2011,FAMILY CARE 200G,PIECE,1,4500,3814,686,4500,July
2023,FAMILY TEA 250G,PIECE,1,8000,6780,1220,8000,July
2026,FANAKA GUAVA 500ML,PIECE,15,3500,44492,8008,52500,July
2029,FANTA 2LTRS ORANGE,PIECE,61,5000,258475,46525,305000,July
2030,FANTA 330ML CAN,PIECE,11,3000,27966,5034,33000,July
2031,FANTA 330MLS,PIECE,128,1000,108475,19525,128000,July
2032,FANTA 500MLS,PIECE,38,1500,48305,8695,57000,July
2033,FANTA FRUIT BLAST 350ML,PIECE,68,1000,57627,10373,68000,July
2034,FANTA NO SUGAR 350ML,PIECE,1,1000,847,153,1000,July
2042,FAX FRUIT COCKTAIL,PIECE,1,8500,7203,1297,8500,July
2060,FAY TP,PIECE,2,2000,3390,610,4000,July
2061,FEATHERS PADS REGULAR,PIECE,3,3000,7627,1373,9000,July
2072,FIDODIDO CHOCO-VAN 220ML,PIECE,1,2500,2119,381,2500,July
2090,FIDODIDO VANILLA 120MLS,PIECE,1,1200,1017,183,1200,July
2111,FLOWER C9 SHOWER GEL,PIECE,1,23000,19492,3508,23000,July
2113,FLOWERS 2000,PIECE,2,2000,3390,610,4000,July
2114,FLYMEEGO VESTS 25000,PIECE,2,25000,42373,7627,50000,July
2117,FOGG ABSOLUTE BODY SPRAY,PIECE,2,18000,30508,5492,36000,July
2128,FOGG MARCO SPRAY,PIECE,1,18000,15254,2746,18000,July
2129,FOGG MASTER AGAR,PIECE,1,18500,15678,2822,18500,July
2133,FOGG MONARCH,PIECE,1,18000,15254,2746,18000,July
2138,FOGG STATUS ROLLON,PIECE,2,8000,13559,2441,16000,July
2140,FOGG ULTIMATE ROLLON,PIECE,1,8500,7203,1297,8500,July
2152,FOOD COLOUR EGG YELLOW,PIECE,1,1000,847,153,1000,July
2154,FOOD COLOUR ORANGE,PIECE,1,1000,847,153,1000,July
2155,FOOD COLOUR PINK,PIECE,1,1000,847,153,1000,July
2157,FOOD COLOUR RED,PIECE,1,1000,847,153,1000,July
2174,FORTUNE BUTTO 1LTR,PIECE,9,8500,64831,11669,76500,July
2175,FORTUNE BUTTO 500ML,PIECE,14,4500,53390,9610,63000,July
2176,FORTUNE GOLD 1LTR,PIECE,2,10000,16949,3051,20000,July
2177,FORTUNE GOLD 3LTR,PIECE,2,28000,47458,8542,56000,July
2178,FORTUNE GOLD 500ML,PIECE,1,5000,4237,763,5000,July
2180,FORTUNE SPAGHETTI 250G,PIECE,4,2125,7203,1297,8500,July
2181,FORTUNE SPAGHETTI 450,PIECE,5,3500,14831,2669,17500,July
2184,FOUNTAIN PENS 2000,PIECE,1,2000,1695,305,2000,July
2185,FOX CHOCOLATE,PIECE,1,1000,847,153,1000,July
2202,FRESH DAIRY FLAVOURED BOX,BOX,1,24000,20339,3661,24000,July
2203,FRESH DAIRY MILK UHT 500ML,PIECE,52,2000,88136,15864,104000,July
2205,FRESH DIARY LONG LIFE BOX,BOX,1,23000,19492,3508,23000,July
2209,FRESH UP TOOTHPASTE,PIECE,1,2000,1695,305,2000,July
2233,FRUITVILLE APPLE DRINK,PIECE,8,3500,23729,4271,28000,July
2234,FRUITVILLE GUAVA 500ML,PIECE,30,3500,88983,16017,105000,July
2235,FRUITVILLE MANGO 500ML,PIECE,21,3500,62288,11212,73500,July
2284,GARDEN TEA BAGS 100G,PIECE,4,6500,22034,3966,26000,July
2286,GEISHA ALOE VERA&HONEY,PIECE,20,4000,67797,12203,80000,July
2288,GEISHA ALOEVERA &HONEY 125G,PIECE,9,2500,19068,3432,22500,July
2289,GEISHA COCONUT MILK 200G,PIECE,8,4000,27119,4881,32000,July
2290,GEISHA COCONUTMILK 125G,PIECE,9,2500,19068,3432,22500,July
2291,GEISHA LEMON&HONEY,PIECE,16,4000,54237,9763,64000,July
2292,GEISHA LEMON&HONEY 125G,PIECE,5,2500,10593,1907,12500,July
2294,GEISHA MORINGA OIL 125G,PIECE,1,4000,3390,610,4000,July
2295,GEISHA MORINGA OIL 225G,PIECE,7,5500,32627,5873,38500,July
2296,GEISHA ROSE&HONEY,PIECE,5,2500,10593,1907,12500,July
2298,GEISHA ROSE&HONEY 225G,PIECE,6,4000,20339,3661,24000,July
2299,GEISHA SHEA AND ALMOND BUTTER SOAP 225G,PIECE,4,5500,18644,3356,22000,July
2302,GEISHA TRADITIONAL BLACK SOAP,PIECE,13,5500,60593,10907,71500,July
2303,GEISHA TRADITIONAL BLACK SOAP 125G,PIECE,9,4000,30508,5492,36000,July
2310,GIFT BAG 1500,PIECE,3,1500,3814,686,4500,July
2311,GIFT BAG 2500,PIECE,4,2500,8475,1525,10000,July
2315,GIFT BAG 4500,PIECE,5,4500,19068,3432,22500,July
2317,GIFT BAG FLORAL LARGE,PIECE,1,6000,5085,915,6000,July
2342,GILLETTE BLUE2 PLUS,PIECE,26,2500,55085,9915,65000,July
2358,GLASSES 3000 PCS,PIECE,5,3500,14831,2669,17500,July
2413,GOOD DAY CASHEW COOKIES,PIECE,2,2600,4407,793,5200,July
2414,GOOD DAY CHOCO CHIP,PIECE,15,5000,63559,11441,75000,July
2422,GOODIE GINGER BISCUIT 75G,PIECE,16,1000,13559,2441,16000,July
2427,GORILLO'S BBQ BEEF 24G,PIECE,177,500,75000,13500,88500,July
2429,GORILLO'S CHICKEN 24G,PIECE,315,500,133475,24025,157500,July
2431,GORILLO'S CHILLI TOMATO 24G,PIECE,92,500,38983,7017,46000,July
2450,GRAPES 12000,PIECE,9,14000,106780,19220,126000,July
2454,GREEN POLYTHENE,PIECE,1,300,254,46,300,July
2455,GREEN RIVER POWDER 5G,PIECE,1,1000,847,153,1000,July
2476,HABARI SALT BIG,PIECE,18,1000,15254,2746,18000,July
2477,HABARI SALT SMALL,PIECE,2,700,1186,214,1400,July
2479,HACO RULER,PIECE,2,2000,3390,610,4000,July
2480,HACO RULER ORIGINAL,PIECE,5,2000,8475,1525,10000,July
2489,HAND SCRUBBING BRUSH 2000,PIECE,1,2000,1695,305,2000,July
2492,HANGER NO:8834,PIECE,1,15000,12712,2288,15000,July
2498,HANKIES 3000,PIECE,1,3000,2542,458,3000,July
2513,HARMONY POT WATER,PIECE,99,1000,83898,15102,99000,July
2514,HARMONY POT WATER 1LTR,PIECE,89,2000,150847,27153,178000,July
2517,HARPIC MOUNTAIN PINE,PIECE,4,15000,50847,9153,60000,July
2518,HARPIC ORIGINAL PLUS,PIECE,2,15000,25424,4576,30000,July
2520,HARPIC POWER PLUS 500ML,PIECE,1,15000,12712,2288,15000,July
2530,HEINZ KETCHUP 300G,PIECE,6,8000,40678,7322,48000,July
2538,HERMELA GUEST SOAP,PIECE,7,3500,20763,3737,24500,July
2539,HERO FOUNTAIN PEN 2000,PIECE,1,2000,1695,305,2000,July
2554,HIMALAYAN SALT 350G,PIECE,1,15000,12712,2288,15000,July
2558,HIT INSECT KILLER GREEN TEA 400ML,PIECE,1,17000,14407,2593,17000,July
2561,HIT INSECT KILLER LEMON 400ML,PIECE,1,17000,14407,2593,17000,July
2562,HIT INSECT KILLER ORANGE 400ML,PIECE,1,17000,14407,2593,17000,July
2595,HOT FRESH 20ML,PIECE,6,2500,12712,2288,15000,July
2596,HOT FRESH HOT PEPPER 60ML,PIECE,1,6000,5085,915,6000,July
2604,HP FACIAL WIPES 3000,PIECE,3,3000,7627,1373,9000,July
2618,HUGGIES PANTS H.C S5,PIECE,1,58000,49153,8847,58000,July
2636,IBON ELVAN SWEETS,PIECE,7,157,932,168,1100,July
2651,IMPERIAL LEATHER 4*175,PIECE,6,13000,66102,11898,78000,July
2657,IMPERIAL LEATHER MEN 175G,PIECE,5,4500,19068,3432,22500,July
2658,IMPERIAL LEATHER MEN COOL 400L LOTION,PIECE,1,13000,11017,1983,13000,July
2663,IMPERIAL LEATHER SOAP RED 175G,PIECE,12,4000,40678,7322,48000,July
2673,INDO CAFE 50G,PIECE,1,10000,8475,1525,10000,July
2674,INDOCAFE 100G,PIECE,2,18000,30508,5492,36000,July
2676,INDOCAFE CAPPUCCINO CREAMY,PIECE,11,3000,27966,5034,33000,July
2681,INDOMIE BEEF 70G,PIECE,81,1200,82373,14827,97200,July
2682,INDOMIE BEEF NOODLES 120G,PIECE,13,2000,22034,3966,26000,July
2683,INDOMIE NOODLES 70G,PIECE,88,1200,89492,16108,105600,July
2684,INDOMIE NOODLES CHICKEN 120G,PIECE,39,2000,66102,11898,78000,July
2706,JAGO 100MLS,PIECE,4,3875,13136,2364,15500,July
2708,JAGO AFTERSHAVE 1LTR,PIECE,1,17000,14407,2593,17000,July
2710,JAGO AFTERSHAVE 300MLS,PIECE,1,7500,6356,1144,7500,July
2714,JAGO SCRUB 250G,PIECE,2,7500,12712,2288,15000,July
2715,JAGO SCRUB 500G,PIECE,4,13000,44068,7932,52000,July
2716,JAMAA WHITE WASHING BAR,PIECE,20,6000,101695,18305,120000,July
2718,JAMIES BROWN BUNS 6PCS,PIECE,143,3500,424153,76347,500500,July
2719,JAMIES BROWN SALT BREAD 1KG,PIECE,9,5500,41949,7551,49500,July
2720,JAMIES BROWN SALT BREAD 500G,PIECE,32,3000,81356,14644,96000,July
2721,JAMIES CAKE @70k,PIECE,4,72500,245763,44237,290000,July
2724,JAMIES CAKES @ 40K,PIECE,2,40000,67797,12203,80000,July
2725,JAMIES CAKES @50k,PIECE,13,50000,550847,99153,650000,July
2726,JAMIES CAKES @60K,PIECE,12,55667,566102,101898,668000,July
2727,JAMIES COCONUT BREAD 1KG,PIECE,35,5500,163136,29364,192500,July
2728,JAMIES COCONUT BREAD 500G,PIECE,18,3000,45763,8237,54000,July
2729,JAMIE'S COOKIE SCONES,PIECE,26,2423,53390,9610,63000,July
2730,JAMIES CROCKDILE BREAD 1KG,PIECE,3,6000,15254,2746,18000,July
2734,JAMIES DOUGH NUTS HUGE,PIECE,161,2000,272881,49119,322000,July
2735,JAMIES DOUGH NUTS SMALL 4000,PIECE,648,3000,1647458,296542,1944000,July
2736,JAMIES COOKIES 4000,PIECE,96,4000,325424,58576,384000,July
2739,JAMIES HOT DOG BUNS 6PCS,PIECE,70,4000,237288,42712,280000,July
2740,JAMIES MANDAZ 8PCS,PIECE,139,3000,353390,63610,417000,July
2744,JAMIES MUFFINS,PIECE,428,1500,544068,97932,642000,July
2748,JAMIES QUEEN CAKES 6PCS 3000,PIECE,117,3500,347034,62466,409500,July
2751,JAMIES SWEET BROWN BREAD1KG,PIECE,242,5500,1127966,203034,1331000,July
2752,JAMIES SWEET BROWN BREAD 500G,PIECE,116,3000,294915,53085,348000,July
2754,JAMIES SWEET CAKE BREAD 1KG,PIECE,158,5532,740678,133322,874000,July
2755,JAMIES SWEET CAKE BREAD 500G,PIECE,44,3000,111864,20136,132000,July
2756,JAMIES SWEET WHITE BREAD 1KG,PIECE,478,5500,2227966,401034,2629000,July
2757,JAMIES SWEET WHITE BREAD 500,PIECE,175,3000,444915,80085,525000,July
2758,JAMIES SWEET WHITE BUNS 12PCS,PIECE,144,3500,427119,76881,504000,July
2759,JAMIES SWEET WHITE BUNS 6PCS,PIECE,144,3500,427119,76881,504000,July
2760,JAMIES SWEET YELLOW BREAD 1KG,PIECE,365,5500,1701271,306229,2007500,July
2761,JAMIES SWEET YELLOW BREAD 500G,PIECE,144,3000,366102,65898,432000,July
2763,JAMIES SWEET YELLOW BUNS 6PCS,PIECE,141,3500,418220,75280,493500,July
2765,JAMIES TWISTED BREAD 1KG,PIECE,1,6000,5085,915,6000,July
2769,JEE NAIL REMOVER,PIECE,1,2000,1695,305,2000,July
2776,JERRYCAN 20LTR 9000,PIECE,2,10000,16949,3051,20000,July
2780,JESA CHOCOLATE FLAVOURED MILK 200ML,PIECE,46,1500,58475,10525,69000,July
2781,JESA FINO BOX,BOX,1,24000,20339,3661,24000,July
2782,JESA FLAVOURED CHOCO 500ML,PIECE,6,4000,20339,3661,24000,July
2783,JESA FLAVOURED MILK BOX,BOX,3,30000,76271,13729,90000,July
2784,JESA FLAVOURED STRAW 500ML,PIECE,5,4000,16949,3051,20000,July
2785,JESA FLAVOURED VANILLA 500ML,PIECE,4,4000,13559,2441,16000,July
2789,JESA FRUIT STRAWBERRY 500G,PIECE,25,6000,127119,22881,150000,July
2791,JESA LONGLIFE UHT BOX,BOX,3,37000,94068,16932,111000,July
2792,JESA MILK 1LTR,PIECE,163,3600,497288,89512,586800,July
2793,JESA MILK 500ML,PIECE,1124,1800,1714576,308624,2023200,July
2794,JESA MILK UHT 500ML,PIECE,117,2193,217458,39142,256600,July
2796,JESA PLAIN YOGHURT 500G,PIECE,11,3700,34492,6208,40700,July
2797,JESA STRAW 250G YOGHURT,PIECE,31,2500,65678,11822,77500,July
2799,JESA STRAW YOGHURT 400G,PIECE,53,2500,112288,20212,132500,July
2801,JESA STRAWBERRY MILK 200MLS,PIECE,30,1500,38136,6864,45000,July
2802,JESA STRAWBERRY YOGHURT 500G,PIECE,22,3700,68983,12417,81400,July
2804,JESA TOFFEE YOGHURT 500G,PIECE,4,3700,12542,2258,14800,July
2805,JESA UHT FINO,PIECE,74,2000,125424,22576,148000,July
2809,JESA VANILLA FLAVOURED 200ML,PIECE,55,1500,69915,12585,82500,July
2811,JESA VANILLA YOGHURT 250G,PIECE,11,2500,23305,4195,27500,July
2812,JESA VANILLA YOGHURT 400G,PIECE,65,2500,137712,24788,162500,July
2813,JESA VANILLA YOGHURT 500G,PIECE,19,3700,59576,10724,70300,July
2825,JIB WATER 20LTRS REFILL,PIECE,5,8000,33898,6102,40000,July
2829,JIK COLOURS 1LTRS,PIECE,3,16000,40678,7322,48000,July
2830,JIK COLOURS 250MLS,PIECE,2,7000,11864,2136,14000,July
2831,JIK REGULAR 250MLS,PIECE,8,6500,44068,7932,52000,July
2833,JIK REGULAR 750MLS,PIECE,6,14000,71186,12814,84000,July
2866,JOHNSON EXTRA GENTLE CARE SOAP,PIECE,1,7500,6356,1144,7500,July
2916,JUMBO BLUE SWIRL 175ML,PIECE,3,4000,10169,1831,12000,July
2917,JUMBO CHOCOLATE RIPPLE 175MLS,PIECE,12,3500,35593,6407,42000,July
2921,JUMBO STRAWBERRY RIPPLE 175ML,PIECE,6,4000,20339,3661,24000,July
2922,JUMBO WAX CRAYONS,PIECE,1,5000,4237,763,5000,July
2933,KABODY COCONUT MILK 1KG,PIECE,1,6500,5508,992,6500,July
2934,KABODY COMPOSITE FLOUR,PIECE,1,6000,5085,915,6000,July
2937,KABODY MUKENE SOYA RICE1KG,PIECE,2,6000,10169,1831,12000,July
2939,KABODY OATS SOYA RICE 1KG,PIECE,1,6500,5508,992,6500,July
2940,KABODY PUMPKIN PORRIDGE 1KG,PIECE,2,6000,10169,1831,12000,July
2943,KABODY QUICK PORRIDGE1KG,PIECE,1,6000,5085,915,6000,July
2945,KABODY SOYA PORRIDGE,PIECE,1,6000,5085,915,6000,July
2947,KABODY WHITE OATS WITH RICE,PIECE,2,6000,10169,1831,12000,July
2950,KAKIRA SUGAR 1KG,PIECE,68,5618,323729,58271,382000,July
2952,KAKIRA SUGAR 2KG,PIECE,14,10429,123729,22271,146000,July
2962,KANGARO STAPLES,PIECE,5,2000,8475,1525,10000,July
2966,KANGAROO BLACK SHOE CREAM,PIECE,1,2000,1695,305,2000,July
2985,KAZIRE ALOEVERA,PIECE,30,1500,38136,6864,45000,July
2986,KAZIRE LEMON TEA,PIECE,10,2000,16949,3051,20000,July
2987,KAZIRE ORANGE,PIECE,9,2000,15254,2746,18000,July
2988,KAZIRE POWER TONIC,PIECE,9,2000,15254,2746,18000,July
2992,KELLOGS CORNFLAKES 500g,PIECE,1,27000,22881,4119,27000,July
2993,KELLOGS CORNFLAKES 720G,PIECE,2,35000,59322,10678,70000,July
3013,KENT OLIVE OIL EXTRA VIRGIN 500ML,PIECE,1,32000,27119,4881,32000,July
3051,KEY HOLDERS 3500,PIECE,5,3500,14831,2669,17500,July
3054,KIBIMBA RICE IKG,PIECE,1,8000,6780,1220,8000,July
3059,KICK SNACKS BBQ BEEF 15G,PIECE,1,500,424,76,500,July
3060,KICK SNACKS CHICKEN,PIECE,205,500,86864,15636,102500,July
3078,KIDS PATRAS 3000,PIECE,3,3000,7627,1373,9000,July
3082,KIDS SOCKS 5000,PIECE,3,5000,12712,2288,15000,July
3093,KIDS WATCHES 5000 GODLER,PIECE,1,5000,4237,763,5000,July
3094,KIDS WATCHES 7000,PIECE,2,6500,11017,1983,13000,July
3100,KIMBO 500G,PIECE,4,7500,25424,4576,30000,July
3103,KINGTAT 800,PIECE,16,1000,13559,2441,16000,July
3119,KISUBI 85GM,PIECE,9,1500,11441,2059,13500,July
3131,KIWI 20G,PIECE,3,3500,8898,1602,10500,July
3133,KIWI BLACK 80G,PIECE,5,8000,33898,6102,40000,July
3140,KIWI POLISH 12G,PIECE,2,2500,4237,763,5000,July
3142,KIWI SHOE CREME NEUTRAL 150MLS,PIECE,4,5500,18644,3356,22000,July
3143,KIWI SHOE POLISH 32G,PIECE,2,5000,8475,1525,10000,July
3144,KIWI SUEDE CLEANER BLACK,PIECE,2,7500,12712,2288,15000,July
3145,KIWI SUEDE CLEANER NEUTRAL,PIECE,1,7500,6356,1144,7500,July
3152,KNICKERS 3500,PIECE,10,3500,29661,5339,35000,July
3153,KNICKERS 4000,PIECE,4,4000,13559,2441,16000,July
3154,KNICKERS 5000,PIECE,1,5000,4237,763,5000,July
3155,KNICKERS 6000,PIECE,1,6000,5085,915,6000,July
3156,KNICKERS 7000,PIECE,5,7000,29661,5339,35000,July
3188,KOOKSY STRAWBERRY 120ML,PIECE,18,1000,15254,2746,18000,July
3194,KOOKSY VAN-CHOC 120MLS,PIECE,12,1000,10169,1831,12000,July
3195,KOOKSY VAN-CHOC 500ML,PIECE,2,5000,8475,1525,10000,July
3196,KOOKSY VANILLA 120MLS,PIECE,21,1000,17797,3203,21000,July
3198,KOOKSY VANILLA 220ML,PIECE,9,2000,15254,2746,18000,July
3199,KOOKSY VANILLA 250ML,PIECE,1,3500,2966,534,3500,July
3200,KOOKSY VANILLA 500ML,PIECE,1,5000,4237,763,5000,July
3202,KOOKSY VANILLA CHOCOLATE 220ML,PIECE,10,2000,16949,3051,20000,July
3203,KOOKSY VANILLA CHOCOLATE 250ML,PIECE,3,3500,8898,1602,10500,July
3207,KOOKSY VANILLA STRAWBERRY 220ML,PIECE,15,2000,25424,4576,30000,July
3208,KOOKSY VANILLA STRAWBERRY 250ML,PIECE,3,3500,8898,1602,10500,July
3210,KOOKSY VAN-STRAW 120MLS,PIECE,24,1000,20339,3661,24000,July
3211,KOOKSY VAN-STRAW 500ML,PIECE,2,5000,8475,1525,10000,July
3212,KOPIKO 3 IN 1 COFFEE,PIECE,4,2000,6780,1220,8000,July
3213,KOPIKO BLANCA CREAMY,PIECE,4,2000,6780,1220,8000,July
3214,KOPIKO BROWN COFFEE,PIECE,16,1500,20339,3661,24000,July
3217,KREST 500MLS,PIECE,42,1500,53390,9610,63000,July
3221,KRYSTAL WATER 500ML,PIECE,36,1000,30508,5492,36000,July
3224,KUAKUA TOILET BLOCKS 6PCS,PIECE,5,10000,42373,7627,50000,July
3234,KYOGERO HERBAL JELLY 100ML,PIECE,2,3500,5932,1068,7000,July
3236,KYOGERO HERBAL JELLY 250G,PIECE,1,7500,6356,1144,7500,July
3237,KYOGERO HERBAL JELLY 50G,PIECE,1,2000,1695,305,2000,July
3238,KYOGERO HERBAL JELLY40G,PIECE,2,1500,2542,458,3000,July
3239,KYOGERO HERBAL SOAP 120G,PIECE,4,3500,11864,2136,14000,July
3260,LABELLE HAIR FOOD 150G,PIECE,1,5000,4237,763,5000,July
3275,LANZO ANTI-BACTERIAL SOAP,PIECE,1,4500,3814,686,4500,July
3276,LANZO BUBBLY SOAP,PIECE,6,3500,17797,3203,21000,July
3277,LANZO COCONUT SHEA SOAP,PIECE,1,3500,2966,534,3500,July
3279,LANZO VANILLA SOAP,PIECE,1,3500,2966,534,3500,July
3284,LATO CHOCO PWDER MILK 15G,PIECE,28,500,11864,2136,14000,July
3285,LATO CHOCOLATE MILK 250MLS,PIECE,50,2000,84746,15254,100000,July
3290,LATO FLAVOURED BOX 23000,BOX,1,23000,19492,3508,23000,July
3291,LATO GHEE 500G,PIECE,3,16000,40678,7322,48000,July
3293,LATO MILK 250G,PIECE,10,12200,103390,18610,122000,July
3294,LATO MILK 400G,PIECE,6,19000,96610,17390,114000,July
3295,LATO MILK 900G,PIECE,3,48000,122034,21966,144000,July
3296,LATO MILK CHOCOLATE 125ML FLAVOURED,PIECE,31,1000,26271,4729,31000,July
3298,LATO MILK POWDER 15G,PIECE,40,500,16949,3051,20000,July
3299,LATO MILK PWDER STRAWBERRY 15G,PIECE,51,500,21610,3890,25500,July
3302,LATO MIXED BERRIES 250G,PIECE,24,3000,61017,10983,72000,July
3304,LATO PEACH&CARAMEL 250G,PIECE,22,3000,55932,10068,66000,July
3305,LATO PEACH&CARAMEL FRUIT 450G,PIECE,10,5500,46610,8390,55000,July
3306,LATO PLAIN YOGHURT 500G,PIECE,12,3700,37627,6773,44400,July
3309,LATO STRAWBERRY MILK 125MLS,PIECE,114,1000,96610,17390,114000,July
3310,LATO STRAWBERRY MILK 250MLS,PIECE,80,2000,135593,24407,160000,July
3311,LATO STRAWBERRY YOGHURT 500G,PIECE,18,3700,56441,10159,66600,July
3315,LATO VANILLA 100G,PIECE,9,1200,9153,1647,10800,July
3316,LATO VANILLA 125ML MILK,PIECE,105,1000,88983,16017,105000,July
3317,LATO VANILLA MILK 250MLS,PIECE,79,2000,133898,24102,158000,July
3318,LATO VANILLA YOGHURT 250ML,PIECE,21,2500,44492,8008,52500,July
3319,LATO VANILLA YOGHURT 500G,PIECE,13,3700,40763,7337,48100,July
3321,LATO YOG MIXED BERRIES 450G,PIECE,18,5500,83898,15102,99000,July
3322,LATO YOG STRAWBERRY 100G,PIECE,35,1200,35593,6407,42000,July
3323,LATO YOG STRAWBERRY 250G,PIECE,20,2500,42373,7627,50000,July
3324,LATO YOGHURT 400G VANILLA,PIECE,27,2500,57203,10297,67500,July
3325,LATO YOGHURT SRAWBERRY 200G,PIECE,103,1000,87288,15712,103000,July
3326,LATO YOGHURT STRAWBERRY 400G,PIECE,30,2500,63559,11441,75000,July
3327,LATO YOGHURT VANILLA 200G,PIECE,122,1000,103390,18610,122000,July
3335,LAVITA PINEAPPLE 320MLS,PIECE,25,1000,21186,3814,25000,July
3336,LAVITA PINEAPPLE 500ML,PIECE,3,1500,3814,686,4500,July
3361,LEMON CAKES 1000,PIECE,51,1200,51864,9336,61200,July
3378,LIGHTERS,PIECE,4,1000,3390,610,4000,July
3419,LOVE CHOCOLATE,PIECE,3,3167,8051,1449,9500,July
3433,LUCOZADE 1LTR,PIECE,30,10000,254237,45763,300000,July
3434,LUCOZADE 250ML,PIECE,3,3000,7627,1373,9000,July
3435,LUCOZADE 250MLS,PIECE,49,3000,124576,22424,147000,July
3456,LUX VESTS,PIECE,1,16000,13559,2441,16000,July
3458,LUXURY TOILET PAPER,PIECE,42,571,20339,3661,24000,July
3472,M&G HELLO BEARS PEN ERASE,PIECE,27,2500,57203,10297,67500,July
3475,M&G INK CATRIDGE,PIECE,6,4000,20339,3661,24000,July
3493,M&G STICK GLUE 1500,PIECE,3,1500,3814,686,4500,July
3494,M&G STICK GLUE 3000,PIECE,3,3000,7627,1373,9000,July
3499,M&G WHITE BOARD MARKER,PIECE,4,1500,5085,915,6000,July
3526,MACRO DENTAL FLOSS,PIECE,22,3000,55932,10068,66000,July
3533,MAGANJO BABY SOYA 1KG,PIECE,4,6500,22034,3966,26000,July
3535,MAGANJO BABY SOYA WITH MILK 500G,PIECE,1,8500,7203,1297,8500,July
3538,MAGANJO CORNFLAKES,PIECE,2,10000,16949,3051,20000,July
3539,MAGANJO ENERGY BOOSTER 1KG,PIECE,2,6500,11017,1983,13000,July
3548,MAGANJO PURE MILLET 1KG,PIECE,2,6500,11017,1983,13000,July
3552,MAGANJO SOYA MILLET,PIECE,1,6500,5508,992,6500,July
3553,MAGANJO SOYA RICE 1KGS,PIECE,5,7500,31780,5720,37500,July
3557,MAGANJO SUPER RICE 1KG,PIECE,2,6000,10169,1831,12000,July
3560,MAGIC 1KG SACHET,PIECE,9,8500,64831,11669,76500,July
3561,MAGIC 1KG BUCKET,PIECE,3,12500,31780,5720,37500,July
3562,MAGIC 250G BUCKET,PIECE,13,4000,44068,7932,52000,July
3563,MAGIC 500G BUCKET,PIECE,5,6500,27542,4958,32500,July
3564,MAGIC 500G SACHET,PIECE,17,4500,64831,11669,76500,July
3566,MAGIC SACHET 45G,PIECE,8,500,3390,610,4000,July
3575,MAKE UP FACIAL WIPES,PIECE,2,3500,5932,1068,7000,July
3584,MAMIS PEANUT PASTE 1KG,PIECE,8,15000,101695,18305,120000,July
3585,MAMIS PEANUT PASTE 500G,PIECE,23,8000,155932,28068,184000,July
3586,MANAGEMENT FILE 2000,PIECE,3,2000,5085,915,6000,July
3588,MANILA PAPERS 1000,PIECE,11,1000,9322,1678,11000,July
3597,MANUSCRIPT 3Q BOOK,PIECE,3,16000,40678,7322,48000,July
3598,MANUSCRIPT BOOK 2Q,PIECE,3,12000,30508,5492,36000,July
3607,MARIKA ICING SUGAR 500G,PIECE,6,4000,20339,3661,24000,July
3609,MARS CHOCOLATE,PIECE,18,3500,53390,9610,63000,July
3610,MARSHMALLOW DELICIOUS ASSORTED 15G,PIECE,18,2000,30508,5492,36000,July
3618,MASSAGE OLIVE OIL,PIECE,2,15000,25424,4576,30000,July
3621,MATHEMATICAL SET 3500 KYLIAN,PIECE,1,4000,3390,610,4000,July
3622,CAR TOY 15000,PIECE,2,17500,29661,5339,35000,July
3625,MAYONNAISE 237ML,PIECE,2,20000,33898,6102,40000,July
3626,MAYONNAISE BIG 887ML,PIECE,2,32000,54237,9763,64000,July
3628,MAYONNAISE MEDIUM 473ML,PIECE,4,25000,84746,15254,100000,July
3633,MEGA PASTA 400G,PIECE,1,4000,3390,610,4000,July
3635,MELEX BAGIYA 1000,PIECE,5,1000,4237,763,5000,July
3636,MELEX BAGIYA 2000,PIECE,7,2000,11864,2136,14000,July
3644,MELEX G.NUTS 1000,PIECE,2,1000,1695,305,2000,July
3645,MELEX G.NUTS 2000,PIECE,6,2000,10169,1831,12000,July
3647,MELEX HARDCONES 425G,PIECE,1,5000,4237,763,5000,July
3648,MELEX HARDCORNS 1000,PIECE,5,1000,4237,763,5000,July
3649,MELEX HARDCORNS 2000,PIECE,6,2000,10169,1831,12000,July
3653,MELEX SIMSIM 170G 2000,PIECE,4,2000,6780,1220,8000,July
3654,MELEX SIMSIM 85G 1000,PIECE,11,1000,9322,1678,11000,July
3655,MELEX SIMSIM BALLS 1000,PIECE,12,1000,10169,1831,12000,July
3656,MELEX SIMSIM BALLS 2000,PIECE,11,2000,18644,3356,22000,July
3663,MEN BOXERS 10000,PIECE,7,10000,59322,10678,70000,July
3668,MEN SOCKS,PIECE,2,4250,7203,1297,8500,July
3669,MEN SOCKS 3500,PIECE,1,3500,2966,534,3500,July
3674,MENTOS GRAPE,PIECE,1,2500,2119,381,2500,July
3682,MESSAGE CARDS 500,PIECE,5,500,2119,381,2500,July
3684,MIA GONJA 1000,PIECE,2,1000,1695,305,2000,July
3690,MIKOSHI GREEN TEA,PIECE,31,6000,157627,28373,186000,July
3709,MILO 100G,PIECE,2,11000,18644,3356,22000,July
3721,MINUTE MAID 1LTRS,PIECE,91,5000,385593,69407,455000,July
3723,MINUTE MAID BERRY BLAST 400MLS,PIECE,38,2500,80508,14492,95000,July
3725,Minute maid mango,PIECE,118,2500,250000,45000,295000,July
3729,MINUTEMAID BERRY BLAST 1LTR,PIECE,30,5000,127119,22881,150000,July
3736,MIRINDA APPLE,PIECE,53,1500,67373,12127,79500,July
3737,MIRINDA APPLE 2LTR,PIECE,33,4500,125847,22653,148500,July
3738,MIRINDA APPLE 330ML,PIECE,37,1000,31356,5644,37000,July
3739,MIRINDA FRUITY,PIECE,29,1500,36864,6636,43500,July
3740,MIRINDA FRUITY 2LTR,PIECE,33,4500,125847,22653,148500,July
3741,MIRINDA FRUITY 330MLS,PIECE,114,1000,96610,17390,114000,July
3742,MIRINDA ORANGE 2LTRS,PIECE,20,4500,76271,13729,90000,July
3743,MIRINDA ORANGE 330ML,PIECE,73,1000,61864,11136,73000,July
3744,MIRINDA ORANGE 500ML,PIECE,20,1500,25424,4576,30000,July
3745,MIRINDA PINEAPPLE,PIECE,5,1500,6356,1144,7500,July
3747,MIRINDA PINEAPPLE 330ML,PIECE,24,1000,20339,3661,24000,July
3748,MIRROR 1500,PIECE,2,1500,2542,458,3000,July
3760,MOCACINE SOCKS 2000,PIECE,10,1950,16525,2975,19500,July
3761,MOCACINE SOCKS 2500,PIECE,2,2500,4237,763,5000,July
3776,MOLFIX JUMBO 3 TAPPED,PIECE,1,53000,44915,8085,53000,July
3809,MOPPER 7000,PIECE,3,7000,17797,3203,21000,July
3813,MOPPERS 15000,PIECE,2,15000,25424,4576,30000,July
3837,MORTEIN DOOM LEMON 400ML,PIECE,2,28000,47458,8542,56000,July
3838,MORTEIN DOOM LEMON 600MLS,PIECE,1,33000,27966,5034,33000,July
3841,MORTEIN LEMON 300ML,PIECE,1,22000,18644,3356,22000,July
3843,MORTEIN ODOURLESS 180MLS,PIECE,1,15000,12712,2288,15000,July
3846,MORTEIN ODOURLESS 600ML,PIECE,1,33000,27966,5034,33000,July
3848,MOSQUITO NETS 15000,PIECE,1,15000,12712,2288,15000,July
3855,MOTH BALLS 4000,PIECE,5,7000,29661,5339,35000,July
3862,MOUNTAIN DEW,PIECE,26,1500,33051,5949,39000,July
3863,MOUNTAIN DEW 2LTR,PIECE,37,4500,141102,25398,166500,July
3864,MOUNTAIN DEW 300MLS,PIECE,113,1000,95763,17237,113000,July
3866,MOUSE &RAT TRAPS BLACK,PIECE,2,3000,5085,915,6000,July
3867,MOUSE &RAT TRAPS GREEN,PIECE,15,3000,38136,6864,45000,July
3869,MOVIT BABY JELLY 110G,PIECE,2,3250,5508,992,6500,July
3875,MOVIT BABYJELLY 50g,PIECE,1,1500,1271,229,1500,July
3879,MOVIT BODY MILK CREME 250G,PIECE,1,4500,3814,686,4500,July
3881,MOVIT BODYMILK 80G,PIECE,2,1500,2542,458,3000,July
3886,MOVIT EGG SHAMPOO 1LTR,PIECE,2,7000,11864,2136,14000,July
3887,MOVIT FAMILY SOAP 230G,PIECE,4,4000,13559,2441,16000,July
3888,MOVIT FAMILY SOAP ALOE 120G,PIECE,1,2500,2119,381,2500,July
3889,MOVIT FAMILY SOAP ALOE 230G,PIECE,4,4000,13559,2441,16000,July
3890,MOVIT FAMILY SOAP ALOE V.P,PIECE,4,7000,23729,4271,28000,July
3891,MOVIT FAMILY SOAP COCOMUT 125G,PIECE,4,2500,8475,1525,10000,July
3892,MOVIT FAMILY SOAP COCONUT 230G,PIECE,6,4000,20339,3661,24000,July
3893,MOVIT FAMILY SOAP LEMON V.P,PIECE,1,7000,5932,1068,7000,July
3896,MOVIT FAMILY SOAP V.P COCONUT,PIECE,1,7000,5932,1068,7000,July
3897,MOVIT FAMILY SOAP V.P ROSE,PIECE,4,7000,23729,4271,28000,July
3900,MOVIT HAIR DYE 120ML,PIECE,1,6000,5085,915,6000,July
3903,MOVIT HAIR FOOD 70G,PIECE,3,3000,7627,1373,9000,July
3904,MOVIT HAIR FOOD AVACADO OIL 200G,PIECE,2,5500,9322,1678,11000,July
3906,MOVIT HERBAL JELLY 120G,PIECE,2,4000,6780,1220,8000,July
3907,MOVIT HERBAL JELLY 200G,PIECE,2,6000,10169,1831,12000,July
3910,MOVIT HERBAL JELLY 550G,PIECE,1,12000,10169,1831,12000,July
3911,MOVIT HERBAL SOAP 120G,PIECE,2,3000,5085,915,6000,July
3913,MOVIT JELLY 200G,PIECE,2,5000,8475,1525,10000,July
3917,MOVIT JELLY 85ML,PIECE,1,2000,1695,305,2000,July
3923,MOVIT OLIVE SHEEN HAIR SPRAY,PIECE,1,13000,11017,1983,13000,July
3925,MOVIT PETRO JELLY 250G,PIECE,1,5500,4661,839,5500,July
3932,MOVIT SULPHUR 60G,PIECE,1,2500,2119,381,2500,July
3944,MUKISA CAKE 2500,PIECE,14,2500,29661,5339,35000,July
3945,MUKISA MANDAZI,PIECE,15,2800,35593,6407,42000,July
3946,MUKISA MANDAZI 1000,PIECE,7,1500,8898,1602,10500,July
3958,MUKWANO TEA BAGS 100G,PIECE,1,5500,4661,839,5500,July
3959,MUKWANO TEA BAGS 200G,PIECE,3,10000,25424,4576,30000,July
3969,Musawo jeza cream,PIECE,1,3000,2542,458,3000,July
3972,MUSAWO SOAP 120G,PIECE,3,2000,5085,915,6000,July
3973,MUSAWO SOAP 240G,PIECE,4,3500,11864,2136,14000,July
3994,NACET 500 PCS,PIECE,7,500,2966,534,3500,July
3995,NACET BLADES 2500 PKT,PIECE,2,2500,4237,763,5000,July
3997,NAIL CUTTER 2500,PIECE,4,2500,8475,1525,10000,July
3998,NAIL CUTTERS 1500,PIECE,11,1500,13983,2517,16500,July
4001,NANA HERBAL MOUTH 60MLS,PIECE,9,7500,57203,10297,67500,July
4021,NATARAJ COLOR PENCILS,PIECE,1,7500,6356,1144,7500,July
4023,NATARAJ PENCILS 6000,PIECE,1,6000,5085,915,6000,July
4024,NATARAJ PENS,PIECE,20,700,11864,2136,14000,July
4029,NATURAL NAPKINS,PIECE,6,2500,12712,2288,15000,July
4032,NECTAR SPRAY,PIECE,1,10000,8475,1525,10000,July
4034,NEEK YOGHURT 1LTR,PIECE,10,7000,59322,10678,70000,July
4035,NEEK YOGHURT 300G 2000,PIECE,10,2500,21186,3814,25000,July
4036,NEEK YOGHURT 500G 3500,PIECE,7,3500,20763,3737,24500,July
4043,NESCAFE CLASSIC 100G,PIECE,4,18000,61017,10983,72000,July
4044,NESCAFE CLASSIC 200G,PIECE,1,29000,24576,4424,29000,July
4045,NESCAFE CLASSIC 2G,PIECE,94,500,39831,7169,47000,July
4046,NESCAFE CLASSIC 50G,PIECE,6,12000,61017,10983,72000,July
4050,NESCAFE ORIGINAL 1000,PIECE,2,1500,2542,458,3000,July
4051,NESTLE KITKAT,PIECE,16,3500,47458,8542,56000,July
4052,NEVIA PEARL&BEAUTY ROLLON,PIECE,4,11000,37288,6712,44000,July
4055,NEWFARM BANANA JUICE 320ML,PIECE,1,2500,2119,381,2500,July
4056,NEWFARM BANANA JUICE 500ML,PIECE,1,3500,2966,534,3500,July
4063,NEWMAN GONJA CRISPS 50G,PIECE,1,1500,1271,229,1500,July
4064,NEWMAN POTATO CRISPS 100G,PIECE,20,2500,42373,7627,50000,July
4066,NEWMAN POTATO CRISPS 50G,PIECE,48,1500,61017,10983,72000,July
4073,NEWMAN'S POTATO CRISPS 180G,PIECE,10,5000,42373,7627,50000,July
4074,NEWMANS POTATO CRISPS 25G,PIECE,51,600,25932,4668,30600,July
4077,NICE BASIN 6000,PIECE,2,6000,10169,1831,12000,July
4078,NICE BASINS BIG 10000,PIECE,1,10000,8475,1525,10000,July
4081,NICE CLEAR PENS,PIECE,15,500,6356,1144,7500,July
4082,NICE TOOTHBRUSH,PIECE,15,1000,12712,2288,15000,July
4084,NICE&LOVELY 200ML PINK,PIECE,1,6000,5085,915,6000,July
4116,NISA CAMEL SOAP SHEABUTTER,PIECE,1,5500,4661,839,5500,July
4117,NISA CUCUMBER HAIR REMOVAL 20ML,PIECE,3,2000,5085,915,6000,July
4118,NISA HAIR REMOVAL CUCUMBER 100ML,PIECE,1,10000,8475,1525,10000,July
4121,NISA HAIR REMOVAL ROSE 100ML,PIECE,1,10000,8475,1525,10000,July
4123,NISA LEMON HAIR REMOVAL CREME 20ML,PIECE,3,2000,5085,915,6000,July
4125,NISA ROSE HAIR REMOVAL CREAM 20ML,PIECE,3,2000,5085,915,6000,July
4128,NIVANA 500MLS,PIECE,196,500,83051,14949,98000,July
4131,NIVANA WATER 1.5L,PIECE,43,1500,54661,9839,64500,July
4137,NIVEA BLACK&WHITE ROLLON,PIECE,3,11000,27966,5034,33000,July
4139,NIVEA COOL KICK 400MLS,PIECE,2,20000,33898,6102,40000,July
4140,NIVEA COOL KICK ROLLON,PIECE,2,11000,18644,3356,22000,July
4141,NIVEA DEEP AMAZONIA,PIECE,1,11000,9322,1678,11000,July
4142,NIVEA DRY COMFORT ROLLON,PIECE,3,11000,27966,5034,33000,July
4147,NIVEA FRESH ENERGY 50ML,PIECE,4,11000,37288,6712,44000,July
4157,NIVEA MEN DEEP BLACK CARBON,PIECE,3,11000,27966,5034,33000,July
4158,NIVEA MEN DEEP ROLLON,PIECE,3,11000,27966,5034,33000,July
4161,NIVEA MEN DRY IMPACT BODY SPRAY,PIECE,1,17000,14407,2593,17000,July
4162,NIVEA MEN FRESH ACTIVE 50ML,PIECE,4,11000,37288,6712,44000,July
4163,NIVEA MEN FRESH ACTIVE SPRAY,PIECE,2,17000,28814,5186,34000,July
4165,NIVEA MEN INVISIBLE BLACK,PIECE,3,17000,43220,7780,51000,July
4167,NIVEA MEN MAXIMUM HYDRATION 400ML,PIECE,1,20000,16949,3051,20000,July
4168,NIVEA MEN REVITALIZING,PIECE,1,20000,16949,3051,20000,July
4173,NIVEA NOURISHING COCOA LOTION 400ML,PIECE,2,20000,33898,6102,40000,July
4177,NIVEA PROTECT&CARE BODY SPRAY,PIECE,1,16000,13559,2441,16000,July
4178,NIVEA REPAIR& CARE 72H 400ML,PIECE,1,19000,16102,2898,19000,July
4185,NIVEA SHEA SMOOTH LOTION 400ML,PIECE,1,20000,16949,3051,20000,July
4190,NOMI 250G BUCKET,PIECE,3,4000,10169,1831,12000,July
4191,NOMI BUCKET 1KG,PIECE,10,12500,105932,19068,125000,July
4192,NOMI BUCKET 500G,PIECE,4,6500,22034,3966,26000,July
4194,NOTE BOOK 1000,PIECE,8,1000,6780,1220,8000,July
4195,NOTE BOOK 2000,PIECE,2,2000,3390,610,4000,July
4196,NOTE BOOK 3000,PIECE,4,3000,10169,1831,12000,July
4198,NOTE BOOK 4000,PIECE,4,4000,13559,2441,16000,July
4199,NOTE BOOK 5500,PIECE,5,5500,23305,4195,27500,July
4201,NOTE BOOK SPIRAL 10000,PIECE,5,10000,42373,7627,50000,July
4204,NOTEBOOK 6500,PIECE,3,6500,16525,2975,19500,July
4208,NOVIDA 350MLS,PIECE,32,1000,27119,4881,32000,July
4209,NOVIDA 500MLS,PIECE,31,1500,39407,7093,46500,July
4217,NTALE HERBAL SOAP 100G,PIECE,4,3500,11864,2136,14000,July
4218,NUMA BUSHERA 1KG,PIECE,12,6500,66102,11898,78000,July
4219,NUMA BUSHERA 2KG,PIECE,5,12000,50847,9153,60000,July
4222,NUMA RICE FLOUR 1KG,PIECE,8,7500,50847,9153,60000,July
4223,NUMA SOYA RICE 1KG,PIECE,12,7000,71186,12814,84000,July
4225,NUMA SOYARICE WITH NKEJJE 500G,PIECE,3,5000,12712,2288,15000,July
4228,NUMA SUPER RICE 5KG,PIECE,1,41000,34746,6254,41000,July
4229,NUSS CHOCOLATE,PIECE,16,1000,13559,2441,16000,July
4235,NUTRO CHOC CREAM WAFERS,PIECE,6,6500,33051,5949,39000,July
4236,NUTRO CHOCOLATE BISCUITS,PIECE,60,1200,61017,10983,72000,July
4239,NUTRO CREAM WAFERS 3,PIECE,7,6500,38559,6941,45500,July
4240,NUTRO DIGESTIVE,PIECE,7,6500,38559,6941,45500,July
4241,NUTRO DIGESTIVE LIGHT,PIECE,4,6500,22034,3966,26000,July
4245,NUTRO STRAW CREAM WAFERS,PIECE,7,3500,20763,3737,24500,July
4247,NUTRO TEA BISCUIT,PIECE,19,3500,56356,10144,66500,July
4248,NUTRO VANILLA 30G,PIECE,100,1223,103644,18656,122300,July
4249,NUTRO VANILLA FLAVOURED,PIECE,1,3500,2966,534,3500,July
4252,NUTRO WAFERS VANILLA,PIECE,12,3500,35593,6407,42000,July
4263,NUVITA CHOCO BISCUITS,PIECE,10,2000,16949,3051,20000,July
4264,NUVITA CHOCOLATE CREAM,PIECE,6,1500,7627,1373,9000,July
4271,NUVITA GO COOKIES,PIECE,18,2000,30508,5492,36000,July
4272,NUVITA LEMON BISCUITS 750,PIECE,6,1500,7627,1373,9000,July
4274,NUVITA ORANGE CREAM BISCUITS,PIECE,7,1500,8898,1602,10500,July
4275,NUVITA STRAWBERRY CREAMS 75G,PIECE,3,1500,3814,686,4500,July
4284,OATIBIX 500G,PIECE,3,12000,30508,5492,36000,July
4292,ODO SMILE TOILET BALLS,PIECE,4,6500,22034,3966,26000,July
4293,ODONIL DISINFECTANT,PIECE,2,7000,11864,2136,14000,July
4295,OFFICE GLUE 90G,PIECE,3,2000,5085,915,6000,July
4312,OLD SPICE PURE SPORT63G,PIECE,1,20000,16949,3051,20000,July
4329,OLIVE OIL SPRAY 275ML,PIECE,1,12000,10169,1831,12000,July
4330,OLIVE OIL SPRAY 85ML,PIECE,1,7500,6356,1144,7500,July
4333,OMO 40G FRESH,PIECE,7,500,2966,534,3500,July
4334,OMO AUTO WASHING POWDER 1KG,PIECE,2,21000,35593,6407,42000,July
4335,OMO BLEACH COLOUR SAFE 700ML.,PIECE,2,9000,15254,2746,18000,July
4336,OMO BLEACH LEMON,PIECE,2,8000,13559,2441,16000,July
4337,OMO BLEACH MULTI -PURPOSE,PIECE,2,4000,6780,1220,8000,July
4339,OMO BLEACH REGULAR,PIECE,1,8000,6780,1220,8000,July
4340,OMO BLEACH REGULAR 250ML,PIECE,4,3500,11864,2136,14000,July
4342,OMO COMFORT 1KG,PIECE,6,13000,66102,11898,78000,July
4343,OMO COMFORT 500G,PIECE,4,7500,25424,4576,30000,July
4344,OMO FAST ACTION 1KG,PIECE,1,13000,11017,1983,13000,July
4345,OMO FAST ACTION 3.5KG,PIECE,2,40000,67797,12203,80000,July
4346,OMO FAST ACTION 500G,PIECE,5,7500,31780,5720,37500,July
4347,ONER APPLE JUICE DRINK,PIECE,158,2500,334746,60254,395000,July
4348,ONER BERRIES 300ML,PIECE,118,1500,150000,27000,177000,July
4349,ONER BERRIES JUICE DRINK,PIECE,97,2500,205508,36992,242500,July
4350,ONER MANGO 1LTR,PIECE,14,5000,59322,10678,70000,July
4351,ONER MANGO 500MLS,PIECE,146,2500,309322,55678,365000,July
4364,ORANGES 2000,PIECE,51,2000,86441,15559,102000,July
4365,ORCHID VALLEY APPLE 1LTR,PIECE,8,7500,50847,9153,60000,July
4368,ORCHID VALLEY MANGO 1LTR6161101061483,PIECE,4,7500,25424,4576,30000,July
4370,ORCHID VALLEY PASSION 1LTR,PIECE,1,7000,5932,1068,7000,July
4390,ORGANIC GINGER POWDER50G,PIECE,1,3500,2966,534,3500,July
4416,OX FORD SETS 11000,PIECE,2,11000,18644,3356,22000,July
4430,PADLOCK 3000,PIECE,1,3000,2542,458,3000,July
4433,PADLOCK 5000,PIECE,1,5000,4237,763,5000,July
4434,PADLOCK 6000,PIECE,1,6000,5085,915,6000,July
4442,PAMPER 2 H.C,PIECE,2,40000,67797,12203,80000,July
4444,PAMPER 2 L.C,PIECE,7,9000,53390,9610,63000,July
4447,PAMPER 3 L.C PANTS,PIECE,5,9000,38136,6864,45000,July
4450,PAMPER 4 L.C PANTS,PIECE,10,9000,76271,13729,90000,July
4454,PAMPER 5 L.C PANTS,PIECE,7,9000,53390,9610,63000,July
4459,PAMPER S.6 JUMBO 48DIAP,PIECE,1,73000,61864,11136,73000,July
4464,PANASONIC AA,PIECE,1,2000,1695,305,2000,July
4465,PANASONIC AAA,PIECE,5,2000,8475,1525,10000,July
4466,PANASONIC BIG,PIECE,1,6000,5085,915,6000,July
4470,PANCHAVATI,PIECE,3,3000,7627,1373,9000,July
4473,PANT PEG 5000,PIECE,1,5000,4237,763,5000,July
4475,PANT PEG COAT HANGER,PIECE,1,9000,7627,1373,9000,July
4481,PANT PEGS 9000,PIECE,2,9000,15254,2746,18000,July
4484,PAPERLINE EXERCISE BK,PIECE,2,4000,6780,1220,8000,July
4494,PARLE MILK POWER BISCUITS 375G,PIECE,5,7000,29661,5339,35000,July
4496,PARLE-G BISCUITS,PIECE,1,10000,8475,1525,10000,July
4497,PARLE-G BISCUITS PCS,PIECE,17,2500,36017,6483,42500,July
4513,PEGS DM 12000,PIECE,1,12000,10169,1831,12000,July
4516,PELIKAN RUBBER,PIECE,1,1000,847,153,1000,July
4517,PELIKAN RUBBERS 1000,PIECE,3,1000,2542,458,3000,July
4519,PENCIL BAG 1500,PIECE,1,1500,1271,229,1500,July
4534,PEPSI,PIECE,41,1500,52119,9381,61500,July
4535,PEPSI 2LTR,PIECE,36,4500,137288,24712,162000,July
4536,PEPSI 330ML,PIECE,110,1000,93220,16780,110000,July
4537,PEPSI MAX,PIECE,16,1000,13559,2441,16000,July
4539,PEPSODENT CAVITY 65G,PIECE,3,2500,6356,1144,7500,July
4540,PEPSODENT CAVITY FIGHTER 150G,PIECE,5,5000,21186,3814,25000,July
4541,PEPSODENT HERBAL 65G,PIECE,16,2500,33898,6102,40000,July
4542,PEPSODENT HERBAL TRIPPLE140G,PIECE,1,5000,4237,763,5000,July
4546,PEPTANG KETCHUP 400G,PIECE,4,7500,25424,4576,30000,July
4549,PEPTANG TOMATO SAUCE 400G,PIECE,3,4500,11441,2059,13500,July
4552,PERMANENT MAKER,PIECE,2,1000,1695,305,2000,July
4556,PETTICOT 4000,PIECE,2,4000,6780,1220,8000,July
4571,PIANO TOYS 1000,PIECE,1,10000,8475,1525,10000,July
4572,PIANO TOYS 10000,PIECE,2,10000,16949,3051,20000,July
4573,PIANO TOYS 4000,PIECE,1,4000,3390,610,4000,July
4574,PIANO TOYS7000,PIECE,1,8000,6780,1220,8000,July
4575,PIAO PIAO TP ORIGINAL,PIECE,91,2000,154237,27763,182000,July
4576,PIAO PIAO TP,PIECE,2,2000,3390,610,4000,July
4577,PICFARE 192 PAGES 6000,PIECE,1,6000,5085,915,6000,July
4578,PICFARE 2 QUIRE,PIECE,1,5000,4237,763,5000,July
4579,PICFARE 288PAGES 8500,PIECE,5,8000,33898,6102,40000,July
4583,PICFARE 96PGS,PIECE,9,1000,7627,1373,9000,July
4585,PICFARE GRAPH BOOK 48PGS,PIECE,5,2000,8475,1525,10000,July
4588,PICFARE PENCILS 3000,PIECE,1,3000,2542,458,3000,July
4589,PICFARE PENCILS PIECES 300,PIECE,8,300,2034,366,2400,July
4592,PICFARE SET,PIECE,4,6000,20339,3661,24000,July
4594,PICH n PEEL TROPICAL MIX 1LTR,PIECE,8,9500,64407,11593,76000,July
4597,PICK n PEEL MANGO 1LTR,PIECE,1,9500,8051,1449,9500,July
4615,PK CHEWING GUM 500,PIECE,72,497,30339,5461,35800,July
4616,PK CHEWING GUM BIG,PIECE,60,1000,50847,9153,60000,July
4622,PLASTIC FOOD WRAP,PIECE,1,6500,5508,992,6500,July
4623,PLASTIC FORKS 50PCS,PIECE,1,4000,3390,610,4000,July
4642,PLATES 3000,PIECE,1,3000,2542,458,3000,July
4644,PLATES CLAY 3000,PIECE,1,3500,2966,534,3500,July
4646,PLATES MELAMINE 3500,PIECE,1,3500,2966,534,3500,July
4649,PLAYING CARDS,PIECE,1,1000,847,153,1000,July
4653,PLUTO ADVANCED AA,PIECE,5,6000,25424,4576,30000,July
4663,POMEGRANATE ED PASSION,PIECE,1,16000,13559,2441,16000,July
4668,POPPER 8500,PIECE,3,8500,21610,3890,25500,July
4680,POTATO FEEDING BOTTLE 18000,PIECE,1,18000,15254,2746,18000,July
4694,POULTRY VIENNAS 1KG,PIECE,3,42000,106780,19220,126000,July
4695,POULTRY VIENNAS 250G,PIECE,5,13000,55085,9915,65000,July
4696,POULTRY VIENNAS 500G,PIECE,9,22000,167797,30203,198000,July
4699,POWER PUFF SNACKS,PIECE,1,1000,847,153,1000,July
4700,POWERPLAY 400MLS,PIECE,16,2000,27119,4881,32000,July
4701,PRADIP CHOCOLATE ESSENCE,PIECE,1,5500,4661,839,5500,July
4705,PRADIP VANILLA CLEAR FLAVOURING,PIECE,6,5000,25424,4576,30000,July
4706,PRADIP VANILLA ESSENCE,PIECE,1,6000,5085,915,6000,July
4711,PREDATOR ENERGY DRINK,PIECE,5,2000,8475,1525,10000,July
4717,PRESTIGE 250G,PIECE,21,4500,80085,14415,94500,July
4718,PRESTIGE 500G,PIECE,8,7500,50847,9153,60000,July
4720,PRICETAGS 1000,PIECE,1,1000,847,153,1000,July
4732,PRINCESS ULTRA PADS,PIECE,1,2700,2288,412,2700,July
4733,PRINCESS ULTRA THIN,PIECE,1,3000,2542,458,3000,July
4739,PRINGLES HOT&SPICY 40G,PIECE,1,6000,5085,915,6000,July
4742,PRINGLES ORIGINAL 165G BURSTING,PIECE,7,11000,65254,11746,77000,July
4743,PRINGLES ORIGINAL 40G,PIECE,4,6000,20339,3661,24000,July
4746,PRINGLES SOUR CREAM 165G,PIECE,4,12000,40678,7322,48000,July
4750,PRIVE CORAL SPLASH,PIECE,1,14000,11864,2136,14000,July
4754,PRIVE KANZ SPLASH,PIECE,1,14000,11864,2136,14000,July
4757,PRIVE MODA POUR FEMME,PIECE,1,15000,12712,2288,15000,July
4767,PROTEX CLASSIC 150G,PIECE,1,6500,5508,992,6500,July
4775,PROTEX GENTAL 90G,PIECE,1,3500,2966,534,3500,July
4777,PROTEX HERBAL 150G,PIECE,6,6500,33051,5949,39000,July
4778,PROTEX HERBAL 90G,PIECE,3,4000,10169,1831,12000,July
4783,PUCELLE BLISSFUL SENSE 75ML,PIECE,1,5000,4237,763,5000,July
4784,PUCELLE ECCENTRIC BREEZE,PIECE,1,7000,5932,1068,7000,July
4785,PUCELLE ECCETRIC BREEZE 75ML,PIECE,2,5000,8475,1525,10000,July
4787,PUCELLE FOR MY HEART,PIECE,1,7500,6356,1144,7500,July
4788,PUCELLE FOR MY PASSION,PIECE,1,7500,6356,1144,7500,July
4789,PUCELLE JOLLY RHYTHM 150MLS,PIECE,1,7500,6356,1144,7500,July
4801,PUFF HOLDERS 1000,PIECE,2,1000,1695,305,2000,July
4802,PUFF HOLDERS 1500,PIECE,1,1500,1271,229,1500,July
4803,PUFF HOLDERS 2000,PIECE,1,2000,1695,305,2000,July
4813,PURE GLUCOSE BOX,PIECE,1,1000,847,153,1000,July
4820,QUAKER WHITE OATS,PIECE,1,13000,11017,1983,13000,July
4826,QUILL PEN INK BIG,PIECE,1,3500,2966,534,3500,July
4839,RADIANT HAIR FOOD 100G,PIECE,6,5000,25424,4576,30000,July
4840,RADIANT HAIR VITALIZER 100G,PIECE,3,5000,12712,2288,15000,July
4842,RADIANT OLIVE OIL SHEEN SPRAY,PIECE,1,14000,11864,2136,14000,July
4843,RADIANT OLIVE OIL SPRAY 250MLS,PIECE,2,11000,18644,3356,22000,July
4849,RAHA COCOA 100G,PIECE,1,8000,6780,1220,8000,July
4851,RAHA DRINKING CHOCOLATE 100G,PIECE,3,7000,17797,3203,21000,July
4871,RASPBERRY MIST PASSION,PIECE,2,16000,27119,4881,32000,July
4872,RAT BOOK 3500,PIECE,1,3000,2542,458,3000,July
4875,RAYAN BLACK PERFUME,PIECE,1,12000,10169,1831,12000,July
4878,RAZAC HAND&BODY LOTION 20Z,PIECE,1,5000,4237,763,5000,July
4879,RAZAC HAND&BODY LOTION 40Z,PIECE,1,7500,6356,1144,7500,July
4889,RECEIPT BOOKS CARBONATED,PIECE,1,6000,5085,915,6000,July
4896,RED BULL 250MLS,PIECE,14,7000,83051,14949,98000,July
4897,RED COCK 2KG,PIECE,3,27000,68644,12356,81000,July
4898,RED COCK BASMATI 1KG,PIECE,4,14000,47458,8542,56000,July
4901,REDCOCK RICE 5KG,PIECE,1,60000,50847,9153,60000,July
4933,RIBBONS 1000,PIECE,1,1000,847,153,1000,July
4935,RIBBONS 7500,PIECE,1,7500,6356,1144,7500,July
4936,RIBENA 1LTR,PIECE,10,10000,84746,15254,100000,July
4937,RIBENA 250MLS,PIECE,21,3000,53390,9610,63000,July
4945,RIHAM COFFEE MALT,PIECE,31,1500,39407,7093,46500,July
4947,RIHAM COLA 320MLS,PIECE,6,1000,5085,915,6000,July
4952,RIHAM CREAMY ORANGE,PIECE,4,1200,4068,732,4800,July
4953,RIHAM CREAMY STRAWBERRY,PIECE,4,1200,4068,732,4800,July
4956,RIHAM EXOTIC TAMARIND,PIECE,28,1000,23729,4271,28000,July
4960,RIHAM ONER APPLE 300ML,PIECE,132,1500,167797,30203,198000,July
4961,RIHAM ONER MANGO 300ml,PIECE,140,1500,177966,32034,210000,July
4964,RIHAM WATER 1.5LTRS,PIECE,6,2000,10169,1831,12000,July
4965,RIHAM WATER 600ML,PIECE,25,1000,21186,3814,25000,July
4974,RINJU SHEA BUTTER 59ML,PIECE,1,5000,4237,763,5000,July
4976,RIOLA LUNCH BOX,PIECE,1,6000,5085,915,6000,July
4984,ROCK BOOM 320MLS,PIECE,70,2000,118644,21356,140000,July
4989,ROKI 5LTRS,PIECE,1,41000,34746,6254,41000,July
4990,ROKI OIL 1LTR,PIECE,2,10000,16949,3051,20000,July
4991,ROKI OIL 3LTRS,PIECE,1,27000,22881,4119,27000,July
4992,ROKI OIL 500ML,PIECE,14,5000,59322,10678,70000,July
5016,ROYCO BEEF 200G,PIECE,9,6000,45763,8237,54000,July
5018,ROYCO BEEF 500G,PIECE,5,12000,50847,9153,60000,July
5020,ROYCO BEEF 60G,PIECE,5,1200,5085,915,6000,July
5021,ROYCO CHICKEN 200G,PIECE,9,6000,45763,8237,54000,July
5022,ROYCO CHICKEN 500G,PIECE,2,12000,20339,3661,24000,July
5023,ROYCO CHICKEN 60G,PIECE,4,1200,4068,732,4800,July
5024,ROYCO CUBE CHICKEN FLAVOUR,PIECE,1,5000,4237,763,5000,July
5025,ROYCO CUBES BEEF,PIECE,5,4000,16949,3051,20000,July
5026,ROYCO CURRY+MCHUZI,PIECE,3,6500,16525,2975,19500,July
5030,RUBEE LOTION 59ML,PIECE,2,5000,8475,1525,10000,July
5031,RUGS 3000,PIECE,1,3000,2542,458,3000,July
5036,RWENZORI 1.5LTRS,PIECE,150,2000,254237,45763,300000,July
5043,RWENZORI WATER 500ML,PIECE,83,1000,70339,12661,83000,July
5049,SAFA TOMATO PASTE 400G,PIECE,4,6000,20339,3661,24000,July
5050,SAFA TOMATO PASTE 70GM,PIECE,39,1500,49576,8924,58500,July
5053,SAFARI TEA 50G,PIECE,6,1750,8898,1602,10500,July
5054,SAFEGUARD PURE WHITE SOAP160G,PIECE,1,3000,2542,458,3000,July
5055,SAFETY PIN 300,PIECE,2,200,339,61,400,July
5061,"SAFISHA GLASS,TILE CLEANER",PIECE,1,10000,8475,1525,10000,July
5063,SAF-LEVURE 125G,PIECE,3,8500,21610,3890,25500,July
5088,SANDALS 7000,PIECE,2,7000,11864,2136,14000,July
5090,SANTA LUCIA 250G,PIECE,31,2500,65678,11822,77500,July
5091,SANTA LUCIA 450G,PIECE,42,5000,177966,32034,210000,July
5095,SANTA LUCIA LUMACA,PIECE,3,6000,15254,2746,18000,July
5142,SAVANNAH COCOPINE 2LTR,PIECE,2,18500,31356,5644,37000,July
5149,SAVANNAH ORANGE 2LTRS,PIECE,2,18500,31356,5644,37000,July
5151,SAVANNAH PINEAPPLE 2LTR,PIECE,2,18500,31356,5644,37000,July
5153,SAVANNAH PINEAPPLE 5LTR,PIECE,1,33000,27966,5034,33000,July
5155,SAVANNAH STRAWBERRY 3LTRS,PIECE,2,22000,37288,6712,44000,July
5159,SCARLET CARAMEL CHOCOLATE,PIECE,1,3000,2542,458,3000,July
5167,SCHOOL SOCKS BLUE&WHITE 4000,PIECE,6,4000,20339,3661,24000,July
5170,SCHOOL SOCKS RED/GREEN YELLOW,PIECE,2,4000,6780,1220,8000,July
5171,SCHOOL SOCKS WHITE 7000,PIECE,1,7500,6356,1144,7500,July
5174,SCHOOL STOCKINGS WHITE,PIECE,5,4500,19068,3432,22500,July
5180,SCOURER 1000,PIECE,25,980,20763,3737,24500,July
5181,SCOURING PADS 500,PIECE,5,500,2119,381,2500,July
5189,SCRUBBING BRUSH LONG 5000,PIECE,3,6000,15254,2746,18000,July
5191,SCRUBBING HAND BRUSH 8000,PIECE,1,9000,7627,1373,9000,July
5198,SCRUBING HAND BRUSH 3000,PIECE,1,3500,2966,534,3500,July
5209,SECRETS PADS,PIECE,4,4000,13559,2441,16000,July
5214,SENSITIVE BABY WIPES,PIECE,16,7000,94915,17085,112000,July
5218,SENSODYNE EXTRA FRESH GEL 75ML,PIECE,3,15000,38136,6864,45000,July
5223,SENSODYNE MULTICARE 40MLS,PIECE,7,8000,47458,8542,56000,July
5233,SESACO SOYACUP 150G,PIECE,2,4000,6780,1220,8000,July
5235,SESAME SNACKS,PIECE,11,5000,46610,8390,55000,July
5236,SESAME SNACKS 100G,PIECE,20,2500,42373,7627,50000,July
5250,SHADES 6000,PIECE,1,6000,5085,915,6000,July
5252,SHAKERS 1000,PIECE,1,1000,847,153,1000,July
5259,SHARPENER SMALL,PIECE,2,500,847,153,1000,July
5260,SHARPENERS,PIECE,2,1000,1695,305,2000,July
5264,SHENKE COIL 4500,PIECE,5,4500,19068,3432,22500,July
5265,SHENKE FLOWER REPELLENT,PIECE,2,8000,13559,2441,16000,July
5267,SHENKE LEMON SCENT,PIECE,3,8000,20339,3661,24000,July
5268,SHENKE LOTUS SCENT,PIECE,4,8000,27119,4881,32000,July
5269,SHENKE MOSQUITO COIL,PIECE,2,6000,10169,1831,12000,July
5270,SHENKE MOSQUITO COIL LOW SMOKE,PIECE,1,6000,5085,915,6000,July
5272,SHENKE MOSQUITO REPELLANT,PIECE,5,16000,67797,12203,80000,July
5273,SHENKE MOSQUITO REPELLANT DOUBLE 20000,PIECE,3,22000,55932,10068,66000,July
5274,SHENKE ORANGE,PIECE,5,8000,33898,6102,40000,July
5275,SHENKE REPELLANT ORDOLESS,PIECE,2,8000,13559,2441,16000,July
5281,SHIVA HONEY 250G,PIECE,2,8500,14407,2593,17000,July
5282,SHIVA HONEY 400G,PIECE,1,13000,11017,1983,13000,July
5283,SHIVA HONEY 500G,PIECE,5,13700,58051,10449,68500,July
5284,SHIVA HONEY 80G,PIECE,1,4500,3814,686,4500,July
5287,SHOE BRUSH 5000,PIECE,2,5000,8475,1525,10000,July
5289,SHOE BRUSHES 1500,PIECE,2,1500,2542,458,3000,July
5290,SHOE BRUSHES 2000,PIECE,5,2000,8475,1525,10000,July
5301,SHOWER 2 SHOWER CONFIDENT,PIECE,1,6000,5085,915,6000,July
5302,SHOWER CAPS,PIECE,2,2000,3390,610,4000,July
5308,SHOWER TOSHOWER FRESH MORNING,PIECE,2,6000,10169,1831,12000,July
5313,SHOWERTO SHOWER MUSK ALIVE,PIECE,3,6000,15254,2746,18000,July
5314,SHOWERTOSHOWER FRESH DAWN,PIECE,2,6000,10169,1831,12000,July
5315,SHOWERTOSHOWER FRESH POWDER,PIECE,2,6000,10169,1831,12000,July
5321,SHREEJI BOOK 200PGS,PIECE,2,4000,6780,1220,8000,July
5324,SHREEJI GRAPH BOOK 96,PIECE,1,3000,2542,458,3000,July
5328,SHREEJI SHORTHAND BOOK,PIECE,1,2000,1695,305,2000,July
5331,SHUYA 240 MM,PIECE,4,6000,20339,3661,24000,July
5332,SHUYA 280MM,PIECE,7,6000,35593,6407,42000,July
5333,SHUYA 330MM,PIECE,11,6000,55932,10068,66000,July
5334,SHUYA PANT LINERS,PIECE,6,6000,30508,5492,36000,July
5345,SILKEE DESIGNER SERVIETTES,PIECE,37,2500,78390,14110,92500,July
5347,SILKEE JUMBO TP,PIECE,148,2000,250847,45153,296000,July
5354,SILVER PLATE 1000,PIECE,97,1000,82203,14797,97000,July
5355,SILVER PLATE 300,PIECE,3,300,763,137,900,July
5356,SILVER PLATE 500,PIECE,48,500,20339,3661,24000,July
5360,SIMBA MBILI 100G,PIECE,1,7000,5932,1068,7000,July
5363,SIMBA MBILI 50G,PIECE,2,5500,9322,1678,11000,July
5366,SIMKA CHOC- VAN 300ML,PIECE,11,3500,32627,5873,38500,July
5367,SIMKA CHOCO BAR 100MLS,PIECE,19,2500,40254,7246,47500,July
5368,SIMKA CHOC-VAN 120MLS,PIECE,112,1000,94915,17085,112000,July
5369,SIMKA CHOC-VAN 230MLS,PIECE,52,2000,88136,15864,104000,July
5370,SIMKA CHOC-VANILLA,PIECE,1,10000,8475,1525,10000,July
5371,SIMKA CHOC-VANILLA 500ML,PIECE,22,4500,83898,15102,99000,July
5372,SIMKA MANGO-VAN 120ML,PIECE,1,1000,847,153,1000,July
5373,SIMKA PINE-VANILLA 120ML,PIECE,2,1000,1695,305,2000,July
5374,SIMKA STRAW-VAN 120MLS,PIECE,243,1000,205932,37068,243000,July
5375,SIMKA STRAW-VAN 230MLS,PIECE,143,2000,242373,43627,286000,July
5376,SIMKA STRAW-VAN 300MLS,PIECE,25,3500,74153,13347,87500,July
5377,SIMKA STRAW-VAN 500MLS,PIECE,19,4500,72458,13042,85500,July
5378,SIMKA STRAW-VANILLA,PIECE,1,10000,8475,1525,10000,July
5379,SIMKA VANILLA 120MLS,PIECE,16,1000,13559,2441,16000,July
5380,SIMKA VANILLA 230MLS,PIECE,28,2000,47458,8542,56000,July
5381,SIMKA VANILLA 300MLS,PIECE,4,3500,11864,2136,14000,July
5382,SIMKA VANILLA 500MLS,PIECE,3,4500,11441,2059,13500,July
5387,SKALA ALOEVERA CREAM 200G,PIECE,1,4000,3390,610,4000,July
5390,SKALA CARROT LOTION 400ML,PIECE,2,6000,10169,1831,12000,July
5392,SKALA FOR MEN LOTION 400ML,PIECE,1,6000,5085,915,6000,July
5393,SKALA MEN CREME,PIECE,2,4000,6780,1220,8000,July
5394,SKALA PAPAYA CREAM 200G,PIECE,1,4000,3390,610,4000,July
5399,SKIN CARE 100G,PIECE,2,3000,5085,915,6000,July
5402,SKIN CARE 250G,PIECE,2,6500,11017,1983,13000,July
5408,SKIN DOCTOR HERBAL 250G,PIECE,3,7000,17797,3203,21000,July
5433,SKY VIEW FRUITII 320ML,PIECE,50,1000,42373,7627,50000,July
5435,SKY VIEW ORANGE 320ML,PIECE,53,1000,44915,8085,53000,July
5436,SKYVIEW 320MLS,PIECE,54,1000,45763,8237,54000,July
5438,SKYVIEW ORANGE 500ML,PIECE,3,1500,3814,686,4500,July
5477,SMILE PENS WAVE 500,PIECE,1,500,424,76,500,July
5481,SNICKERS CHOCOLATE,PIECE,8,3500,23729,4271,28000,July
5482,SNOW SPRAYS 4500,PIECE,3,5000,12712,2288,15000,July
5483,SNOWMAN MAKERS,PIECE,2,1000,1695,305,2000,July
5491,SOAP DISH 2000,PIECE,1,2000,1695,305,2000,July
5497,SOAP DISH KENPOLY 1000,PIECE,2,2000,3390,610,4000,July
5508,SOFINE PURE OLIVE OIL 120ML,PIECE,2,7000,11864,2136,14000,July
5513,SOFT BALL 2000,PIECE,1,2000,1695,305,2000,July
5514,SOFT BROOM 10000,PIECE,3,10000,25424,4576,30000,July
5515,SOFT BROOM 15000,PIECE,3,15000,38136,6864,45000,July
5521,SOFT CARE BABY WIPES,PIECE,14,7000,83051,14949,98000,July
5527,SOFTCARE BABY PANTS L40,PIECE,5,27000,114407,20593,135000,July
5528,SOFTCARE BABY PANTS M44,PIECE,1,27000,22881,4119,27000,July
5530,SOFTCARE L40,PIECE,4,25000,84746,15254,100000,July
5531,SOFTCARE M42 GOLD,PIECE,3,25000,63559,11441,75000,July
5536,SOFTCARE PAMPERS S15,PIECE,1,7500,6356,1144,7500,July
5539,SOFTCARE SANITARY PADS,PIECE,23,3000,58475,10525,69000,July
5558,SOSOFT BABY 750MLS,PIECE,1,11000,9322,1678,11000,July
5560,SOSOFT LUXURY 2.5LTR,PIECE,1,29000,24576,4424,29000,July
5566,SOY SAUCE DARK 150G,PIECE,6,5000,25424,4576,30000,July
5567,SOY SAUCE DARK 500G,PIECE,10,10000,84746,15254,100000,July
5568,SOY SAUCE LIGHT 150G,PIECE,1,5000,4237,763,5000,July
5569,SOY SAUCE LIGHT 500G,PIECE,1,10000,8475,1525,10000,July
5574,SPARKLING CANDLES 8000,PIECE,4,7000,23729,4271,28000,July
5575,SPARKLING CANDLES 9000,PIECE,1,8000,6780,1220,8000,July
5589,SPIRAL NOTE BOOK 70S,PIECE,1,4500,3814,686,4500,July
5591,SPLASH APPLE 1LTR,PIECE,23,8000,155932,28068,184000,July
5592,SPLASH APPLE 250MLS,PIECE,72,2000,122034,21966,144000,July
5593,SPLASH APPLES 150ML,PIECE,11,1500,13983,2517,16500,July
5594,SPLASH BOX 42000,BOX,1,45000,38136,6864,45000,July
5602,SPLASH MANGO 150ML,PIECE,37,1500,47034,8466,55500,July
5603,SPLASH MANGO 250MLS,PIECE,98,2000,166102,29898,196000,July
5604,SPLASH MANGO JUICE 1LTR,PIECE,25,8000,169492,30508,200000,July
5609,SPONGE 2000,PIECE,4,2000,6780,1220,8000,July
5610,SPONGE 3000,PIECE,5,3000,12712,2288,15000,July
5611,SPONGE 4000,PIECE,3,4000,10169,1831,12000,July
5613,SPONGES 2500,PIECE,2,2500,4237,763,5000,July
5619,SPOONS 5000,PIECE,2,5000,8475,1525,10000,July
5621,SPOONS 8000/ FORKS ,PIECE,1,8000,6780,1220,8000,July
5624,SPRING FILE 3000,PIECE,8,3000,20339,3661,24000,July
5625,SPRITE 2LTR,PIECE,27,5000,114407,20593,135000,July
5626,SPRITE 350MLS,PIECE,73,1000,61864,11136,73000,July
5627,SPRITE 500MLS,PIECE,39,1500,49576,8924,58500,July
5628,SPRITE ZERO 350ML,PIECE,1,1000,847,153,1000,July
5630,SQUEEZERS 5000,PIECE,1,5000,4237,763,5000,July
5631,SQUEEZERS DOULBLE 10000,PIECE,1,10000,8475,1525,10000,July
5633,SQUISHY BLUE RASBERRY 200ML,PIECE,24,2000,40678,7322,48000,July
5634,SQUISHY FRUIT DRINK 200ML,PIECE,45,2000,76271,13729,90000,July
5635,SQUISHY FRUIT DRINK MANGO 200ML,PIECE,44,2000,74576,13424,88000,July
5638,SSCHOOL SOCKS WHITE,PIECE,1,3000,2542,458,3000,July
5656,STA-SOFT LAVENDER 750ML,PIECE,2,13000,22034,3966,26000,July
5658,STA-SOFT SPRING FRESH 750MLS,PIECE,1,13000,11017,1983,13000,July
5671,STING,PIECE,34,2000,57627,10373,68000,July
5672,STING RED RUSH,PIECE,28,2000,47458,8542,56000,July
5673,STONEY 350MLS,PIECE,27,1000,22881,4119,27000,July
5674,STONEY 500MLS,PIECE,28,1500,35593,6407,42000,July
5693,STRAWBERRY PRADIP COLORED,PIECE,1,5000,4237,763,5000,July
5717,SUGAR 1KG,PIECE,45,5200,198305,35695,234000,July
5724,SULFO GLYCERINE COLORLESS,PIECE,9,2167,16525,2975,19500,July
5725,SULFO GLYCERINE PINK,PIECE,5,2400,10169,1831,12000,July
5726,SULTAN COCONUT HAIL OIL,PIECE,1,5000,4237,763,5000,July
5730,SUMZ COATED PEANUT 50G,PIECE,11,1200,11186,2014,13200,July
5731,SUMZ COCONUT COOKIES,PIECE,6,4000,20339,3661,24000,July
5733,SUMZ CHOCOLATE COOKIES 200G,PIECE,6,4000,20339,3661,24000,July
5735,SUMZ CORN CRAX 160G,PIECE,13,3000,33051,5949,39000,July
5736,SUMZ CORN CRAX 80G,PIECE,12,1500,15254,2746,18000,July
5739,SUMZ CRISPS CHILLI 60G,PIECE,19,3000,48305,8695,57000,July
5741,SUMZ CRISPS FRUIT CHUTNEY,PIECE,10,1500,12712,2288,15000,July
5743,SUMZ CRUNCHY DADDIES 150G,PIECE,8,3000,20339,3661,24000,July
5744,SUMZ DADDIES 75G 1000,PIECE,30,1500,38136,6864,45000,July
5746,SUMZ GINGER COOKIES,PIECE,5,4000,16949,3051,20000,July
5748,SUMZ GONJA 40G,PIECE,86,1500,109322,19678,129000,July
5749,SUMZ GONJA 90G CRISPS,PIECE,56,3000,142373,25627,168000,July
5750,SUMZ GONJA CRISPS 160G,PIECE,15,5500,69915,12585,82500,July
5753,SUMZ POTATO CRISP BBQ 30G,PIECE,24,1500,30508,5492,36000,July
5754,SUMZ POTATO CRISPS 180G,PIECE,20,5475,92797,16703,109500,July
5755,SUMZ POTATO CRISPS 20G,PIECE,388,600,197288,35512,232800,July
5756,SUMZ POTATO CRISPS 40G,PIECE,289,1500,367373,66127,433500,July
5757,SUMZ POTATO CRISPS 90G,PIECE,114,3000,289831,52169,342000,July
5758,SUMZ POTATO CRISPS TASTY TOMATO12G,PIECE,26,600,13220,2380,15600,July
5761,SUMZ ROASTED NUTS 120G,PIECE,28,3000,71186,12814,84000,July
5763,SUMZ ROASTED NUTS 60G,PIECE,23,1500,29237,5263,34500,July
5764,SUMZ SALT&VINEGAR 30G,PIECE,22,1500,27966,5034,33000,July
5766,SUMZ TANGY LEMON CRISPS 30G,PIECE,16,1500,20339,3661,24000,July
5767,SUMZS CRISPS 500G,PIECE,3,12000,30508,5492,36000,July
5773,SUN SIP PASSION 3LTR,PIECE,2,16000,27119,4881,32000,July
5778,SUNLIGHT DISH PASTE,PIECE,6,6000,30508,5492,36000,July
5780,SUNLIGHT DISHWASHING PASTE,PIECE,1,9000,7627,1373,9000,July
5781,SUNLIGHT DISHWASHING PASTE 800G,PIECE,2,12000,20339,3661,24000,July
5785,SUNLIGHT LAVENDER 3.5KG,PIECE,2,34500,58475,10525,69000,July
5786,SUNLIGHT LAVENDER 500G,PIECE,1,5500,4661,839,5500,July
5792,SUNLIGHT SOAP 175G,PIECE,2,2500,4237,763,5000,July
5793,SUNLIGHT SPRING 3.5KG,PIECE,1,34000,28814,5186,34000,July
5794,SUNLIGHT SPRING IKG,PIECE,3,11000,27966,5034,33000,July
5795,SUNLIGHT SPRING SENSATIONS 500G,PIECE,2,5500,9322,1678,11000,July
5796,SUNLIGHT TROPICAL 1KG,PIECE,2,11000,18644,3356,22000,July
5798,SUNLIGHT TROPICAL 500G,PIECE,5,5500,23305,4195,27500,July
5802,SUNSEED OIL 1LTRS,PIECE,2,12000,20339,3661,24000,July
5803,SUNSEED OIL 2LTRS,PIECE,4,23000,77966,14034,92000,July
5804,SUNSEED OIL 3LTRS,PIECE,5,28000,118644,21356,140000,July
5805,SUNSEED OIL 5LTRS,PIECE,1,45000,38136,6864,45000,July
5807,SUNSHINE BEEF FLAVOR,PIECE,206,500,87288,15712,103000,July
5808,SUNSHINE CHICKEN FLAVOR,PIECE,88,500,37288,6712,44000,July
5809,SUNSHINE ONION FLAVOR,PIECE,142,500,60169,10831,71000,July
5810,SUNSHINE PLAIN FLAVOR,PIECE,138,500,58475,10525,69000,July
5811,SUNSHINE TOMATO FLAVOR,PIECE,143,500,60593,10907,71500,July
5814,SUNSIP APPLE 5LTR,PIECE,3,24000,61017,10983,72000,July
5815,SUNSIP BLACKCURRANT 3LTR,PIECE,1,16000,13559,2441,16000,July
5816,SUNSIP BLACKCURRANT 5LTR,PIECE,1,24000,20339,3661,24000,July
5818,SUNSIP MANGO 3LTRS,PIECE,2,16000,27119,4881,32000,July
5823,SUNSIP STRAWBERRY 5LTRS,PIECE,2,24000,40678,7322,48000,July
5829,SUNVEAT CREAMY ORANGE,PIECE,14,1500,17797,3203,21000,July
5844,SUPER GLUE,PIECE,2,1000,1695,305,2000,July
5852,SUPREME BAKING FLOUR,PIECE,1,9000,7627,1373,9000,July
5859,SWEET IVORY PCS,PIECE,3,100,254,46,300,July
5864,SWEET PEPSI,PIECE,47,100,3983,717,4700,July
5865,SWEET PEPSI PKT 2000,PIECE,1,2000,1695,305,2000,July
5875,SWEETS 100,PIECE,187,100,15847,2853,18700,July
5876,SWEETS 1000,PIECE,9,1000,7627,1373,9000,July
5877,SWEETS 1500 ICECREAMM LOLLIPOP,PIECE,2,1500,2542,458,3000,July
5878,SWEETS 200,PIECE,132,200,22373,4027,26400,July
5879,SWEETS 300,PIECE,34,300,8644,1556,10200,July
5881,SWEETS 500,PIECE,253,500,107203,19297,126500,July
5882,SWEETS 700 BIG FIVE,PIECE,31,700,18390,3310,21700,July
5903,SWT BASMATI 1KG BLUE,PIECE,1,15000,12712,2288,15000,July
5906,SWT LONG GRAIN 5KG/JASONS 5KG,PIECE,1,43000,36441,6559,43000,July
5909,SWT-1 RICE 1KG GREEN,PIECE,3,7500,19068,3432,22500,July
5923,TABLE KNIFE PIECES 3000,PIECE,2,3000,5085,915,6000,July
5964,TEEPEE BRUSH A9,PIECE,1,3000,2542,458,3000,July
5978,TEMMY'S CORNFLAKES 1KG,PIECE,1,30000,25424,4576,30000,July
5979,TEMMY'S CORNFLAKES 250G,PIECE,5,10000,42373,7627,50000,July
5980,TEMMY'S CORNFLAKES 500G,PIECE,6,16000,81356,14644,96000,July
5999,TIAMO SWEETS,PIECE,5,200,847,153,1000,July
6011,TIGER HEAD AA,PIECE,2,1000,1695,305,2000,July
6041,TOCEBA AAA,PIECE,3,900,2288,412,2700,July
6042,TOCEBAL AA,PIECE,11,1000,9322,1678,11000,July
6043,TODAY WAFFERS,PIECE,1,1500,1271,229,1500,July
6045,TOILET BLUE BLOCKS 4PCS,PIECE,4,7500,25424,4576,30000,July
6049,TOILET BRUSH TEEPEE10000,PIECE,6,10000,50847,9153,60000,July
6050,TOILET BRUSHES 12000,PIECE,1,12000,10169,1831,12000,July
6057,TOMDECA VESTS,PIECE,1,28000,23729,4271,28000,July
6068,TOOTHPICK 1000,PIECE,3,1000,2542,458,3000,July
6101,TOP UP 400G,PIECE,20,2000,33898,6102,40000,July
6102,TOP UP 700G,PIECE,7,3500,20763,3737,24500,July
6103,TOP UP CHILL 260G,PIECE,6,2000,10169,1831,12000,July
6144,TOWELS 33000,PIECE,1,33000,27966,5034,33000,July
6185,TROPICAL HEAT BEEF MASALA 100G,PIECE,2,5000,8475,1525,10000,July
6186,TROPICAL HEAT BLACK PEPPER 100G,PIECE,2,8500,14407,2593,17000,July
6187,TROPICAL HEAT BLACK PEPPER 50G,PIECE,2,5500,9322,1678,11000,July
6190,TROPICAL HEAT CINNAMON 50G,PIECE,5,4500,19068,3432,22500,July
6197,TROPICAL HEAT FISH MASALA 100G,PIECE,2,5000,8475,1525,10000,July
6200,TROPICAL HEAT GARLIC POWDER 50G,PIECE,4,4500,15254,2746,18000,July
6203,TROPICAL HEAT MEAT TENDERISER50G,PIECE,4,4000,13559,2441,16000,July
6209,TROPICAL HEAT PILAU MASALA 100G,PIECE,4,11000,37288,6712,44000,July
6210,TROPICAL HEAT PILAU MASALA 50G,PIECE,4,6000,20339,3661,24000,July
6215,TROPICAL HEAT TEA MASALA 100G,PIECE,3,10000,25424,4576,30000,July
6216,TROPICAL HEAT TEA MASALA 45G,PIECE,1,5000,4237,763,5000,July
6217,TROPICAL HEAT TURMERIC 100G,PIECE,1,7500,6356,1144,7500,July
6218,TROPICAL HEAT TURMERIC 50G,PIECE,4,3500,11864,2136,14000,July
6221,TROPICAL MINT SWEETS,PIECE,10,200,1695,305,2000,July
6227,TROPIKAL WILD MUSK A.F,PIECE,1,12000,10169,1831,12000,July
6233,TRUCK CAR 15000,PIECE,1,15000,12712,2288,15000,July
6268,U.S.A BEAUTY SOAP BLACK,PIECE,4,6500,22034,3966,26000,July
6272,UBISCO CREAMS VANILLA,PIECE,2,1000,1695,305,2000,July
6280,UBISCO KREAMY CREAMS STRAWBERRY,PIECE,3,1000,2542,458,3000,July
6288,U-FRESH MANGO,PIECE,7,700,4153,747,4900,July
6290,UGACHICK DRUMSTICK WHOLE 500G,PIECE,2,13000,22034,3966,26000,July
6292,UGACHICK FAMILY PACK 2KG,PIECE,1,42000,35593,6407,42000,July
6296,UGACHICK LIVER 500G,PIECE,1,4600,3898,702,4600,July
6300,UGACHICK THIGHS 500G,PIECE,2,13000,22034,3966,26000,July
6301,UGACHICK WINGS 500G,PIECE,2,13000,22034,3966,26000,July
6304,UGANDA SAFARI TEA 100G,PIECE,6,3500,17797,3203,21000,July
6306,UGANDA SAFARI TEA 500G,PIECE,1,11000,9322,1678,11000,July
6307,UGANDA TEA BAGS,PIECE,3,5500,13983,2517,16500,July
6310,UKWAJU,PIECE,63,1500,80085,14415,94500,July
6314,ULTRASONIC PEST REPELLER,PIECE,1,15000,12712,2288,15000,July
6318,UMBRELLAS 8000,PIECE,2,8000,13559,2441,16000,July
6322,UMOJA SANDALS 6000,PIECE,1,7000,5932,1068,7000,July
6323,UMOJA SANDALS 8000,PIECE,3,9333,23729,4271,28000,July
6334,URBAN GWEKE 350G,PIECE,11,6318,58898,10602,69500,July
6398,VASELINE ALOESOOTHE LOTION 400ML,PIECE,1,14500,12288,2212,14500,July
6401,VASELINE BLUESEAL COCOA BUTTER250ML,PIECE,1,9500,8051,1449,9500,July
6404,VASELINE BLUESEAL MEN FRESH 100ML,PIECE,7,5000,29661,5339,35000,July
6406,VASELINE BLUESEAL ORIGINAL 250ML,PIECE,6,9500,48305,8695,57000,July
6411,VASELINE COCOAGLOW LOTION 400G radiant,PIECE,3,14500,36864,6636,43500,July
6412,VASELINE DRY SKIN REPAIR 200ML,PIECE,4,8000,27119,4881,32000,July
6413,VASELINE DRY SKIN REPAIR LOTION 400ML,PIECE,1,15000,12712,2288,15000,July
6422,VASELINE MEN COOLING JELLY 240ML,PIECE,7,9500,56356,10144,66500,July
6423,VASELINE MEN COOLING LOTION 200ML,PIECE,1,8000,6780,1220,8000,July
6424,VASELINE MEN EXTRA HYDRATION,PIECE,2,14500,24576,4424,29000,July
6427,VASELINE MEN JELLY FRESH 240ML,PIECE,2,9500,16102,2898,19000,July
6450,VESTLINE ALOEVERA 400ML,PIECE,1,6500,5508,992,6500,July
6451,VESTLINE ALOEVERA CREAM,PIECE,2,4000,6780,1220,8000,July
6458,VICTAN SINGLE VEST,PIECE,1,5000,4237,763,5000,July
6460,VICTOR BODY CREAM 250,PIECE,4,5000,16949,3051,20000,July
6461,VICTOR CREME 120G,PIECE,1,2500,2119,381,2500,July
6464,VIGOS HAZELNUT CHOCOLATE 800,PIECE,4,800,2712,488,3200,July
6468,VIM LAVENDER 1KG,PIECE,2,8000,13559,2441,16000,July
6469,VIM LAVENDER 500G,PIECE,4,5000,16949,3051,20000,July
6470,VIM LEMON 1KG,PIECE,5,8000,33898,6102,40000,July
6471,VIM LEMON FRESH 500G,PIECE,5,5000,21186,3814,25000,July
6474,VINEGAR WHITE 700MLS,PIECE,2,2500,4237,763,5000,July
6496,WANDAZ PETROLEUM JELLY 250G,PIECE,1,6000,5085,915,6000,July
6497,WANDAZ PETROLEUM JELLY 500G,PIECE,1,11500,9746,1754,11500,July
6520,WATER GUN TOYS 20000,PIECE,1,20000,16949,3051,20000,July
6529,WATERGUN 10000,PIECE,2,10000,16949,3051,20000,July
6533,WEET CORNFLAKES 750G,PIECE,1,22000,18644,3356,22000,July
6534,WEETABIX 112G,PIECE,4,4500,15254,2746,18000,July
6535,WEETABIX 225G,PIECE,6,8500,43220,7780,51000,July
6537,WEETABIX 450G,PIECE,5,15500,65678,11822,77500,July
6557,WELLICE SHOWER GEL OLIVE OIL 1LTR,PIECE,1,23000,19492,3508,23000,July
6559,WHAT'S UP 320ML,PIECE,1,1000,847,153,1000,July
6564,WHISPPEX SHAVERS,PIECE,4,3125,10593,1907,12500,July
6568,WHITE CHALK 5000,PIECE,3,5000,12712,2288,15000,July
6572,WHITE STAR SOAP 1KG,PIECE,61,6500,336017,60483,396500,July
6573,WHITE VINEGAR,PIECE,5,2500,10593,1907,12500,July
6579,WHITEDENT HERBAL 110G,PIECE,3,5000,12712,2288,15000,July
6580,WHITEDENT HERBAL 190G,PIECE,3,6500,16525,2975,19500,July
6581,WHITEDENT HERBAL 250G,PIECE,4,8000,27119,4881,32000,July
6583,WHITEDENT HERBAL 70G,PIECE,3,3000,7627,1373,9000,July
6588,WIG CAP HAIR NET,PIECE,1,1500,1271,229,1500,July
6606,WRAPPERS 500,PIECE,11,500,4661,839,5500,July
6607,WRAPPING PAPER 1000,PIECE,3,1000,2542,458,3000,July
6613,YAKET 550ML,PIECE,122,500,51695,9305,61000,July
6618,YARRISON BOXERS 3PCS 22000,PIECE,2,22000,37288,6712,44000,July
6619,YARRISON UNDER SHIRT 30000,PIECE,1,35000,29661,5339,35000,July
6620,YARRISON VESTS 3PCS 27000,PIECE,1,27000,22881,4119,27000,July
6642,YOJUS APPLE DRINK,PIECE,22,1000,18644,3356,22000,July
6643,YOJUS MANGO 150ML,PIECE,19,1000,16102,2898,19000,July
6650,YOUR CHOICE SAUSAGE 1KG,PIECE,1,30000,25424,4576,30000,July
6651,YOUR CHOICE SAUSAGES 500G,PIECE,5,17000,72034,12966,85000,July
6665,ZESTA 300 G,PIECE,1,7500,6356,1144,7500,July
6666,ZESTA 500G,PIECE,1,10500,8898,1602,10500,July
6674,ZESTA STRAWBERRY JAM,PIECE,4,10625,36017,6483,42500,July
6676,ZESTA TOMATO KETCHUP,PIECE,11,7000,65254,11746,77000,July
6677,ZESTA TOMATO KETCHUP 700G,PIECE,3,12000,30508,5492,36000,July
6695,JAMIES CAKE SLICE @6k,PIECE,5,6000,25424,4576,30000,July
6697,OFFICE PIN DL121,PIECE,1,1500,1271,229,1500,July
6698,SOFINE GENLESE ROSE NOURISH 1L,PIECE,1,22000,18644,3356,22000,July
6700,DOVE NOURISHING SECRETS RELAXING RITUAL 750ML,PIECE,1,30000,25424,4576,30000,July
6707,VASELINE BLUESEAL MEN COOLING 95ML,PIECE,8,5000,33898,6102,40000,July
6708,VASELINE BLUESEAL BABY 95ML,PIECE,3,5000,12712,2288,15000,July
6709,VASELINE BLUESEAL JELLY ORIGINAL 95ML,PIECE,1,5000,4237,763,5000,July
6710,VASELINE BLUESEAL COCOA BUTTER 95ML,PIECE,3,5000,12712,2288,15000,July
6711,NIVEA RICH NOURISHING 200ML,PIECE,1,14000,11864,2136,14000,July
6723,BRITANIA GINGER BISCUITS 1KG,PIECE,2,20000,33898,6102,40000,July
6724,US MUSTARD 227G-8000,PIECE,1,8000,6780,1220,8000,July
6765,BIRTHDAY CANDLE 2K,PIECE,4,2000,6780,1220,8000,July
6770,SUNLIGHT SPRING 2KG,PIECE,1,20000,16949,3051,20000,July
6773,VEGETABLE SAMOSA 1000,PIECE,199,1000,168644,30356,199000,July
6775,CHAPS 3000,PIECE,277,3000,704237,126763,831000,July
6776,KEBAB 3000,PIECE,90,3000,228814,41186,270000,July
6778,PILAO PLAIN 5000,PIECE,14,4700,55763,10037,65800,July
6779,PILAO PLAIN 10000,PIECE,260.86,9985,2207288,397312,2604600,July
6780,CHIPS PLAIN 5000,PIECE,5,3240,13729,2471,16200,July
6781,VEGETABLE RICE 7000,PIECE,238.12,6964,1405381,252969,1658350,July
6782,CHICKEN STEW 8000,PIECE,1,4000,3390,610,4000,July
6784,LIVER STEW 8000,PIECE,122.82,7725,803983,144717,948700,July
6787,VEGETABLE RICE 3500,PIECE,10,3920,33220,5980,39200,July
6788,BEEF SAUSAGES 1000,PIECE,1641,1000,1390678,250322,1641000,July
6790,KATOGO 4000,PIECE,258.55,3977,871424,156856,1028280,July
6792,CHIPS 2500,PIECE,511.96,2510,1089153,196047,1285200,July
6793,LIVER 4000,PIECE,2,2500,4237,763,5000,July
6794,KATOGO 2500,PIECE,5,2800,11864,2136,14000,July
6795,KATOGO 2000,PIECE,5,2000,8475,1525,10000,July
6798,CADBURY DAIRY MILK 35G,PIECE,30,4000,101695,18305,120000,July
6799,SPRING ROLLS VEGETABLE 1000,PIECE,43,1000,36441,6559,43000,July
6805,PANCAKES 500,PIECE,443,500,187712,33788,221500,July
6807,BEAN STEW 2000,PIECE,214.48,1986,360915,64965,425880,July
6808,CRACKERS 1500,PIECE,212,2000,359322,64678,424000,July
6812,BEEF STEW 6000,PIECE,490,2000,830508,149492,980000,July
6813,GRILLED CHICKEN 7000,PIECE,161,7000,955085,171915,1127000,July
6816,BLUE BAND 250G,PIECE,16,5000,67797,12203,80000,July
6820,BEEF SAMOSA 1500,PIECE,346,1500,439831,79169,519000,July
6821,CHAPATI 1000,PIECE,2515,1000,2131356,383644,2515000,July
6825,TROPIKAL AIR FRESHNER VANILLA 300ML,PIECE,3,12000,30508,5492,36000,July
6831,JESA MIXED BERRY YOGHURT 250G,PIECE,16,2500,33898,6102,40000,July
6840,GONJA FRIED 1000,PIECE,240.5,1015,206780,37220,244000,July
6841,PIZZA CHICKEN SLICE BIG ,PIECE,166,6000,844068,151932,996000,July
6847,PIZZA 14'' CHICKEN ,PIECE,1,25000,21186,3814,25000,July
6848,PIZZA 16'' CHICKEN ,PIECE,7,35000,207627,37373,245000,July
6859,ROLEX NORMAL 2EGGS,PIECE,53,2500,112288,20212,132500,July
6868,SPAGHETI 2500,PIECE,237.08,2487,499746,89954,589700,July
6871,POSHO KG,PIECE,13.56,5049,58017,10443,68460,July
6876,"GREENS (NAKATI,DODO ETC)",PIECE,32.08,5786,157305,28315,185620,July
6885,JAGO SCRUB 110G,PIECE,4,4000,13559,2441,16000,July
6887,JESA BLUEBERRY FRUIT YOGHURT 450G,PIECE,8,6000,40678,7322,48000,July
6888,JAMIES CAKE @20k,PIECE,1,25000,21186,3814,25000,July
6889,EGGS BOILED 500,PIECE,618,500,261864,47136,309000,July
6892,RAHA DRINKING CHOCOLATE 10G,PIECE,4,500,1695,305,2000,July
6894,SQUISHY JUICE APPLE,PIECE,43,2000,72881,13119,86000,July
6921,ZENDEN PLASTIC PLAYING CARDS ,PIECE,5,5000,21186,3814,25000,July
6930,JINYI EAR BUDS 1000,PIECE,3,1167,2966,534,3500,July
6935,SHREEJI 96 PAGES A4 ,PIECE,4,2000,6780,1220,8000,July
6936,JESA MIXED BERRY YOGHURT 500G,PIECE,20,3700,62712,11288,74000,July
6940,JAMIES CAKE @100k,PIECE,1,100000,84746,15254,100000,July
6943,SUMZ POTATO CRISPS FRUIT CHUTNEY 12G,PIECE,25,600,12712,2288,15000,July
6953,STRIKE NUTS CHOCOLATE BAR,PIECE,12,1417,14407,2593,17000,July
6960,NAN GUEST BATHING SOAP,PIECE,6,4000,20339,3661,24000,July
6961,STAR COFFEE 100G TIN,PIECE,1,17000,14407,2593,17000,July
6970,YAM SLICE 1000,PIECE,159,1000,134746,24254,159000,July
6971,SWEET POTATOES BOILED 1000,PIECE,201,1000,170339,30661,201000,July
6976,SUMZ POTATO CRIPS TASTY TOMATO 30G,PIECE,47,1500,70500,0,70500,July
6987,DOMS CUBOID PEN ,PIECE,7,700,4153,747,4900,July
6988,ELITE BALL PENS 500,PIECE,18,500,7627,1373,9000,July
6990,PAPERLINE SHORTHAND NOTEBOOK,PIECE,1,2000,1695,305,2000,July
6993,DOMS WAX CRAYONS BIG,PIECE,1,5000,4237,763,5000,July
7000,MASTER MATH SET A006 5000,PIECE,5,5000,21186,3814,25000,July
7002,M&G OFFICE SCISSORS 190MM,PIECE,2,6500,11017,1983,13000,July
7015,JESA STRAWBERRY&CHOCOLATE 450G,PIECE,7,6000,35593,6407,42000,July
7026,CHICKEN STEW 4000,PIECE,260,4000,881356,158644,1040000,July
7040,BUCKETS 4000 1LTR,PIECE,1,4000,3390,610,4000,July
7065,BRITANIA SWEET MEAL BISCUITS,PIECE,1,2500,2119,381,2500,July
7073,SUMZ TANGY LEMON CRISPS 12G,PIECE,28,600,14237,2563,16800,July
7077,VASELINE BLUESEAL ALOEVERA 95ML,PIECE,8,5000,33898,6102,40000,July
7078,VASELINE BLUESEAL ALOEVERA 240ML,PIECE,1,9500,8051,1449,9500,July
7089,JAMIES WHITE SALT BREAD 500G,PIECE,1,3000,2542,458,3000,July
7101,JAMIES DADDIES TIN 17000,PIECE,16,17000,230508,41492,272000,July
7102,JAMIES DADDIES TIN 20000,PIECE,1,20000,16949,3051,20000,July
7112,PUMPKIN SLICE 1000,PIECE,145,1000,122881,22119,145000,July
7114,NESCAFE GOLD BLEND 95G,PIECE,1,40000,33898,6102,40000,July
7115,CLAIRMEN CREAM 300ML,PIECE,1,14000,11864,2136,14000,July
7120,JAMIES DADDIES 500G 10000,PIECE,10,10000,84746,15254,100000,July
7130,JAMIES MUFFINS 2000,PIECE,122,2000,206780,37220,244000,July
7137,JAMIES COOKIES 2000,PIECE,6,2000,10169,1831,12000,July
7139,SUMZ BBQ CRISPS 12G,PIECE,12,600,6102,1098,7200,July
7142,JAMIES MARBLE CAKE 3000,PIECE,225,3000,572034,102966,675000,July
7143,GRAVY SOUP 1000,PIECE,120.06,1020,103814,18686,122500,July
7144,JAMIES DOUGHNUT BIG CHOCOLATE 2500,PIECE,77,2500,163136,29364,192500,July
7146,JAMIES COOKIES TIN 500G 10000,PIECE,9,10000,76271,13729,90000,July
7147,JAMIES COOKIES 800G TIN 17000,PIECE,8,17000,115254,20746,136000,July
7153,INNOCENCE BODY SPRAY ,PIECE,1,12000,10169,1831,12000,July
7155,CA DREAMZ PINK SPRAY,PIECE,1,10000,8475,1525,10000,July
7159,ADIDAS CHAMPIONS LEAGUE SPRAY,PIECE,1,13000,11017,1983,13000,July
7163,SPIDERMAN SWEETS 700,PIECE,3,700,1780,320,2100,July
7164,NUTRO ORANGE BISCUIT 1200,PIECE,27,1200,27458,4942,32400,July
7165,ONER APPLE DRINK 1LTR,PIECE,19,5000,80508,14492,95000,July
7168,SPLASH TROPICAL FRUIT PUNCH 1LTR,PIECE,5,8000,33898,6102,40000,July
7172,HIGHLAND TEA 50G,PIECE,1,2500,2119,381,2500,July
7173,D.L FIESTA WHITE 70ML,PIECE,9,3000,22881,4119,27000,July
7174,JAMIES LIQUID SOAP 5LTR 10000,PIECE,4,10000,33898,6102,40000,July
7239,BEEF PILAU 20000,PIECE,8,5075,34407,6193,40600,July
7243,PLAIN WHITE RICE 8000,PIECE,3,3500,8898,1602,10500,July
7259,PLAIN CHIPS 7000,PIECE,9,4244,32373,5827,38200,July
7270,FRIED EGGS 5000,PIECE,2,2000,3390,610,4000,July
7278,JUICE 2000 300ML,PIECE,73,2000,123729,22271,146000,July
7279,JUICE 4000 500ml,PIECE,38,4000,128814,23186,152000,July
7284,SUMZ SALT& VIEGAR,PIECE,33,600,16780,3020,19800,July
7296,BANANA JUICE 3000,PIECE,5,3000,12712,2288,15000,July
7306,MAVAL GIRL PANTY LINERS,PIECE,1,2500,2119,381,2500,July
7307,PRADIP PASSION 5000 50ML,PIECE,1,5000,4237,763,5000,July
7308,COTTON EAR SWABS 4000,PIECE,4,4000,13559,2441,16000,July
7330,SUMZ GONJA CRISP 400G,PIECE,2,12000,20339,3661,24000,July
7337,LUX PREMIUMS MENS UNDER WEAR,PIECE,1,16000,13559,2441,16000,July
7339,SOFTCARE GOLD S48,PIECE,2,25000,42373,7627,50000,July
7346,LED TOUCH,PIECE,1,4000,3390,610,4000,July
7349,BODY SCRUBBER GLOVE,PIECE,4,2500,8475,1525,10000,July
7373,VASELINE BLUESEAL BABY 240ML,PIECE,2,9500,16102,2898,19000,July
7374,JAMIES WHOLE SALE SWEET YELLOW 5000,PIECE,88,5000,372881,67119,440000,July
7375,JAMIES WHOLE SALE SWEET BROWN 5000,PIECE,60,5000,254237,45763,300000,July
7376,JAMIES WHOLE SALE SWEET WHITE 5000,PIECE,86,5000,364407,65593,430000,July
7378,SUMZ COATED PEANUTS CHILLI MASALA 150G,PIECE,10,3300,27966,5034,33000,July
7379,SUMZ COATED PEANUTS PLAINMASALA 150G,PIECE,5,3000,12712,2288,15000,July
7380,AFROCARE PERFUMED JELLY 500G,PIECE,1,10000,8475,1525,10000,July
7382,RIGGS PATROL BODY SPRAY 250ML,PIECE,1,16000,13559,2441,16000,July
7383,MOVIT BABY JELLY 200G,PIECE,2,5000,8475,1525,10000,July
7387,HB PENCILS,PIECE,1,1500,1271,229,1500,July
7388,HIKMA YELLOW BAGIYA 4000,PIECE,5,4500,19068,3432,22500,July
7389,HIKMA YELLOW BAGIYA 2000,PIECE,11,1500,13983,2517,16500,July
7390,HIKMA BAGIYA 1500,PIECE,1,1500,1271,229,1500,July
7391,HIKMA BAGIYA 2500,PIECE,13,2654,29237,5263,34500,July
7392,HIKMA DADDIES 5000,PIECE,2,5000,8475,1525,10000,July
7393,HIKMA DADDIES 2000,PIECE,17,2500,36017,6483,42500,July
7394,HIKMA G.NUTS 3000,PIECE,21,2000,35593,6407,42000,July
7396,JAMIES SWEET WHITE WHOLESALE 500G 2500,PIECE,90,2500,190678,34322,225000,July
7397,JAMIES SWEET YELLOW 500G WHOLE SALE 2500,PIECE,90,2500,190678,34322,225000,July
7398,JAMIES SWEET BROWN 500G WHOLE SALE 2500,PIECE,91,2500,192797,34703,227500,July
7400,NUTRO DIGESTIVE LIGHT 400G,PIECE,1,13000,11017,1983,13000,July
7404,MELEX SIMSIM BALLS 250G,PIECE,7,5000,29661,5339,35000,July
7406,COLGATE TOOTHBRUSH 6+,PIECE,3,6000,15254,2746,18000,July
7410,ONER TAMARIND 500ML,PIECE,76,2500,161017,28983,190000,July
7411,PAMPERS PANTS 6,PIECE,2,40000,67797,12203,80000,July
7413,AMERICAN CROWN SHOWER GEL COCONUT JOY 1000ML,PIECE,1,23000,19492,3508,23000,July
7421,JAMIES COOKIES 300G 7000,PIECE,2,7000,11864,2136,14000,July
7426,JAMIES SWEET CAKE BREAD WHOLESALE 5000,PIECE,3,5000,12712,2288,15000,July
7427,COLGATE CLEAN MINT 10500,PIECE,4,10500,35593,6407,42000,July
7429,TROPICAL HEAT PAPRIKA SPICE 100G,PIECE,3,6000,15254,2746,18000,July
7430,JAMIES SWEET YELLOW BUNS WHOLESALE 2500,PIECE,269,2500,569915,102585,672500,July
7431,JAMIES MARBLE CAKE 10000,PIECE,2,15000,25424,4576,30000,July
7432,FRESCO BODY OIL 100ML 4000,PIECE,4,4500,15254,2746,18000,July
7434,FANTA CAN 330ML 3000,PIECE,1,3000,2542,458,3000,July
7438,YARRISON KIDS VESTS18000,PIECE,1,26000,22034,3966,26000,July
7473,ARTIN MASSAGE OIL OLIVE OIL 1LTR,PIECE,1,13000,11017,1983,13000,July
7476,MENTOS MINT 29G,PIECE,6,2500,12712,2288,15000,July
7486,APPLES PACKED 11000,PIECE,6,11000,55932,10068,66000,July
7489,HAPPY TIME WATER GAME 10000,PIECE,1,10000,8475,1525,10000,July
7490,BIRTHDAY CANDLES STAR 4000,PIECE,1,4000,3390,610,4000,July
7492,CS MUKENESNACK 100G 3500,PIECE,1,6000,5085,915,6000,July
7494,FRUIT VILLE TROPICAL,PIECE,7,3500,20763,3737,24500,July
7497,JAMIES SWEET BUNS BROWN 6PCS WHOLESALE,PIECE,158,2500,334746,60254,395000,July
7498,JAMIES SWT WHITE BUNS 6PCS WHOLESALE,PIECE,153,2500,324153,58347,382500,July
7517,SEDUCTION SPRAY,PIECE,1,12000,10169,1831,12000,July
7519,VERSMAN MILLIONAIRE MEN 200ML,PIECE,1,9500,8051,1449,9500,July
7522,JUST WOW 250ML,PIECE,2,15000,25424,4576,30000,July
7524,TOYS 2000,PIECE,4,2000,6780,1220,8000,July
7526,DOCTORS KIT DOLL 20000,PIECE,1,19998,16947,3051,19998,July
7527,BALLS 2000,PIECE,1,2000,1695,305,2000,July
7534,LUDO 40000,PIECE,1,40000,33898,6102,40000,July
7535,SNAKE&LADDER 40000,PIECE,1,40000,33898,6102,40000,July
7539,Bottles 20000,PIECE,1,22000,18644,3356,22000,July
7540,NUMA KARO 2KG 12000,PIECE,1,12000,10169,1831,12000,July
7543,DOLLS3000,PIECE,2,3000,5085,915,6000,July
7544,DOLLS 5000,PIECE,1,5000,4237,763,5000,July
7547,TOYS 15000,PIECE,3,10000,25424,4576,30000,July
7552,TOYS 5000,PIECE,6,5500,27966,5034,33000,July
7553,TOYS 3000,PIECE,1,3000,2542,458,3000,July
7554,AFIA LEMON 500ML,PIECE,12,3000,30508,5492,36000,July
7558,HISS,PIECE,1,2500,2119,381,2500,July
7559,MOPPER 20000,PIECE,1,20000,16949,3051,20000,July
7564,HISCENTS RAMBO,PIECE,1,15000,12712,2288,15000,July
7568,RIGGS VOYAGE,PIECE,1,16000,13559,2441,16000,July
7570,SAPIL STRAWBERRY,PIECE,1,16000,13559,2441,16000,July
7575,AMERICAN SRAWBERRY GEL,PIECE,1,18000,15254,2746,18000,July
7587,ONER TAMARIND 300ML,PIECE,23,1500,29237,5263,34500,July
7588,SUMZ CASHEW NUTS 75G,PIECE,1,7500,6356,1144,7500,July
7590,WEETABIX SUPER SAVER 850G,PIECE,1,26000,22034,3966,26000,July
7591,SUMZ WAVE CRISPS 30G 1200,PIECE,19,1500,24153,4347,28500,July
7592,COLGATE CHARCOAL 210G 10000,PIECE,11,11000,102542,18458,121000,July
7593,COLGATE CHARCOAL 35G 2500,PIECE,16,2500,33898,6102,40000,July
7606,BEYOGLU BISCUITO,PIECE,1,1500,1271,229,1500,July
7617,NUVITA COOKIES COCONUT 100GM,PIECE,14,2300,27288,4912,32200,July
7620,SPRITE CAN 330ML,PIECE,17,3000,43220,7780,51000,July
7632,CLERE COCOA BUTTER 200ML,PIECE,2,5000,8475,1525,10000,July
7636,NISA LAVENDER HAND&BODY LOTION 50ML,PIECE,1,3500,2966,534,3500,July
7644,FANEST CHICKEN SAUSAGES 500G,PIECE,2,15000,25424,4576,30000,July
7647,SKY VIEW APPLE 320ML,PIECE,55,1000,46610,8390,55000,July
7650,JAMIES SWEET WHITE BUNS @4000,PIECE,164,4000,555932,100068,656000,July
7687,NOTE BOOK 6500,PIECE,4,6500,22034,3966,26000,July
7697,BODY SCRUBBER GLOVE 5000,PIECE,7,5000,29661,5339,35000,July
7701,CLEAR BAGS 1500,PIECE,3,1500,3814,686,4500,July
7703,TOYS 1000,PIECE,1,1000,847,153,1000,July
7704,JAMIES MILK BREAD 5500,PIECE,137,5985,694915,125085,820000,July
7705,JAMIES CAKE SLICE@8000,PIECE,59,8000,400000,72000,472000,July
7706,JAMIES MILK BREAD 500G,PIECE,30,3500,88983,16017,105000,July
7707,JAMIES COOKIES@20000,PIECE,2,20000,33898,6102,40000,July
7711,RIGGS ARMOUR SPRAY 250ML,PIECE,1,16000,13559,2441,16000,July
7718,BERTINI OLIVE OIL 100ML,PIECE,3,18000,45763,8237,54000,July
7719,SECRETS PADS ULTRA DAY&NIGHT PINK,PIECE,2,5500,9322,1678,11000,July
7720,SECRETS PADS ULTRA OVER NIGHT BLUE,PIECE,3,5500,13983,2517,16500,July
7721,SECRETS PANT LINERS PURPLE,PIECE,5,5500,23305,4195,27500,July
7726,DABUR CHARCOAL 150G,PIECE,4,7000,23729,4271,28000,July
7727,JAMIES SWEET WHITE BUNS WHOLESALE,PIECE,198,2500,495000,0,495000,July
7733,SUMZ MATOOKE CRISPS BBQ 20G,PIECE,27,600,13729,2471,16200,July
7744,TOY CAR 18000,PIECE,1,18000,15254,2746,18000,July
7745,CHOCOLATE 800,PIECE,2,800,1356,244,1600,July
7746,SWEETS 1500,PIECE,3,1500,3814,686,4500,July
7748,BAKEMATE LOVE 1500,PIECE,5,1500,6356,1144,7500,July
7770,PREDATOR ENERGY 350ML,PIECE,34,2000,57627,10373,68000,July
7771,SUMZ HONEY BUTTER FLAVOUR 12G,PIECE,31,600,15763,2837,18600,July
7783,MENTOS PEACH ORANGE,PIECE,2,2500,4237,763,5000,July
7789,JAMIES DANISH BREAD@3500,PIECE,25,3500,74153,13347,87500,July
7790,JAMIES CINNAMON BREAD,PIECE,212,5986,1075424,193576,1269000,July
7797,VERSMAN TRENDY 10000,PIECE,3,9500,24153,4347,28500,July
7807,CROWN PERFUME 4 MEN 12000,PIECE,2,12000,20339,3661,24000,July
7808,PICNIK CHOCOLATE 10G,PIECE,26,1000,22034,3966,26000,July
7812,FLAMINGO LEMON&HONEY 200G,PIECE,1,3500,2966,534,3500,July
7813,PETIT BEURRE 78G,PIECE,6,1200,6102,1098,7200,July
7815,7UP 330ML,PIECE,69,1000,58475,10525,69000,July
7816,FRUIT VILLE STRAWBERRY BANANA 500ML,PIECE,13,3500,38559,6941,45500,July
7821,DEAR BODY WILD ROMANCE 250ML,PIECE,1,16000,13559,2441,16000,July
7823,DOVE REFRESHING 500ML,PIECE,1,20000,16949,3051,20000,July
7824,BANANA JUICE 5000,PIECE,4,5000,16949,3051,20000,July
7826,JAMIES CINNAMON BREAD 500G,PIECE,28,3500,83051,14949,98000,July
7829,KICK PRINCESS CHICKEN FLAVOUR ,PIECE,222,500,94068,16932,111000,July
7831,7UP 500ML,PIECE,17,1500,21610,3890,25500,July
7832,FANEST BEEF SAUSAGES 500G,PIECE,4,13000,44068,7932,52000,July
7833,FANEST BEEF SAUSAGES 1KG,PIECE,1,21000,17797,3203,21000,July
7843,DOVE INVISIBLE CARE 250ML SPRAY,PIECE,2,21000,35593,6407,42000,July
7849,ELEGANT LEGEND AF 300ML,PIECE,2,7000,11864,2136,14000,July
7851,OLD SPICE ORIGINAL 85G,PIECE,1,21000,17797,3203,21000,July
7857,MOOISTE CHOCOLATE,PIECE,9,2500,19068,3432,22500,July
7859,TOFFEE 500,PIECE,28,500,11864,2136,14000,July
7860,WASH -Q KIDS TOOTH BRUSH ,PIECE,2,1000,1695,305,2000,July
7861,ROYAL SHAVERS,PIECE,10,3500,29661,5339,35000,July
7865,SWEETS 700,PIECE,2,696,1179,212,1391,July
7867,ROCK BOOM 500ML,PIECE,12,3000,30508,5492,36000,July
7871,DOVE ESSENTIAL CARE LOTION 400ML,PIECE,2,19000,32203,5797,38000,July
7872,DOVE INTENSE CARE LOTION 400ML,PIECE,2,19000,32203,5797,38000,July
7875,DOVE PAMPERING CARE 400ML,PIECE,1,19000,16102,2898,19000,July
7876,GRILLED GOATS MEAT 8000,PIECE,59,8000,400000,72000,472000,July
7878,BLUE BAND WITH CHOCO 250G,PIECE,10,6500,55085,9915,65000,July
7879,WEETABIX VANILLA 230G,PIECE,1,9500,8051,1449,9500,July
7884,ROKI COOKING OIL 1L,PIECE,6,8000,40678,7322,48000,July
7885,ROKI COOKING OIL 500ML,PIECE,11,4000,37288,6712,44000,July
7886,PAKA MATCH BOX,PIECE,17,1000,14407,2593,17000,July
7887,LIFEBUOY MOISTURE PLUS 175G,PIECE,2,6000,10169,1831,12000,July
7888,REXONA INVISIBLE DRY FRESH ROLLON 72JAM,PIECE,3,10000,25424,4576,30000,July
7894,NUVITA CHOCOLATE COOKIES 100GM,PIECE,2,2500,4237,763,5000,July
7896,NUVITA CHOCO CHIP COOKIES 100GM,PIECE,6,2500,12712,2288,15000,July
7901,YULU CLASSIC BOXERS 3PCS 22000,PIECE,2,22000,37288,6712,44000,July
7902,NIVEA FRESH CHERRY ROLL ON ,PIECE,1,11000,9322,1678,11000,July
7903,BLUE BAND WITH CHOCO 500G,PIECE,2,11000,18644,3356,22000,July
7904,SAFEGUAD SOFTCARE SOAP JUMBO,PIECE,2,3000,5085,915,6000,July
7905,SAFEGUARD LEMON SOAP,PIECE,6,1500,7627,1373,9000,July
7906,SAFEGUARD PURE WHITE ,PIECE,1,1500,1271,229,1500,July
7907,WEETABIX CORNFLAKES CRUNCHY 250G,PIECE,1,10000,8475,1525,10000,July
7908,RIGGS LONDON ACE SPRAY,PIECE,2,16000,27119,4881,32000,July
7909,ONER APPLE DRINK 200ML,PIECE,59,1000,50000,9000,59000,July
7910,ONER MANGO 200ML,PIECE,36,1000,30508,5492,36000,July
7911,RIHAM X ENERGY 400ML,PIECE,7,2000,11864,2136,14000,July
7913,CLERE BABY JELLY 50G,PIECE,3,2000,5085,915,6000,July
7917,SAFEGUARD LEMON FRESH JUMBO,PIECE,7,3000,17797,3203,21000,July
7918,JAMIES MILK BREAD WHOLESALE 1KG,PIECE,3,5500,13983,2517,16500,July
7919,JAMIES CINNAMON BREAD WHOLESALE 1KG,PIECE,5,5500,23305,4195,27500,July
7921,SOFTCARE BABY PANTS M9,PIECE,3,9000,22881,4119,27000,July
7922,AKABOGA ONION CHILI PASTE 200ML,PIECE,1,6500,5508,992,6500,July
7923,7UP SODA 2LTR,PIECE,10,4500,38136,6864,45000,July
7925,MASREYA PENNE PASTA 3500,PIECE,7,3500,20763,3737,24500,July
7926,MASREYA ELBOW PASTA 3500,PIECE,4,3500,11864,2136,14000,July
7927,AMARA MACADAMIA LOTION 400ML,PIECE,3,8500,21610,3890,25500,July
7929,GROW NATURAL HONEY 400G,PIECE,1,12000,10169,1831,12000,July
7930,KELLOGS CORNFLAKES 1KG,PIECE,2,45000,76271,13729,90000,July
7931,RAHA DRINKING CHOCOLATE 400G,PIECE,2,18000,30508,5492,36000,July
7932,DOWNY LUXURY PERFUME 900ML ,PIECE,1,24000,20339,3661,24000,July
7933,WEETABIX CORNFLAKES 50G,PIECE,3,2000,5085,915,6000,July
7934,SOFTCARE WIPES 10PCS,PIECE,23,1239,24153,4347,28500,July
7935,"ANNABELLE SHOWERGELS MIX PAPAYA,BLOSSOM,STRWBERRY",PIECE,2,14000,23729,4271,28000,July
7937,DOWNY FRESH SCENT SUNRISE 900ML,PIECE,1,24000,20339,3661,24000,July
7938,DOWNY SWEET ELEGANCE 300ML,PIECE,3,8500,21610,3890,25500,July
7939,DOWNY FRESH SCENT SNURISE 300ML,PIECE,3,8500,21610,3890,25500,July
7940,FANEST MINCED BEEF 500G,PIECE,3,13000,33051,5949,39000,July
7941,SUMZ POTATO CRISPS CHILLI LEMON 30G,PIECE,10,1500,12712,2288,15000,July
7943,HIKMA DADDIES 1000,PIECE,29,1000,24576,4424,29000,July
7944,HIKMA YELLOW BAGIYA 2500,PIECE,6,2500,12712,2288,15000,July
7952,SAFISHA KITCHEN CLEANER ,PIECE,4,3000,10169,1831,12000,July
7953,SAFISHA SCOURING PAD,PIECE,1,2000,1695,305,2000,July
7954,ROYCO 2-IN-1 200G,PIECE,2,6500,11017,1983,13000,July
7959,"ANKIT CRIMBLES STRAWBERY BISCUIT, VAN,CHO ",PIECE,5,4500,19068,3432,22500,July
7962,PIAO PIAO SANITARY PADS ULTRA THIN,PIECE,3,4000,10169,1831,12000,July
7963,PIAO PIAO SANITARY PADS EXTRA LENGTH,PIECE,1,4000,3390,610,4000,July
7964,PIAO PIAO HANDKERCHIEF,PIECE,5,1000,4237,763,5000,July
7965,TIFFANY NUTTYBITES CHO&HAZLENUT,PIECE,4,2500,8475,1525,10000,July
7967,SUNVEAT PETIT BEURRE CHO-VAN BISCUIT 75G,PIECE,11,1200,11186,2014,13200,July
7968,SUNVEAT MIXED NUT COOKIES 100G,PIECE,7,2000,11864,2136,14000,July
7969,CREMCA GOLDEN BITES BUTTER COOKIES,PIECE,1,2500,2119,381,2500,July
7970,FINI CINEMA MAX 165G,PIECE,2,13000,22034,3966,26000,July
7971,FINI LITTLE MIX 165G,PIECE,1,13000,11017,1983,13000,July
7972,MARSHMALLOW TIANS CONFECTION 327G,PIECE,1,22000,18644,3356,22000,July
7974,KIVUUVU 1000,PIECE,16,1000,13559,2441,16000,July
7975,WISDOM JUNIOR TOOTHBRUSH,PIECE,3,2500,6356,1144,7500,July
7976,ACE TOILET CLEANER OCEAN FRESH 250ML,PIECE,1,5000,4237,763,5000,July
7977,BIRTHDAY CANDLE NO. 3500,PIECE,2,3500,5932,1068,7000,July
7979,MAGIC CUBE 10000,PIECE,1,10000,8475,1525,10000,July
7980,KINGKAT 1500,PIECE,2,1500,2542,458,3000,July
7981,DAILY FRESH MASALA PEANUTS 70G,PIECE,3,1500,3814,686,4500,July
7982,DAILY FRESH SIMSIM BAR 1500,PIECE,2,1500,2542,458,3000,July
7983,DAILY FRESH PEANUT BAR 1500,PIECE,2,1500,2542,458,3000,July
7984,JESA BON-GA COCONUT YOGHURT 330G,PIECE,2,3500,5932,1068,7000,July
7985,JESA BON-GA MANGO 330G,PIECE,3,3500,8898,1602,10500,July
7986,JESA BON-GA STRAWBERRY YOGHURT 330G,PIECE,1,3500,2966,534,3500,July
3,10LTR JERRICAN 6000,PIECE,1,6500,5508,992,6500.1,August
4,180ML DISPOSABLE GLASSES,PIECE,24,3000,61017,10983,72000,August
7,300MLS DISPOSABLE GLASSES,PIECE,9,5000,38136,6864,45000,August
9,500MLS DISPOSABLE GLASSES,PIECE,10,6000,50847,9153,60000,August
12,7 DAYS BABY WIPES,PIECE,2,8500,14407,2593,17000,August
14,7 DAYS WIPES,PIECE,8,4375,29661,5339,35000,August
15,7DAYS ANTIBACTERIAL BABY WIPES,PIECE,2,8500,14407,2593,17000,August
16,7DAYS ANTIBACTERIAL WIPES,PIECE,6,5000,25424,4576,30000,August
18,7DAYS PANT LINERS,PIECE,1,4000,3390,610,4000,August
26,ABC BABY WIPES,PIECE,3,9000,22881,4119,27000,August
35,ACTIVE MAN SPRAY,PIECE,1,10000,8475,1525,10000,August
36,ACTIVE WOMAN BODY SPRAY,PIECE,3,10000,25424,4576,30000,August
43,ADIDAS PURE GAME SPRAY,PIECE,3,13000,33051,5949,39000,August
49,AFIA APPLE 500ML,PIECE,8,3000,20339,3661,24000,August
51,AFIA MANGO 500MLS,PIECE,25,3000,63559,11441,75000,August
52,AFIA MIXED FRUIT 500MLS,PIECE,23,3000,58475,10525,69000,August
53,AFIA MULTI VITAMIN,PIECE,10,3000,25424,4576,30000,August
54,AFIA ORANGE 500ML,PIECE,5,3000,12712,2288,15000,August
55,AFIA WHITE GUAVA,PIECE,23,3000,58475,10525,69000,August
58,AFRICANA TEA BAGS 50,PIECE,6,5000,25424,4576,30000,August
60,AFROCARE BODY LOTION 400ML,PIECE,3,6000,15254,2746,18000,August
61,AFROCARE JELLY 100G,PIECE,2,3000,5085,915,6000,August
63,AFROCARE PETROLEUM JELLY,PIECE,2,4500,7627,1373,9000,August
73,ALPER DRAJE CHOCOLATE,PIECE,4,3500,11864,2136,14000,August
81,ALWAYS COTTON EXTRA LONG,PIECE,7,3000,17797,3203,21000,August
83,ALWAYS COTTON MAXITHICK,PIECE,1,3000,2542,458,3000,August
86,ALWAYS EXTRA LONG,PIECE,27,3500,80085,14415,94500,August
88,ALWAYS LONG,PIECE,9,3500,26695,4805,31500,August
91,ALWAYS ULTRA THIN,PIECE,11,3818,35593,6407,42000,August
92,ALWAYS ULTRA V.P,PIECE,2,6500,11017,1983,13000,August
93,ALWAYS V.P EXTRA LONG,PIECE,3,6500,16525,2975,19500,August
94,ALWAYS VACUUM JAR 2LTRS,PIECE,1,65000,55085,9915,65000,August
95,ALWAYS VALUE PACK LONG,PIECE,5,6500,27542,4958,32500,August
103,AMARA COCOA BUTTER 200ML,PIECE,2,6000,10169,1831,12000,August
107,AMARA COCONUT 400ML,PIECE,1,8500,7203,1297,8500,August
108,AMARA FOR MEN 400ML,PIECE,5,10000,42373,7627,50000,August
111,AMARA HYDRATING GLYCERINE 400ML LOTION,PIECE,1,8500,7203,1297,8500,August
112,AMARA MEN 200ML,PIECE,3,6000,15254,2746,18000,August
113,AMARA MEN 400ML,PIECE,1,9000,7627,1373,9000,August
115,AMARA RAW SHEA 200ML,PIECE,4,6000,20339,3661,24000,August
119,AMARA UNSCENTED 100G,PIECE,1,3500,2966,534,3500,August
125,AMERICAN GARDEN KETCHUP 340G,PIECE,1,8000,6780,1220,8000,August
126,AMERICAN GARDEN KETCHUP 340G,PIECE,1,8000,6780,1220,8000,August
129,AMERICAN GARDEN KETCHUP 680G,PIECE,2,19000,32203,5797,38000,August
136,AMERICAN GREEN GARDEN HONEY 200G,PIECE,2,8500,14407,2593,17000,August
146,AMLA HAIR OIL 100ML,PIECE,1,7000,5932,1068,7000,August
157,ANKIT BOURBON,PIECE,8,5000,33898,6102,40000,August
179,APPLE CIDER VINEGAR 473MLS,PIECE,6,11000,55932,10068,66000,August
182,APPLES GREEN,PIECE,238,1500,302542,54458,357000,August
183,APPLES RED,PIECE,571,1500,725847,130653,856500,August
195,AQUAFRESH HERBAL 50ML,PIECE,1,5000,4237,763,5000,August
209,Ariel color and style,PIECE,2,7500,12712,2288,15000,August
212,ARIEL DOWNY 500G,PIECE,3,7167,18220,3280,21500,August
214,ARIEL LAVENDER 1KG,PIECE,1,15500,13136,2364,15500,August
215,ARIEL ORIGINAL 1KG,PIECE,2,14500,24576,4424,29000,August
217,ARMAF AIR FRESHNER OUD,PIECE,2,11000,18644,3356,22000,August
218,ARMAF AIR FRESHNER SPRING,PIECE,2,11000,18644,3356,22000,August
226,ARMAF ENCHANTED VINTAGE,PIECE,2,11000,18644,3356,22000,August
231,ARMAF LE FEMME MIST,PIECE,1,17000,14407,2593,17000,August
235,ARMAF SHADES FOR MEN,PIECE,1,17000,14407,2593,17000,August
239,ARMAF TAG-HER FOR WOMEN,PIECE,1,13000,11017,1983,13000,August
254,AROMAT 75G,PIECE,6,5500,27966,5034,33000,August
270,ART BOOK BIG,PIECE,1,4000,3390,610,4000,August
271,ART BOOK SMALL,PIECE,2,2000,3390,610,4000,August
277,ART PENCILS 6B,PIECE,1,1000,847,153,1000,August
279,ASANTEE PAPAYA SOAP,PIECE,1,6500,5508,992,6500,August
311,AUNT PORRIDGE 1KG,PIECE,3,14000,35593,6407,42000,August
312,AUNT PORRIDGE 2KG,PIECE,1,28000,23729,4271,28000,August
313,AUNT PORRIDGE 6MONTHS,PIECE,4,14000,47458,8542,56000,August
325,AXE APOLLO BODY SPRAY,PIECE,4,13000,44068,7932,52000,August
326,AXE BLACK,PIECE,4,13000,44068,7932,52000,August
339,AXESS AQUA,PIECE,5,9000,38136,6864,45000,August
344,AZAM BAKING FLOUR 2KG,PIECE,6,8500,43220,7780,51000,August
346,AZAM EMBE MANGO,PIECE,12,1500,15254,2746,18000,August
347,AZAM ENERGY DRINK 300MLS,PIECE,39,1500,49576,8924,58500,August
348,AZAM MALT 300MLS,PIECE,2,1500,2542,458,3000,August
349,AZAM MALT 500MLS,PIECE,19,3000,48305,8695,57000,August
353,B.D CANDLE NUMBERS,PIECE,16,1469,19915,3585,23500,August
354,B.D CANDLES 1500,PIECE,1,1500,1271,229,1500,August
357,B.D CROWNS 2500,PIECE,3,2500,6356,1144,7500,August
383,BABY BOTTLE 092 6000,PIECE,1,6000,5085,915,6000,August
440,BABY JUNIOR 50G,PIECE,5,1500,6356,1144,7500,August
441,BABY JUNIOR BABY OIL 90ML,PIECE,3,3500,8898,1602,10500,August
442,BABY JUNIOR JELLY 200g,PIECE,1,6000,5085,915,6000,August
444,BABY JUNIOR JELLY 500G,PIECE,1,11000,9322,1678,11000,August
447,BABY JUNIOR100g,PIECE,1,3500,2966,534,3500,August
454,BABY NIPPLES 700,PIECE,2,700,1186,214,1400,August
455,BABY NIPPLES BIG 1000,PIECE,2,1000,1695,305,2000,August
461,BABY PLATES 10000,PIECE,1,10000,8475,1525,10000,August
466,BABY RATTLES,PIECE,1,12000,10169,1831,12000,August
497,BABY& ME BABYJELLY 240ML,PIECE,1,5000,4237,763,5000,August
498,BABY&ME BABY CREAM,PIECE,1,4000,3390,610,4000,August
523,BALLET ACTIVE VITAMIN 120MLS,PIECE,2,5500,9322,1678,11000,August
524,BALLET ACTIVE VITAMIN 300MLS,PIECE,2,10000,16949,3051,20000,August
526,BALLET ALOE VERA 120MLS,PIECE,3,5500,13983,2517,16500,August
527,BALLET ALOE VERA JELLY 300MLS,PIECE,4,10000,33898,6102,40000,August
528,BALLET BABY JELLY 120MLS,PIECE,3,5500,13983,2517,16500,August
529,BALLET BABY JELLY 300MLS,PIECE,6,10000,50847,9153,60000,August
532,BALLET BABY LOTION 240ML,PIECE,1,12000,10169,1831,12000,August
537,BALLET BUTTER BLEND 120MLS,PIECE,3,5500,13983,2517,16500,August
540,BALLET HONEY SOAP,PIECE,1,4000,3390,610,4000,August
541,BALLET POWDER 100G,PIECE,1,5000,4237,763,5000,August
543,BALLET SHEA BUTTER SOAP,PIECE,4,4000,13559,2441,16000,August
556,BALLS AND DOLLS LIGHTING 7000,PIECE,3,7167,18220,3280,21500,August
562,BALLS SOFT 1000,PIECE,1,2000,1695,305,2000,August
563,BALOON 300,PIECE,228,300,57966,10434,68400,August
570,BAMBOO TOOTHPICK 2500,PIECE,2,2500,4237,763,5000,August
571,BAMBOO TOOTHPICKS,PIECE,3,2667,6780,1220,8000,August
577,BANNERS 7000,PIECE,1,7000,5932,1068,7000,August
588,BASKETS 2500,PIECE,3,2500,6356,1144,7500,August
612,BECCA COUNTER BOOKS 6500,PIECE,2,6500,11017,1983,13000,August
636,BESSA MILLET DRINK 500MLS,PIECE,10,4500,38136,6864,45000,August
637,BESSA MILLET MALT DRINK 330ML,PIECE,7,3000,17797,3203,21000,August
647,BIC PENS,PIECE,9,700,5339,961,6300,August
648,BIC SHEVARS,PIECE,11,1000,9322,1678,11000,August
649,BI-CARBONATE SODA,PIECE,13,1000,11017,1983,13000,August
655,BIG DADDY 300 SWEETS,PIECE,9,300,2288,412,2700,August
659,BIKERS ST MICHAEL 10000,PIECE,2,10000,16949,3051,20000,August
663,BIO- OIL 60ML,PIECE,1,24000,20339,3661,24000,August
664,BIRTHDAY CANDLES 3500,PIECE,3,4000,10169,1831,12000,August
665,BIRTHDAY CANDLES 4000,PIECE,3,3500,8898,1602,10500,August
667,BIRTHDAY CROWNS 5000,PIECE,3,8333,21186,3814,25000,August
671,BIRTHDAY HATS 2500,PIECE,6,2500,12712,2288,15000,August
672,BIRTHDAY HATS 3500,PIECE,8,3500,23729,4271,28000,August
673,BIRTHDAY HATS 5000,PIECE,1,5000,4237,763,5000,August
674,BIRTHDAY LETTERS 5000,PIECE,4,5000,16949,3051,20000,August
683,BIYINZIKA CHICKENLEGS 1KGS,PIECE,2,19000,32203,5797,38000,August
684,BIYINZIKA DRUMSTICKS 500G,PIECE,2,15000,25424,4576,30000,August
687,BIYINZIKA MUCHOMO 1.5KG,PIECE,1,28000,23729,4271,28000,August
688,BIYINZIKA STANDARD1.2KG,PIECE,3,25000,63559,11441,75000,August
689,BIYINZIKA SUPA 1KG,PIECE,5,20000,84746,15254,100000,August
690,BIYINZIKA THIGHS 500G,PIECE,1,11000,9322,1678,11000,August
691,BIYINZIKA WINGS 500G,PIECE,3,13000,33051,5949,39000,August
704,BLESSED KISUBI TEA 200G,PIECE,5,6500,27542,4958,32500,August
713,BLUE BAND 100G,PIECE,25,2480,52542,9458,62000,August
714,BLUE BAND 1KG,PIECE,2,19000,32203,5797,38000,August
716,BLUE BAND 500G,PIECE,10,10000,84746,15254,100000,August
717,BLUE BAND LOW FAT,PIECE,4,6500,22034,3966,26000,August
718,BLUE BAND LOW SPREAD 250G,PIECE,8,4000,27119,4881,32000,August
724,BLUE LADY SPRAY,PIECE,1,15000,12712,2288,15000,August
725,BLUE LAGOON PASSION SPLASH,PIECE,1,17000,14407,2593,17000,August
729,BLUE TOILET BLOCKS DOUBLE,PIECE,11,5000,46610,8390,55000,August
731,BLUEBAND LOW FAT 100G,PIECE,5,2000,8475,1525,10000,August
732,BLUEBAND PEANUT BUTTER,PIECE,4,8000,27119,4881,32000,August
733,BLUEBAND PEANUT BUTTER 400G,PIECE,1,14000,11864,2136,14000,August
745,BODYLUXE JELLY 500G,PIECE,2,10000,16949,3051,20000,August
766,BOTTLES 17000,PIECE,1,17000,14407,2593,17000,August
769,BOTTLES 15000,PIECE,1,15000,12712,2288,15000,August
781,BOUNTY CHOCOLATE,PIECE,25,3500,74153,13347,87500,August
790,BOX FILES 6000,PIECE,3,7000,17797,3203,21000,August
805,BRAVO SWEET BREAD 1KG,PIECE,2,4500,7627,1373,9000,August
817,BRITANIA BUTTER 1KG,PIECE,1,20000,16949,3051,20000,August
824,BRITANIA MILK BISCUIT,PIECE,53,500,22458,4042,26500,August
826,BRITANIA MUNCHIES BISCUITS,PIECE,39,500,16525,2975,19500,August
829,BRITANIA NICE COCONUT BISCUITS,PIECE,6,4000,20339,3661,24000,August
830,BRITANIA SHORT CAKE 200G,PIECE,8,4000,27119,4881,32000,August
836,BROOKSIDE FRUIT STRAWBERRIES,PIECE,27,5500,125847,22653,148500,August
838,BROOKSIDE FRUIT VANILLA 250G,PIECE,5,3000,12712,2288,15000,August
841,BROOKSIDE FRUIT YOG VANILLA 450G,PIECE,1,5000,4237,763,5000,August
842,BROOKSIDE LEMON 250G,PIECE,21,3000,53390,9610,63000,August
843,BROOKSIDE LEMON BISCUITS 450G,PIECE,14,5500,65254,11746,77000,August
844,BROOKSIDE MILK 500ML,PIECE,24,2275,46271,8329,54600,August
845,BROOKSIDE PEAR CARAMEL,PIECE,5,5100,21610,3890,25500,August
846,BROOKSIDE PEAR CARAMEL 250G,PIECE,5,3000,12712,2288,15000,August
849,BROOKSIDE STRAWBERRIES 250G,PIECE,26,3000,66102,11898,78000,August
882,BUFFER,PIECE,3,4500,11441,2059,13500,August
890,BUSHENYI HONEY 250G,PIECE,3,6000,15254,2746,18000,August
891,BUSHENYI HONEY 5OOG,PIECE,12,9000,91525,16475,108000,August
892,BUSHENYI HONEY 90G,PIECE,10,3500,29661,5339,35000,August
901,C.B CHOCOLATE CHOCO CHIP 120ML,PIECE,1,2500,2119,381,2500,August
902,C.B CHOCOLATE CHOCO CHIPS 200ML,PIECE,1,5000,4237,763,5000,August
913,C.B RIPPLES CHOCOLATE 200ML,PIECE,2,4000,6780,1220,8000,August
916,C.B RIPPLES STRAWBERRY 200ML,PIECE,2,4000,6780,1220,8000,August
917,C.B ROYAL MANGO 120ML,PIECE,1,2500,2119,381,2500,August
941,CADBURY DAIRYMILK 10G CHOCOLATE,PIECE,9,1500,11441,2059,13500,August
943,CADBURY DREAM WHITE CREAMY 80G,PIECE,24,8000,162712,29288,192000,August
944,CADBURY DRINKING CHOCOLATE 125G,PIECE,12,9000,91525,16475,108000,August
945,CADBURY DRINKING CHOCOLATE 450G,PIECE,1,25000,21186,3814,25000,August
946,CADBURY FRUIT & NUT 80G,PIECE,13,8000,88136,15864,104000,August
949,CADBURY RUM&RAISIN 80G,PIECE,2,8000,13559,2441,16000,August
951,CADBURY TOPDECK MINT,PIECE,18,8000,122034,21966,144000,August
997,CANDLES 500,PIECE,6,500,2542,458,3000,August
1009,CAR TOYS 8000,PIECE,1,8000,6780,1220,8000,August
1012,CAR TOYS 4000,PIECE,1,4000,3390,610,4000,August
1014,CAR TOYS 5000,PIECE,1,5000,4237,763,5000,August
1017,CARAMBOLA BLACK SPOT,PIECE,1,6000,5085,915,6000,August
1021,CARO LIGHT 300ML,PIECE,1,12000,10169,1831,12000,August
1022,CARO LIGHT OIL 50ML,PIECE,2,4500,7627,1373,9000,August
1029,CARROT CAKE,PIECE,32,5000,135593,24407,160000,August
1038,CASIO 401/991MS CALCULATOR,PIECE,1,45000,38136,6864,45000,August
1044,CB BUTTERSCOTCH 1LTR,PIECE,3,24000,61017,10983,72000,August
1046,CB CLASSIC VANILLA 120MLS,PIECE,2,2500,4237,763,5000,August
1047,CB CLASSIC VANILLA 200MLS,PIECE,4,4000,13559,2441,16000,August
1054,CB MAGIC STRAW 500ML,PIECE,2,10000,16949,3051,20000,August
1058,CELOTAPE 2000,PIECE,1,2500,2119,381,2500,August
1060,CELOTAPE BLACK,PIECE,1,1500,1271,229,1500,August
1066,CERELAC 12MONTHS 400G,PIECE,2,30000,50847,9153,60000,August
1068,CERELAC 7MONTHS MIXEDFRUITS,PIECE,1,30000,25424,4576,30000,August
1093,CHAMPION A4 200PAGES,PIECE,9,4000,30508,5492,36000,August
1094,CHAMPION A4 96 PAGES,PIECE,2,2000,3390,610,4000,August
1095,CHAPA BAKING POWDER,PIECE,6,1500,7627,1373,9000,August
1096,CHAPA NYOTA BLUE 600G,PIECE,3,4000,10169,1831,12000,August
1097,CHAPA NYOTA BROWN 600G,PIECE,1,4000,3390,610,4000,August
1108,CHASTITY RASASI SPRAY,PIECE,1,12000,10169,1831,12000,August
1110,CHELSEA CROWN PERFUME,PIECE,1,10000,8475,1525,10000,August
1111,CHERRY COTTON BUDS,PIECE,2,2500,4237,763,5000,August
1113,CHERRY COTTON BUDS 4500,PIECE,1,4000,3390,610,4000,August
1122,CHICKSTAX SILVER FISH POWDER,PIECE,1,7000,5932,1068,7000,August
1125,CHILDREN TABLEWARE 25000,PIECE,1,25000,21186,3814,25000,August
1127,CHILDREN'S UNDERWEAR 16000,PIECE,1,18000,15254,2746,18000,August
1131,CHINA GREEN TEA 50G,PIECE,4,6000,20339,3661,24000,August
1134,CHOCOLATE 500,PIECE,83,500,35169,6331,41500,August
1137,CHOCOLATES 300,PIECE,4,300,1017,183,1200,August
1169,CLASSIC G.B.K WHOLE MILK 500ML,PIECE,60,2200,111864,20136,132000,August
1171,CLASSIC MILK BOX 23000,BOX,2,24000,40678,7322,48000,August
1176,CLEAR BAG 1000,PIECE,4,1000,3390,610,4000,August
1182,CLEOS HOT SAUCE 125G,PIECE,5,3500,14831,2669,17500,August
1189,CLERE FOR MEN ICE 250G,PIECE,3,6000,15254,2746,18000,August
1193,CLERE PETROLEUM JELLY 250G,PIECE,1,6000,5085,915,6000,August
1194,CLERE PETROLEUM JELLY100G,PIECE,2,3500,5932,1068,7000,August
1195,CLIMAX BERRIES 170G,PIECE,2,6000,10169,1831,12000,August
1196,CLIMAX BERRIES 50G,PIECE,5,2500,10593,1907,12500,August
1197,CLIMAX CITRUS FRUITS 170G,PIECE,1,6000,5085,915,6000,August
1199,CLIMAX EXOTIC TROPICAL FRUITS 170G,PIECE,1,6000,5085,915,6000,August
1201,CLIMAX FOREST FRUITS 50G,PIECE,6,2500,12712,2288,15000,August
1202,CLIMAX TROPICAL FRUITS 50G,PIECE,4,2500,8475,1525,10000,August
1212,CLOSEUP TRIPLEFRESH 60G,PIECE,2,3000,5085,915,6000,August
1213,CLOSEUP TRIPPLE FRESH 125G,PIECE,1,5000,4237,763,5000,August
1219,COBWEB 7000,PIECE,1,7000,5932,1068,7000,August
1220,COBWEB 9000,PIECE,1,9000,7627,1373,9000,August
1221,COCACOLA 2LTRS,PIECE,83,5000,351695,63305,415000,August
1222,COCACOLA 350MLS,PIECE,107,1000,90678,16322,107000,August
1223,COCACOLA 500MLS,PIECE,65,1500,82627,14873,97500,August
1224,COCACOLA CAN 330ML,PIECE,15,3000,38136,6864,45000,August
1227,COCACOLA ZERO 350ML,PIECE,9,1000,7627,1373,9000,August
1238,COCOPULP 300ML CREME,PIECE,1,13000,11017,1983,13000,August
1239,COCOPULP CREME 100ML,PIECE,1,8000,6780,1220,8000,August
1241,COCOS COCONUT BAR,PIECE,20,1000,16949,3051,20000,August
1244,COLGATE 0-2YEARS,PIECE,3,4000,10169,1831,12000,August
1245,COLGATE CHARCOAL GENTLE CLEAN,PIECE,18,7500,114407,20593,135000,August
1246,COLGATE CHARCOAL TWIN TOOTHBRUSH,PIECE,14,4000,47458,8542,56000,August
1247,COLGATE CHILDREN 50MLS,PIECE,4,4500,15254,2746,18000,August
1248,COLGATE DEEP CLEAN,PIECE,3,1500,3814,686,4500,August
1249,COLGATE DOUBLE ACTION,PIECE,13,4000,44068,7932,52000,August
1252,COLGATE HERBAL 140G,PIECE,13,7500,82627,14873,97500,August
1253,COLGATE HERBAL 230G,PIECE,13,10000,110169,19831,130000,August
1254,COLGATE HERBAL 35G,PIECE,16,2500,33898,6102,40000,August
1255,COLGATE HERBAL 70G,PIECE,12,4500,45763,8237,54000,August
1256,COLGATE KIDS 2-5YEARS,PIECE,8,5000,33898,6102,40000,August
1257,COLGATE MAX FRESH 65G,PIECE,5,3500,14831,2669,17500,August
1259,COLGATE MAX-FRESH 130G,PIECE,1,6500,5508,992,6500,August
1261,COLGATE MAXIMUM CAVITY 140G,PIECE,2,7500,12712,2288,15000,August
1262,COLGATE MAXIMUM CAVITY 35G,PIECE,3,2500,6356,1144,7500,August
1263,COLGATE MAXIMUM CAVITY 70G,PIECE,2,4500,7627,1373,9000,August
1264,COLGATE NATURAL EXTRACT 75MLS,PIECE,2,9000,15254,2746,18000,August
1265,COLGATE TOOTBRUSH,PIECE,12,2500,25424,4576,30000,August
1266,COLGATE TOOTHBRUSH 1500,PIECE,5,1500,6356,1144,7500,August
1267,COLGATE TOOTHBRUSH CHARCOAL,PIECE,14,2500,29661,5339,35000,August
1269,COLGATE TRIPLE ACTION 140G,PIECE,2,6500,11017,1983,13000,August
1270,COLGATE TRIPPLE ACTION 70G,PIECE,7,4000,23729,4271,28000,August
1274,COLORES NEW ELITE COLOURS BIG,PIECE,2,2000,3390,610,4000,August
1277,COMB 1500,PIECE,4,1500,5085,915,6000,August
1279,COMB WITH MIRROR 1500,PIECE,1,1500,1271,229,1500,August
1280,COMB WITH MIRROR 2500,PIECE,1,2500,2119,381,2500,August
1286,COMFORT T.P 1000,PIECE,138,1000,116949,21051,138000,August
1289,COMPACT T.P,PIECE,57,1000,48305,8695,57000,August
1290,COMPO PENS,PIECE,2,3000,5085,915,6000,August
1329,COTTO SWABS EAR BUDS,PIECE,4,1500,5085,915,6000,August
1330,COTTON BUDS WOODEN,PIECE,6,2500,12712,2288,15000,August
1334,COVERTINA CHOCOLATE 500,PIECE,22,500,9322,1678,11000,August
1343,COW & GATE 1 400GM,PIECE,7,44000,261017,46983,308000,August
1344,COW & GATE 2,PIECE,3,44000,111864,20136,132000,August
1357,CREAMBELL STRAWBERRY VAN 500ML,PIECE,3,10000,25424,4576,30000,August
1359,CREAMY EFFECT WIPES,PIECE,11,6000,55932,10068,66000,August
1362,"CROWN 10,000",PIECE,1,10000,8475,1525,10000,August
1374,CUPS 1500,PIECE,1,1500,1271,229,1500,August
1389,CUSSON SOAP MILD&GENTLE,PIECE,6,3500,17797,3203,21000,August
1391,CUSSONS BABY OIL 100MLS,PIECE,1,9000,7627,1373,9000,August
1393,CUSSONS BABY OIL PINK 200MLS,PIECE,2,16000,27119,4881,32000,August
1394,CUSSONS BABY PERFUMED JELLY 200ML,PIECE,3,12000,30508,5492,36000,August
1397,CUSSONS BABY UNPERFUMED JELLY 200ML,PIECE,2,12000,20339,3661,24000,August
1401,CUSSONS PERFUMED JELLY A&R 100ML,PIECE,7,5571,33051,5949,39000,August
1406,CUSSONS SOAP SOFT&SMOOTH,PIECE,7,3500,20763,3737,24500,August
1412,CUTTERS 1000,PIECE,1,1000,847,153,1000,August
1413,CUTTERS 1500,PIECE,2,1500,2542,458,3000,August
1419,D.L BLUEBERRY SWIRL 500ML,PIECE,1,10000,8475,1525,10000,August
1422,D.L CHOCOLATE RIPPLE 500ML,PIECE,1,10000,8475,1525,10000,August
1423,D.L FIESTA CLASSIC 100MLS,PIECE,40,3513,119068,21432,140500,August
1424,D.L FIESTA SALTED CARAMEL,PIECE,21,4000,71186,12814,84000,August
1425,D.L MANGO 250ML,PIECE,8,5000,33898,6102,40000,August
1426,D.L MAXIMO BISCOTTI 175ML,PIECE,8,4500,30508,5492,36000,August
1427,D.L MAXIMO CARAMEL NUTS,PIECE,1,4500,3814,686,4500,August
1428,D.L MAXIMO VAN-CHOCO FLAKES 175ML,PIECE,8,4500,30508,5492,36000,August
1429,D.L MEGA CONE VANILLA,PIECE,1,3500,2966,534,3500,August
1430,D.L MINI FIESTA CARAMEL,PIECE,25,3000,63559,11441,75000,August
1431,D.L MINI FIESTA CLASSIC 70MLS,PIECE,31,3000,78814,14186,93000,August
1435,D.L STRAWBERRY RIPPLE 500ML,PIECE,3,10000,25424,4576,30000,August
1437,D.L VAN.STRAW 250ML,PIECE,25,5000,105932,19068,125000,August
1440,D.L VAN-CHOC 500ML,PIECE,8,9750,66102,11898,78000,August
1443,D.L VANILLA 500ML,PIECE,9,9611,73305,13195,86500,August
1444,D.L VANILLA CREAM 120MLS,PIECE,21,2000,35593,6407,42000,August
1445,D.L VAN-STRAW 120ML,PIECE,10,2000,16949,3051,20000,August
1447,D.L VAN-STRAW 500ML,PIECE,8,9563,64831,11669,76500,August
1450,DABUR HERBAL CLOVE 150G,PIECE,14,6000,71186,12814,84000,August
1453,DABUR NEEM TOOTHPASTE 150G,PIECE,9,6000,45763,8237,54000,August
1461,DAIRY MILK PLAIN 80G,PIECE,22,8000,149153,26847,176000,August
1462,DAIRY MILK TOP DECK 80G,PIECE,13,8000,88136,15864,104000,August
1464,DAIRY TOP YOGHURT STRAWBERRY 250G,PIECE,178,1000,150847,27153,178000,August
1484,DATES 1000,PIECE,14,1000,11864,2136,14000,August
1485,DATES 2000,PIECE,19,2026,32627,5873,38500,August
1486,DATES 3000,PIECE,6,3500,17797,3203,21000,August
1510,DELIDENT MAX 70G,PIECE,2,2000,3390,610,4000,August
1511,DELLA CHOCOLATE,PIECE,12,3000,30508,5492,36000,August
1512,DELUXE ALUMINIUM FOIL,PIECE,3,6500,16525,2975,19500,August
1513,DEMICH BRAIN BOOSTER PORRIDGE,PIECE,5,7000,29661,5339,35000,August
1514,DEMICH PORRIDGE ENERGY BOOSTER 1KG,PIECE,3,7000,17797,3203,21000,August
1527,DENTEX TOOTHBRUSH SOFT,PIECE,7,3500,20763,3737,24500,August
1532,DERBY CLUB HOUSE MIST,PIECE,3,17000,43220,7780,51000,August
1539,DETTOL 125MLS,PIECE,4,9000,30508,5492,36000,August
1540,DETTOL ACTIVE 175G,PIECE,3,6500,16525,2975,19500,August
1542,DETTOL COOL 105G,PIECE,3,4500,11441,2059,13500,August
1543,DETTOL COOL 175G,PIECE,3,6500,16525,2975,19500,August
1544,DETTOL EVENTONE 175G,PIECE,1,6500,5508,992,6500,August
1547,DETTOL FRESH 175G,PIECE,4,6500,22034,3966,26000,August
1548,DETTOL FRESH 90G,PIECE,1,4500,3814,686,4500,August
1550,DETTOL HERBAL 105G,PIECE,3,4500,11441,2059,13500,August
1551,DETTOL HERBAL 175G,PIECE,6,6500,33051,5949,39000,August
1552,DETTOL JUNIORS GLYCERINE SOAP 100G,PIECE,3,4500,11441,2059,13500,August
1553,DETTOL LIQUID 250 MLS,PIECE,3,15000,38136,6864,45000,August
1555,DETTOL LIQUID 50MLS,PIECE,1,4000,3390,610,4000,August
1557,DETTOL ORIGINAL 100G,PIECE,2,4500,7627,1373,9000,August
1558,DETTOL ORIGINAL 175G,PIECE,5,6500,27542,4958,32500,August
1559,DETTOL SENSITIVE 175G,PIECE,1,6500,5508,992,6500,August
1560,DETTOL SKINCARE 175G,PIECE,3,6500,16525,2975,19500,August
1568,DEXE BLACK HAIR SHAMPOO,PIECE,8,2000,13559,2441,16000,August
1594,DISPOSABLE BOWLS 3500,PIECE,3,3500,8898,1602,10500,August
1595,DISPOSABLE FORKS 2500,PIECE,1,4000,3390,610,4000,August
1602,DISPOSABLE PLATES 9 ROUND,PIECE,6,7000,35593,6407,42000,August
1607,DIVINE 300MLS,PIECE,47,2500,99576,17924,117500,August
1608,DIVINE 500MLS,PIECE,45,4000,152542,27458,180000,August
1633,DOLBY SPORT SPRAY,PIECE,1,12000,10169,1831,12000,August
1634,DOLBY SPRAY,PIECE,2,10000,16949,3051,20000,August
1641,DOLL 25000,PIECE,1,25000,21186,3814,25000,August
1642,DOLL 3000,PIECE,1,3000,2542,458,3000,August
1645,DOLL BABY 40000,PIECE,1,40000,33898,6102,40000,August
1651,DOLLAR CHOCOLATE 3.5OZ,PIECE,1,3000,2542,458,3000,August
1652,DOLLS 12000,PIECE,1,12000,10169,1831,12000,August
1661,DOLLS YONG 17000,PIECE,2,17000,28814,5186,34000,August
1666,DOMS COLOUR PENCILS LONG,PIECE,1,7000,5932,1068,7000,August
1667,DOMS COLOUR PENCILS SHORT,PIECE,1,4000,3390,610,4000,August
1670,DOMS PENCILS A1 5000,PIECE,2,5000,8475,1525,10000,August
1688,DOUBLE REFINED SALT 650G,PIECE,1,7000,5932,1068,7000,August
1697,DOVE CUCUMBER&GREENTEA SHOWERGEL,PIECE,2,22000,37288,6712,44000,August
1698,DOVE DEEPLY NOURISHING SHOWER GEL 500ML,PIECE,2,22000,37288,6712,44000,August
1710,DOVE INVIGORATING RITUAL SHOWER GEL,PIECE,1,22000,18644,3356,22000,August
1734,DOVE ROLLON GRAPEFRUIT,PIECE,1,11000,9322,1678,11000,August
1750,DOWNY FEEL LUX 20ML,PIECE,20,700,11864,2136,14000,August
1753,DOWNY VALLEY DEW 20ML,PIECE,20,700,11864,2136,14000,August
1758,DREAM PANT LINERS,PIECE,6,2500,12712,2288,15000,August
1759,DRINKING CHOCOLATE 225G,PIECE,2,15000,25424,4576,30000,August
1763,DUCKS 8000,PIECE,3,6667,16949,3051,20000,August
1769,DURACELL AA PLUS,PIECE,9,6000,45763,8237,54000,August
1771,DURACELL AAA PLUS,PIECE,3,6000,15254,2746,18000,August
1772,DURU CARING MILK,PIECE,1,4500,3814,686,4500,August
1773,DURU CUCUMBER,PIECE,1,4500,3814,686,4500,August
1774,DURU DOLCE ALMOND,PIECE,5,4500,19068,3432,22500,August
1779,DURU FRESH SENSATION 4PCS,PIECE,4,16000,54237,9763,64000,August
1780,DURU GLYCERINE,PIECE,1,5000,4237,763,5000,August
1783,DURU MISKET 4PCS,PIECE,1,16000,13559,2441,16000,August
1784,DURU MOUNTAINAIR SOAP,PIECE,1,14000,11864,2136,14000,August
1785,DURU NATURAL CARE,PIECE,8,4500,30508,5492,36000,August
1788,DURU OCEAN BREEZE SOAP,PIECE,1,14000,11864,2136,14000,August
1790,DURU REFRESHING LEMON,PIECE,1,14000,11864,2136,14000,August
1796,DUST PAN 7000,PIECE,1,7000,5932,1068,7000,August
1800,DUSTBIN MUKWANO 8000,PIECE,1,8000,6780,1220,8000,August
1813,EAGLE DISPOSABLE FORKS AND SPOONS,PIECE,1,4000,3390,610,4000,August
1816,EAST AFRICAN HONEY 350G,PIECE,3,13000,33051,5949,39000,August
1818,EAST AFRICAN ORGANIC HONEY 100G,PIECE,5,3500,14831,2669,17500,August
1819,EAST AFRICAN ORGANIC HONEY 250G,PIECE,3,8000,20339,3661,24000,August
1820,EAST AFRICAN ORGANIC HONEY 450G,PIECE,1,12000,10169,1831,12000,August
1823,ECLAIRS,PIECE,48,200,8136,1464,9600,August
1837,EDEN APRICOT SCRUB 454G,PIECE,1,22000,18644,3356,22000,August
1840,EDEN BODY MILK 500ML,PIECE,1,26000,22034,3966,26000,August
1853,EGGS HALF TRAY,PIECE,4,7000,23729,4271,28000,August
1855,EGGS PIECES,PIECE,122,500,51695,9305,61000,August
1856,EGGS TRAY,PIECE,10,14000,118644,21356,140000,August
1861,ELEGANCE COCOA BUTTER,PIECE,1,6000,5085,915,6000,August
1869,ELEGANT BLACK A.F,PIECE,2,7000,11864,2136,14000,August
1877,ELEGANT JASMINE A.F,PIECE,2,7000,11864,2136,14000,August
1878,ELEGANT LAVENDER AR.F,PIECE,2,7000,11864,2136,14000,August
1887,ELEGANT STRAWBERRY 300ML,PIECE,2,7000,11864,2136,14000,August
1888,ELEGANT YURI AIR FRESHNER,PIECE,2,7000,11864,2136,14000,August
1891,ELGON BLEND COFFEE 100G,PIECE,2,9000,15254,2746,18000,August
1908,ENVELOPE A4,PIECE,5,500,2119,381,2500,August
1910,ENVELOPES 200,PIECE,22,200,3729,671,4400,August
1911,ENVELOPES 300,PIECE,9,300,2288,412,2700,August
1914,ERASER RUBBER,PIECE,13,500,5508,992,6500,August
1915,ERASER RUBBER BIG,PIECE,8,1000,6780,1220,8000,August
1923,EURO SILK 2200 ORIGINAL,PIECE,140,2200,261017,46983,308000,August
1929,EVERFRESH MANDAZI 2500,PIECE,1,2500,2119,381,2500,August
1931,EVERVESS,PIECE,2,1000,1695,305,2000,August
1935,EXOTIC 320MLS,PIECE,5,1000,4237,763,5000,August
1936,F.D CHOCOLATE MILK 250MLS,PIECE,23,2000,38983,7017,46000,August
1937,F.D FLAVOURED CHOCOLATE,PIECE,9,4000,30508,5492,36000,August
1939,F.D MANGO 100G,PIECE,10,1020,8644,1556,10200,August
1941,F.D MANGO 400G,PIECE,16,2500,33898,6102,40000,August
1942,F.D MANGO 450G,PIECE,15,3700,47034,8466,55500,August
1945,F.D MIXED BERRIES 250G,PIECE,6,2500,12712,2288,15000,August
1946,F.D MIXED BERRIES 400G,PIECE,19,2500,40254,7246,47500,August
1948,F.D PLAIN 250G,PIECE,6,2500,12712,2288,15000,August
1949,F.D PLAIN YOGHURT 400G,PIECE,24,2500,50847,9153,60000,August
1950,F.D PLAIN YOGHURT 450G,PIECE,18,3700,56441,10159,66600,August
1952,F.D STRAWBERRY 100G,PIECE,145,1200,147458,26542,174000,August
1954,F.D STRAWBERRY 200G,PIECE,1,1200,1017,183,1200,August
1955,F.D STRAWBERRY 250G,PIECE,86,2500,182203,32797,215000,August
1956,F.D STRAWBERRY 400G,PIECE,153,2500,324153,58347,382500,August
1957,F.D STRAWBERRY 450G,PIECE,63,3700,197542,35558,233100,August
1958,F.D STRAWBERRY FLAVOURED 250ML,PIECE,58,2000,98305,17695,116000,August
1959,F.D STRAWBERRY MILK 500MLS,PIECE,9,4000,30508,5492,36000,August
1960,F.D UHT 200ML MILK,PIECE,27,1000,22881,4119,27000,August
1961,F.D UHT MILK 2000,PIECE,22,2000,37288,6712,44000,August
1962,F.D UNSALTED BUTTER 250G,PIECE,1,11000,9322,1678,11000,August
1963,F.D VANILLA 100G,PIECE,146,1200,148475,26725,175200,August
1966,F.D VANILLA 250G,PIECE,70,2500,148305,26695,175000,August
1967,F.D VANILLA 400G,PIECE,137,2500,290254,52246,342500,August
1968,F.D VANILLA 450G,PIECE,62,3700,194407,34993,229400,August
1969,F.D VANILLA FLAVOURED 250ML,PIECE,37,2000,62712,11288,74000,August
1970,F.D VANILLA MILK 500MLS,PIECE,6,4000,20339,3661,24000,August
1971,F.D YOGHURT MIXED BERRIES 450G,PIECE,23,3700,72119,12981,85100,August
1973,FA AQUA 50MLS,PIECE,1,6500,5508,992,6500,August
1974,FA CARRIEAN LEMON,PIECE,3,6500,16525,2975,19500,August
1982,FA INVISIBLE POWER,PIECE,2,6500,11017,1983,13000,August
1987,FA MYSTIC MOMENTS,PIECE,1,6500,5508,992,6500,August
1992,FA SPORT RECHARGE 72H,PIECE,2,6000,10169,1831,12000,August
1993,FA SPORT ROLLON 50 ML,PIECE,1,6500,5508,992,6500,August
1995,FA WHITENING & CARE,PIECE,2,6500,11017,1983,13000,August
1999,FACE TOWEL 1000,PIECE,3,1000,2542,458,3000,August
2006,FAMEN FRESHLY FREE,PIECE,1,6500,5508,992,6500,August
2023,FAMILY TEA 250G,PIECE,4,8000,27119,4881,32000,August
2026,FANAKA GUAVA 500ML,PIECE,15,3500,44492,8008,52500,August
2029,FANTA 2LTRS ORANGE,PIECE,59,5000,250000,45000,295000,August
2030,FANTA 330ML CAN,PIECE,15,3000,38136,6864,45000,August
2031,FANTA 330MLS,PIECE,120,1000,101695,18305,120000,August
2032,FANTA 500MLS,PIECE,49,1500,62288,11212,73500,August
2033,FANTA FRUIT BLAST 350ML,PIECE,1,1000,847,153,1000,August
2040,FAX ARGAN&MILK 225G,PIECE,1,5000,4237,763,5000,August
2044,FAX LAVENDER,PIECE,1,8500,7203,1297,8500,August
2060,FAY TP,PIECE,32,2000,54237,9763,64000,August
2070,FIDODIDO CHOCOLATE 120ML,PIECE,12,1200,12203,2197,14400,August
2072,FIDODIDO CHOCO-VAN 220ML,PIECE,27,2500,57203,10297,67500,August
2073,FIDODIDO CHOCO-VANI 500ML,PIECE,2,5000,8475,1525,10000,August
2085,FIDODIDO STRAW-VAN 120MLS,PIECE,92,1200,93559,16841,110400,August
2087,FIDODIDO STRAW-VANI 250ML,PIECE,3,4000,10169,1831,12000,August
2088,FIDODIDO STRAW-VANI 500ML,PIECE,3,5000,12712,2288,15000,August
2089,FIDODIDO STRWABERRY 220ML,PIECE,51,2500,108051,19449,127500,August
2094,FIDODIDO VANILLA SPECIAL,PIECE,2,4000,6780,1220,8000,August
2099,FLASH BALLS 3000,PIECE,1,7500,6356,1144,7500,August
2111,FLOWER C9 SHOWER GEL,PIECE,2,23000,38983,7017,46000,August
2112,FLOWERS 1500,PIECE,1,1500,1271,229,1500,August
2113,FLOWERS 2000,PIECE,2,2000,3390,610,4000,August
2114,FLYMEEGO VESTS 25000,PIECE,2,26000,44068,7932,52000,August
2128,FOGG MARCO SPRAY,PIECE,1,18000,15254,2746,18000,August
2130,FOGG MASTER CEDAR,PIECE,2,18500,31356,5644,37000,August
2132,FOGG MASTER PINE,PIECE,1,18500,15678,2822,18500,August
2150,FOOD COLOUR BLUE,PIECE,1,1000,847,153,1000,August
2151,FOOD COLOUR CHOCOLATE BROWN,PIECE,1,1000,847,153,1000,August
2154,FOOD COLOUR ORANGE,PIECE,3,1000,2542,458,3000,August
2155,FOOD COLOUR PINK,PIECE,2,1000,1695,305,2000,August
2174,FORTUNE BUTTO 1LTR,PIECE,8,8500,57627,10373,68000,August
2175,FORTUNE BUTTO 500ML,PIECE,18,4500,68644,12356,81000,August
2177,FORTUNE GOLD 3LTR,PIECE,2,28000,47458,8542,56000,August
2180,FORTUNE SPAGHETTI 250G,PIECE,3,2000,5085,915,6000,August
2181,FORTUNE SPAGHETTI 450,PIECE,4,3875,13136,2364,15500,August
2183,FOUNTAIN PEN,PIECE,7,8000,47458,8542,56000,August
2203,FRESH DAIRY MILK UHT 500ML,PIECE,66,2000,111864,20136,132000,August
2209,FRESH UP TOOTHPASTE,PIECE,4,2000,6780,1220,8000,August
2233,FRUITVILLE APPLE DRINK,PIECE,14,3500,41525,7475,49000,August
2234,FRUITVILLE GUAVA 500ML,PIECE,25,3500,74153,13347,87500,August
2235,FRUITVILLE MANGO 500ML,PIECE,7,3500,20763,3737,24500,August
2281,GARDEN TEA 250,PIECE,1,14000,11864,2136,14000,August
2283,GARDEN TEA 50G,PIECE,4,2500,8475,1525,10000,August
2284,GARDEN TEA BAGS 100G,PIECE,1,7000,5932,1068,7000,August
2285,GARDENERS COFFEE,PIECE,1,8000,6780,1220,8000,August
2286,GEISHA ALOE VERA&HONEY,PIECE,6,4000,20339,3661,24000,August
2288,GEISHA ALOEVERA &HONEY 125G,PIECE,5,2500,10593,1907,12500,August
2289,GEISHA COCONUT MILK 200G,PIECE,12,4000,40678,7322,48000,August
2290,GEISHA COCONUTMILK 125G,PIECE,4,2500,8475,1525,10000,August
2291,GEISHA LEMON&HONEY,PIECE,15,4000,50847,9153,60000,August
2292,GEISHA LEMON&HONEY 125G,PIECE,5,2500,10593,1907,12500,August
2294,GEISHA MORINGA OIL 125G,PIECE,1,4000,3390,610,4000,August
2295,GEISHA MORINGA OIL 225G,PIECE,2,5500,9322,1678,11000,August
2296,GEISHA ROSE&HONEY,PIECE,7,2500,14831,2669,17500,August
2298,GEISHA ROSE&HONEY 225G,PIECE,4,4000,13559,2441,16000,August
2299,GEISHA SHEA AND ALMOND BUTTER SOAP 225G,PIECE,11,5500,51271,9229,60500,August
2302,GEISHA TRADITIONAL BLACK SOAP,PIECE,12,5500,55932,10068,66000,August
2303,GEISHA TRADITIONAL BLACK SOAP 125G,PIECE,6,4000,20339,3661,24000,August
2310,GIFT BAG 1500,PIECE,5,1500,6356,1144,7500,August
2311,GIFT BAG 2500,PIECE,4,2500,8475,1525,10000,August
2315,GIFT BAG 4500,PIECE,14,4500,53390,9610,63000,August
2316,GIFT BAG BIG 4500,PIECE,2,4500,7627,1373,9000,August
2317,GIFT BAG FLORAL LARGE,PIECE,2,6000,10169,1831,12000,August
2319,GIFT BAG FLORAL SMALL,PIECE,2,2000,3390,610,4000,August
2335,GILITTEY 2 PLUS,PIECE,1,1500,1271,229,1500,August
2342,GILLETTE BLUE2 PLUS,PIECE,31,2500,65678,11822,77500,August
2345,GIRL FRIEND FANTASY LOTION 500ML,PIECE,1,7000,5932,1068,7000,August
2362,GLASSES PLASTIC 4000,PIECE,1,2500,2119,381,2500,August
2371,GLOVES 6000,PIECE,1,6000,5085,915,6000,August
2380,G-NUTS COATED 500,PIECE,3,500,1271,229,1500,August
2393,GOLDEN CLING FILM 25000,PIECE,1,25000,21186,3814,25000,August
2422,GOODIE GINGER BISCUIT 75G,PIECE,19,1000,16102,2898,19000,August
2427,GORILLO'S BBQ BEEF 24G,PIECE,209,500,88559,15941,104500,August
2429,GORILLO'S CHICKEN 24G,PIECE,328,500,138983,25017,164000,August
2431,GORILLO'S CHILLI TOMATO 24G,PIECE,154,500,65254,11746,77000,August
2450,GRAPES 12000,PIECE,12,14083,143220,25780,169000,August
2455,GREEN RIVER POWDER 5G,PIECE,8,1000,6780,1220,8000,August
2476,HABARI SALT BIG,PIECE,19,1000,16102,2898,19000,August
2477,HABARI SALT SMALL,PIECE,1,700,593,107,700,August
2479,HACO RULER,PIECE,3,2000,5085,915,6000,August
2480,HACO RULER ORIGINAL,PIECE,9,2000,15254,2746,18000,August
2497,HANKIES 2000,PIECE,8,2000,13559,2441,16000,August
2498,HANKIES 3000,PIECE,26,3000,66102,11898,78000,August
2501,HANYAN EAR BUDS,PIECE,2,2500,4237,763,5000,August
2511,HARMONY BANANA 300ML,PIECE,1,1000,847,153,1000,August
2513,HARMONY POT WATER,PIECE,76,1000,64407,11593,76000,August
2514,HARMONY POT WATER 1LTR,PIECE,74,2000,125424,22576,148000,August
2517,HARPIC MOUNTAIN PINE,PIECE,3,15000,38136,6864,45000,August
2518,HARPIC ORIGINAL PLUS,PIECE,1,15000,12712,2288,15000,August
2520,HARPIC POWER PLUS 500ML,PIECE,1,14000,11864,2136,14000,August
2530,HEINZ KETCHUP 300G,PIECE,9,8056,61441,11059,72500,August
2559,HIT INSECT KILLER GREENTEA 275ML,PIECE,1,12000,10169,1831,12000,August
2563,HIT INSECT ORANGE 275ML,PIECE,1,12000,10169,1831,12000,August
2564,HIT LILY BLOSSOM 275ML,PIECE,3,12000,30508,5492,36000,August
2595,HOT FRESH 20ML,PIECE,7,2500,14831,2669,17500,August
2596,HOT FRESH HOT PEPPER 60ML,PIECE,4,6000,20339,3661,24000,August
2598,HOT PEPPER POWDER,PIECE,1,4000,3390,610,4000,August
2604,HP FACIAL WIPES 3000,PIECE,9,3111,23729,4271,28000,August
2636,IBON ELVAN SWEETS,PIECE,42,200,7119,1281,8400,August
2637,ICE CUPS 8000,PIECE,2,8000,13559,2441,16000,August
2651,IMPERIAL LEATHER 4*175,PIECE,4,13000,44068,7932,52000,August
2657,IMPERIAL LEATHER MEN 175G,PIECE,2,4500,7627,1373,9000,August
2663,IMPERIAL LEATHER SOAP RED 175G,PIECE,7,4000,23729,4271,28000,August
2666,IMPERIAL LEATHER SPORT 175G,PIECE,2,4500,7627,1373,9000,August
2673,INDO CAFE 50G,PIECE,1,10000,8475,1525,10000,August
2676,INDOCAFE CAPPUCCINO CREAMY,PIECE,9,3000,22881,4119,27000,August
2681,INDOMIE BEEF 70G,PIECE,44,1200,44746,8054,52800,August
2682,INDOMIE BEEF NOODLES 120G,PIECE,27,2000,45763,8237,54000,August
2683,INDOMIE NOODLES 70G,PIECE,71,1200,72203,12997,85200,August
2684,INDOMIE NOODLES CHICKEN 120G,PIECE,6,2000,10169,1831,12000,August
2687,INSPIRE AIR FRESHNER STRAWBERRY,PIECE,1,7000,5932,1068,7000,August
2688,"INSPIRE MANGO A.F lemon,sea mineral",PIECE,4,7000,23729,4271,28000,August
2706,JAGO 100MLS,PIECE,6,4000,20339,3661,24000,August
2710,JAGO AFTERSHAVE 300MLS,PIECE,3,7500,19068,3432,22500,August
2714,JAGO SCRUB 250G,PIECE,5,8000,33898,6102,40000,August
2716,JAMAA WHITE WASHING BAR,PIECE,19,6000,96610,17390,114000,August
2718,JAMIES BROWN BUNS 6PCS,PIECE,179,3500,530932,95568,626500,August
2719,JAMIES BROWN SALT BREAD 1KG,PIECE,5,5500,23305,4195,27500,August
2720,JAMIES BROWN SALT BREAD 500G,PIECE,27,3000,68644,12356,81000,August
2721,JAMIES CAKE @70k,PIECE,5,71000,300847,54153,355000,August
2723,JAMIES CAKES @30k,PIECE,1,30000,25424,4576,30000,August
2724,JAMIES CAKES @ 40K,PIECE,2,40000,67797,12203,80000,August
2725,JAMIES CAKES @50k,PIECE,14,50357,597458,107542,705000,August
2726,JAMIES CAKES @60K,PIECE,10,61000,516949,93051,610000,August
2727,JAMIES COCONUT BREAD 1KG,PIECE,35,5500,163136,29364,192500,August
2728,JAMIES COCONUT BREAD 500G,PIECE,16,3000,40678,7322,48000,August
2729,JAMIE'S COOKIE SCONES,PIECE,35,2000,59322,10678,70000,August
2730,JAMIES CROCKDILE BREAD 1KG,PIECE,1,6000,5085,915,6000,August
2734,JAMIES DOUGH NUTS HUGE,PIECE,116,2000,196610,35390,232000,August
2735,JAMIES DOUGH NUTS SMALL 4000,PIECE,689,3000,1751695,315305,2067000,August
2736,JAMIES COOKIES 4000,PIECE,94,4000,318644,57356,376000,August
2739,JAMIES HOT DOG BUNS 6PCS,PIECE,57,4000,193220,34780,228000,August
2740,JAMIES MANDAZ 8PCS,PIECE,62,3000,157627,28373,186000,August
2744,JAMIES MUFFINS,PIECE,514,1500,653390,117610,771000,August
2748,JAMIES QUEEN CAKES 6PCS 3000,PIECE,153,3500,453814,81686,535500,August
2751,JAMIES SWEET BROWN BREAD1KG,PIECE,292,5500,1361017,244983,1606000,August
2752,JAMIES SWEET BROWN BREAD 500G,PIECE,118,3000,300000,54000,354000,August
2754,JAMIES SWEET CAKE BREAD 1KG,PIECE,166,5946,836441,150559,987000,August
2755,JAMIES SWEET CAKE BREAD 500G,PIECE,50,3000,127119,22881,150000,August
2756,JAMIES SWEET WHITE BREAD 1KG,PIECE,491,5500,2288559,411941,2700500,August
2757,JAMIES SWEET WHITE BREAD 500,PIECE,165,3000,419492,75508,495000,August
2758,JAMIES SWEET WHITE BUNS 12PCS,PIECE,107,3500,317373,57127,374500,August
2759,JAMIES SWEET WHITE BUNS 6PCS,PIECE,207,3500,613983,110517,724500,August
2760,JAMIES SWEET YELLOW BREAD 1KG,PIECE,367,5500,1710593,307907,2018500,August
2761,JAMIES SWEET YELLOW BREAD 500G,PIECE,130,3000,330508,59492,390000,August
2763,JAMIES SWEET YELLOW BUNS 6PCS,PIECE,114,3500,338136,60864,399000,August
2764,JAMIES SWEET YELLOW SCONES,PIECE,1,3500,2966,534,3500,August
2765,JAMIES TWISTED BREAD 1KG,PIECE,4,6000,20339,3661,24000,August
2776,JERRYCAN 20LTR 9000,PIECE,3,10000,25424,4576,30000,August
2780,JESA CHOCOLATE FLAVOURED MILK 200ML,PIECE,12,1500,15254,2746,18000,August
2781,JESA FINO BOX,BOX,2,24000,40678,7322,48000,August
2782,JESA FLAVOURED CHOCO 500ML,PIECE,18,4000,61017,10983,72000,August
2783,JESA FLAVOURED MILK BOX,BOX,1,30000,25424,4576,30000,August
2784,JESA FLAVOURED STRAW 500ML,PIECE,15,4000,50847,9153,60000,August
2785,JESA FLAVOURED VANILLA 500ML,PIECE,11,4000,37288,6712,44000,August
2789,JESA FRUIT STRAWBERRY 500G,PIECE,10,6000,50847,9153,60000,August
2791,JESA LONGLIFE UHT BOX,BOX,3,36667,93220,16780,110000,August
2792,JESA MILK 1LTR,PIECE,186,3600,567458,102142,669600,August
2793,JESA MILK 500ML,PIECE,1184,1800,1806102,325098,2131200,August
2794,JESA MILK UHT 500ML,PIECE,89,2200,165932,29868,195800,August
2796,JESA PLAIN YOGHURT 500G,PIECE,21,3700,65847,11853,77700,August
2797,JESA STRAW 250G YOGHURT,PIECE,15,2500,31780,5720,37500,August
2799,JESA STRAW YOGHURT 400G,PIECE,59,2500,125000,22500,147500,August
2801,JESA STRAWBERRY MILK 200MLS,PIECE,49,1500,62288,11212,73500,August
2802,JESA STRAWBERRY YOGHURT 500G,PIECE,25,3700,78390,14110,92500,August
2803,JESA TOFFEE 250G,PIECE,8,2500,16949,3051,20000,August
2804,JESA TOFFEE YOGHURT 500G,PIECE,29,3700,90932,16368,107300,August
2805,JESA UHT FINO,PIECE,47,2000,79661,14339,94000,August
2811,JESA VANILLA YOGHURT 250G,PIECE,19,2500,40254,7246,47500,August
2812,JESA VANILLA YOGHURT 400G,PIECE,67,2500,141949,25551,167500,August
2813,JESA VANILLA YOGHURT 500G,PIECE,21,3700,65847,11853,77700,August
2819,JIAAI BABY SOOTHER CHART,PIECE,1,2000,1695,305,2000,August
2824,JIB WATER 18.9LTRS REFILL,PIECE,1,7000,5932,1068,7000,August
2825,JIB WATER 20LTRS REFILL,PIECE,5,8000,33898,6102,40000,August
2830,JIK COLOURS 250MLS,PIECE,2,7000,11864,2136,14000,August
2831,JIK REGULAR 250MLS,PIECE,5,6500,27542,4958,32500,August
2833,JIK REGULAR 750MLS,PIECE,5,14000,59322,10678,70000,August
2857,JOHNSON BABY JELLY FRANGRANCE FREE 100ML,PIECE,2,10000,16949,3051,20000,August
2859,JOHNSON BABY OIL 125MLS,PIECE,1,20000,16949,3051,20000,August
2874,JOHNSON SOAP 100G BLUE,PIECE,3,6000,15254,2746,18000,August
2882,JOHNSON'S BABY JELLY LIGHTLY FRANGRANCED,PIECE,2,10000,16949,3051,20000,August
2916,JUMBO BLUE SWIRL 175ML,PIECE,11,4000,37288,6712,44000,August
2917,JUMBO CHOCOLATE RIPPLE 175MLS,PIECE,11,3500,32627,5873,38500,August
2921,JUMBO STRAWBERRY RIPPLE 175ML,PIECE,14,4000,47458,8542,56000,August
2933,KABODY COCONUT MILK 1KG,PIECE,5,6500,27542,4958,32500,August
2934,KABODY COMPOSITE FLOUR,PIECE,3,6000,15254,2746,18000,August
2935,KABODY ENKEJJE SOYA RICE 1KG,PIECE,4,6500,22034,3966,26000,August
2936,KABODY MILLET SOYA PORRIDGE,PIECE,2,6500,11017,1983,13000,August
2939,KABODY OATS SOYA RICE 1KG,PIECE,1,6500,5508,992,6500,August
2940,KABODY PUMPKIN PORRIDGE 1KG,PIECE,2,6500,11017,1983,13000,August
2941,KABODY PUMPKIN SEED 1KG,PIECE,1,6500,5508,992,6500,August
2942,KABODY PURE MILLET 1KG,PIECE,2,6250,10593,1907,12500,August
2943,KABODY QUICK PORRIDGE1KG,PIECE,1,6500,5508,992,6500,August
2944,KABODY RICE FLOUR 1KG,PIECE,3,6500,16525,2975,19500,August
2945,KABODY SOYA PORRIDGE,PIECE,3,6167,15678,2822,18500,August
2950,KAKIRA SUGAR 1KG,PIECE,67,5500,312288,56212,368500,August
2952,KAKIRA SUGAR 2KG,PIECE,19,10000,161017,28983,190000,August
2962,KANGARO STAPLES,PIECE,1,2000,1695,305,2000,August
2985,KAZIRE ALOEVERA,PIECE,26,1500,33051,5949,39000,August
2986,KAZIRE LEMON TEA,PIECE,10,2000,16949,3051,20000,August
2987,KAZIRE ORANGE,PIECE,4,2000,6780,1220,8000,August
2988,KAZIRE POWER TONIC,PIECE,5,2000,8475,1525,10000,August
2989,KAZIRE RED TONIC 350MLS,PIECE,4,2000,6780,1220,8000,August
2990,KAZIRE VIT FRUIT,PIECE,11,2000,18644,3356,22000,August
2992,KELLOGS CORNFLAKES 500g,PIECE,2,27000,45763,8237,54000,August
3049,KEY HOLDERS 2000,PIECE,1,2000,1695,305,2000,August
3050,KEY HOLDERS 2500,PIECE,1,2500,2119,381,2500,August
3051,KEY HOLDERS 3500,PIECE,9,3500,26695,4805,31500,August
3052,KIBIMBA RICE 2KG,PIECE,4,15500,52542,9458,62000,August
3054,KIBIMBA RICE IKG,PIECE,3,8000,20339,3661,24000,August
3060,KICK SNACKS CHICKEN,PIECE,215,500,91102,16398,107500,August
3085,KIDS TOOTHBRUSH 1000,PIECE,2,1000,1695,305,2000,August
3091,KIDS WATCH 10000,PIECE,3,10000,25424,4576,30000,August
3094,KIDS WATCHES 7000,PIECE,5,7200,30508,5492,36000,August
3100,KIMBO 500G,PIECE,3,7500,19068,3432,22500,August
3103,KINGTAT 800,PIECE,13,1038,11441,2059,13500,August
3111,KIRUNGI ALOEVERA 250ML,PIECE,1,1000,847,153,1000,August
3114,KIRUNGI KITUZI,PIECE,2,1000,1695,305,2000,August
3119,KISUBI 85GM,PIECE,2,1500,2542,458,3000,August
3130,KITUZI,PIECE,17,1000,14407,2593,17000,August
3131,KIWI 20G,PIECE,1,3500,2966,534,3500,August
3133,KIWI BLACK 80G,PIECE,7,8000,47458,8542,56000,August
3136,KIWI DARK TAN 25ML,PIECE,1,2500,2119,381,2500,August
3140,KIWI POLISH 12G,PIECE,3,2500,6356,1144,7500,August
3143,KIWI SHOE POLISH 32G,PIECE,2,5000,8475,1525,10000,August
3145,KIWI SUEDE CLEANER NEUTRAL,PIECE,2,7500,12712,2288,15000,August
3151,KNICKERS 3000,PIECE,1,3000,2542,458,3000,August
3152,KNICKERS 3500,PIECE,6,3500,17797,3203,21000,August
3153,KNICKERS 4000,PIECE,5,4000,16949,3051,20000,August
3156,KNICKERS 7000,PIECE,7,7000,41525,7475,49000,August
3157,KNICKERS 8000,PIECE,2,8000,13559,2441,16000,August
3158,KNICKERS 9000,PIECE,4,9000,30508,5492,36000,August
3159,KNIFE 3000,PIECE,1,3000,2542,458,3000,August
3171,KOFA MATHEMATICAL SET,PIECE,6,4000,20339,3661,24000,August
3198,KOOKSY VANILLA 220ML,PIECE,4,2000,6780,1220,8000,August
3202,KOOKSY VANILLA CHOCOLATE 220ML,PIECE,2,2000,3390,610,4000,August
3212,KOPIKO 3 IN 1 COFFEE,PIECE,2,2000,3390,610,4000,August
3213,KOPIKO BLANCA CREAMY,PIECE,7,2000,11864,2136,14000,August
3214,KOPIKO BROWN COFFEE,PIECE,16,1500,20339,3661,24000,August
3217,KREST 500MLS,PIECE,45,1500,57203,10297,67500,August
3221,KRYSTAL WATER 500ML,PIECE,33,1000,27966,5034,33000,August
3234,KYOGERO HERBAL JELLY 100ML,PIECE,2,3500,5932,1068,7000,August
3236,KYOGERO HERBAL JELLY 250G,PIECE,1,7500,6356,1144,7500,August
3237,KYOGERO HERBAL JELLY 50G,PIECE,2,2000,3390,610,4000,August
3238,KYOGERO HERBAL JELLY40G,PIECE,2,1500,2542,458,3000,August
3239,KYOGERO HERBAL SOAP 120G,PIECE,6,3500,17797,3203,21000,August
3242,LA BELLE APRICOT SCRUB,PIECE,4,8000,27119,4881,32000,August
3248,LA BELLE SHAMPOO 1LTR,PIECE,1,7500,6356,1144,7500,August
3259,LABELLE BODY LOTION SHEA BUTTER,PIECE,1,11000,9322,1678,11000,August
3275,LANZO ANTI-BACTERIAL SOAP,PIECE,4,3500,11864,2136,14000,August
3277,LANZO COCONUT SHEA SOAP,PIECE,2,3500,5932,1068,7000,August
3279,LANZO VANILLA SOAP,PIECE,2,3500,5932,1068,7000,August
3284,LATO CHOCO PWDER MILK 15G,PIECE,25,500,10593,1907,12500,August
3285,LATO CHOCOLATE MILK 250MLS,PIECE,46,2000,77966,14034,92000,August
3290,LATO FLAVOURED BOX 23000,BOX,1,23000,19492,3508,23000,August
3291,LATO GHEE 500G,PIECE,2,16000,27119,4881,32000,August
3293,LATO MILK 250G,PIECE,6,13667,69492,12508,82000,August
3294,LATO MILK 400G,PIECE,9,20333,155085,27915,183000,August
3295,LATO MILK 900G,PIECE,5,50400,213559,38441,252000,August
3296,LATO MILK CHOCOLATE 125ML FLAVOURED,PIECE,88,1000,74576,13424,88000,August
3298,LATO MILK POWDER 15G,PIECE,146,500,61864,11136,73000,August
3299,LATO MILK PWDER STRAWBERRY 15G,PIECE,13,500,5508,992,6500,August
3300,LATO MILK UHT 200ML,PIECE,16,1000,13559,2441,16000,August
3302,LATO MIXED BERRIES 250G,PIECE,8,3000,20339,3661,24000,August
3304,LATO PEACH&CARAMEL 250G,PIECE,18,3000,45763,8237,54000,August
3305,LATO PEACH&CARAMEL FRUIT 450G,PIECE,15,5500,69915,12585,82500,August
3306,LATO PLAIN YOGHURT 500G,PIECE,17,3700,53305,9595,62900,August
3307,LATO POWDERED MILK 2.5KG,PIECE,2,104000,176271,31729,208000,August
3309,LATO STRAWBERRY MILK 125MLS,PIECE,80,1000,67797,12203,80000,August
3310,LATO STRAWBERRY MILK 250MLS,PIECE,34,2000,57627,10373,68000,August
3311,LATO STRAWBERRY YOGHURT 500G,PIECE,11,3700,34492,6208,40700,August
3315,LATO VANILLA 100G,PIECE,13,1200,13220,2380,15600,August
3316,LATO VANILLA 125ML MILK,PIECE,83,1000,70339,12661,83000,August
3317,LATO VANILLA MILK 250MLS,PIECE,39,2000,66102,11898,78000,August
3319,LATO VANILLA YOGHURT 500G,PIECE,14,3700,43898,7902,51800,August
3321,LATO YOG MIXED BERRIES 450G,PIECE,13,5500,60593,10907,71500,August
3322,LATO YOG STRAWBERRY 100G,PIECE,40,1200,40678,7322,48000,August
3323,LATO YOG STRAWBERRY 250G,PIECE,23,2500,48729,8771,57500,August
3324,LATO YOGHURT 400G VANILLA,PIECE,27,2500,57203,10297,67500,August
3325,LATO YOGHURT SRAWBERRY 200G,PIECE,83,1000,70339,12661,83000,August
3326,LATO YOGHURT STRAWBERRY 400G,PIECE,20,2500,42373,7627,50000,August
3327,LATO YOGHURT VANILLA 200G,PIECE,110,1000,93220,16780,110000,August
3335,LAVITA PINEAPPLE 320MLS,PIECE,21,1000,17797,3203,21000,August
3361,LEMON CAKES 1000,PIECE,93,1200,94576,17024,111600,August
3378,LIGHTERS,PIECE,9,1000,7627,1373,9000,August
3401,LMZ HREBAL 120G,PIECE,2,5000,8475,1525,10000,August
3419,LOVE CHOCOLATE,PIECE,10,3500,29661,5339,35000,August
3433,LUCOZADE 1LTR,PIECE,20,10000,169492,30508,200000,August
3434,LUCOZADE 250ML,PIECE,5,3000,12712,2288,15000,August
3435,LUCOZADE 250MLS,PIECE,37,3000,94068,16932,111000,August
3458,LUXURY TOILET PAPER,PIECE,83,600,42203,7597,49800,August
3465,M&G COUNTER BOOK AQUIRE,PIECE,1,5000,4237,763,5000,August
3472,M&G HELLO BEARS PEN ERASE,PIECE,11,2500,23305,4195,27500,August
3475,M&G INK CATRIDGE,PIECE,4,4000,13559,2441,16000,August
3526,MACRO DENTAL FLOSS,PIECE,6,3000,15254,2746,18000,August
3533,MAGANJO BABY SOYA 1KG,PIECE,5,6500,27542,4958,32500,August
3535,MAGANJO BABY SOYA WITH MILK 500G,PIECE,4,8500,28814,5186,34000,August
3539,MAGANJO ENERGY BOOSTER 1KG,PIECE,3,6500,16525,2975,19500,August
3548,MAGANJO PURE MILLET 1KG,PIECE,3,6500,16525,2975,19500,August
3552,MAGANJO SOYA MILLET,PIECE,3,6500,16525,2975,19500,August
3553,MAGANJO SOYA RICE 1KGS,PIECE,7,7500,44492,8008,52500,August
3557,MAGANJO SUPER RICE 1KG,PIECE,3,6500,16525,2975,19500,August
3560,MAGIC 1KG SACHET,PIECE,7,8500,50424,9076,59500,August
3561,MAGIC 1KG BUCKET,PIECE,1,12500,10593,1907,12500,August
3562,MAGIC 250G BUCKET,PIECE,9,4000,30508,5492,36000,August
3563,MAGIC 500G BUCKET,PIECE,9,6500,49576,8924,58500,August
3564,MAGIC 500G SACHET,PIECE,19,4500,72458,13042,85500,August
3566,MAGIC SACHET 45G,PIECE,7,500,2966,534,3500,August
3575,MAKE UP FACIAL WIPES,PIECE,8,3500,23729,4271,28000,August
3584,MAMIS PEANUT PASTE 1KG,PIECE,6,15000,76271,13729,90000,August
3585,MAMIS PEANUT PASTE 500G,PIECE,5,8000,33898,6102,40000,August
3588,MANILA PAPERS 1000,PIECE,4,1000,3390,610,4000,August
3596,MANUSCRIPT,PIECE,3,16667,42373,7627,50000,August
3598,MANUSCRIPT BOOK 2Q,PIECE,1,12000,10169,1831,12000,August
3607,MARIKA ICING SUGAR 500G,PIECE,5,4000,16949,3051,20000,August
3609,MARS CHOCOLATE,PIECE,4,3500,11864,2136,14000,August
3610,MARSHMALLOW DELICIOUS ASSORTED 15G,PIECE,5,2000,8475,1525,10000,August
3618,MASSAGE OLIVE OIL,PIECE,1,15000,12712,2288,15000,August
3619,MASTER MATHEMATIC SET,PIECE,3,4667,11864,2136,14000,August
3620,MATHEMATICAL SET,PIECE,1,4000,3390,610,4000,August
3622,CAR TOY 15000,PIECE,1,15000,12712,2288,15000,August
3625,MAYONNAISE 237ML,PIECE,5,20000,84746,15254,100000,August
3626,MAYONNAISE BIG 887ML,PIECE,1,32000,27119,4881,32000,August
3628,MAYONNAISE MEDIUM 473ML,PIECE,2,25000,42373,7627,50000,August
3633,MEGA PASTA 400G,PIECE,9,4000,30508,5492,36000,August
3635,MELEX BAGIYA 1000,PIECE,9,1000,7627,1373,9000,August
3636,MELEX BAGIYA 2000,PIECE,1,2000,1695,305,2000,August
3638,MELEX DADDIES 100G 2000,PIECE,1,2000,1695,305,2000,August
3644,MELEX G.NUTS 1000,PIECE,19,1053,16949,3051,20000,August
3645,MELEX G.NUTS 2000,PIECE,8,2000,13559,2441,16000,August
3646,MELEX G-NUTS 250GM 6500,PIECE,5,5000,21186,3814,25000,August
3648,MELEX HARDCORNS 1000,PIECE,14,1000,11864,2136,14000,August
3649,MELEX HARDCORNS 2000,PIECE,3,2000,5085,915,6000,August
3653,MELEX SIMSIM 170G 2000,PIECE,3,2000,5085,915,6000,August
3654,MELEX SIMSIM 85G 1000,PIECE,9,1000,7627,1373,9000,August
3656,MELEX SIMSIM BALLS 2000,PIECE,2,3500,5932,1068,7000,August
3663,MEN BOXERS 10000,PIECE,4,10000,33898,6102,40000,August
3669,MEN SOCKS 3500,PIECE,1,3500,2966,534,3500,August
3672,MENTHOXYL,PIECE,1,500,424,76,500,August
3674,MENTOS GRAPE,PIECE,11,2500,23305,4195,27500,August
3675,MENTOS GRAPE FLAVOUR,PIECE,1,2500,2119,381,2500,August
3682,MESSAGE CARDS 500,PIECE,5,500,2119,381,2500,August
3684,MIA GONJA 1000,PIECE,5,1600,6780,1220,8000,August
3690,MIKOSHI GREEN TEA,PIECE,28,6000,142373,25627,168000,August
3721,MINUTE MAID 1LTRS,PIECE,81,5000,343220,61780,405000,August
3723,MINUTE MAID BERRY BLAST 400MLS,PIECE,41,2500,86864,15636,102500,August
3724,MINUTE MAID BOOST MANGO,PIECE,1,2500,2119,381,2500,August
3725,Minute maid mango,PIECE,94,2500,199153,35847,235000,August
3729,MINUTEMAID BERRY BLAST 1LTR,PIECE,53,5000,224576,40424,265000,August
3736,MIRINDA APPLE,PIECE,55,1500,69915,12585,82500,August
3737,MIRINDA APPLE 2LTR,PIECE,41,4500,156356,28144,184500,August
3738,MIRINDA APPLE 330ML,PIECE,76,1000,64407,11593,76000,August
3739,MIRINDA FRUITY,PIECE,39,1500,49576,8924,58500,August
3740,MIRINDA FRUITY 2LTR,PIECE,35,4500,133475,24025,157500,August
3741,MIRINDA FRUITY 330MLS,PIECE,101,1000,85593,15407,101000,August
3742,MIRINDA ORANGE 2LTRS,PIECE,25,4500,95339,17161,112500,August
3743,MIRINDA ORANGE 330ML,PIECE,56,1000,47458,8542,56000,August
3744,MIRINDA ORANGE 500ML,PIECE,25,1500,31780,5720,37500,August
3745,MIRINDA PINEAPPLE,PIECE,29,1500,36864,6636,43500,August
3747,MIRINDA PINEAPPLE 330ML,PIECE,33,1000,27966,5034,33000,August
3748,MIRROR 1500,PIECE,2,1500,2542,458,3000,August
3750,MIRRORS 2500,PIECE,2,2500,4237,763,5000,August
3760,MOCACINE SOCKS 2000,PIECE,8,2000,13559,2441,16000,August
3761,MOCACINE SOCKS 2500,PIECE,1,2500,2119,381,2500,August
3786,MONACO MIST,PIECE,2,16000,27119,4881,32000,August
3809,MOPPER 7000,PIECE,2,7000,11864,2136,14000,August
3812,MOPPERS 12000,PIECE,1,12000,10169,1831,12000,August
3813,MOPPERS 15000,PIECE,1,15000,12712,2288,15000,August
3840,MORTEIN LEMON 180ML,PIECE,2,15000,25424,4576,30000,August
3843,MORTEIN ODOURLESS 180MLS,PIECE,2,15000,25424,4576,30000,August
3844,MORTEIN ODOURLESS 300MLS,PIECE,1,22000,18644,3356,22000,August
3845,MORTEIN ODOURLESS 400ML,PIECE,2,28000,47458,8542,56000,August
3846,MORTEIN ODOURLESS 600ML,PIECE,2,33000,55932,10068,66000,August
3855,MOTH BALLS 4000,PIECE,6,7000,35593,6407,42000,August
3862,MOUNTAIN DEW,PIECE,34,1500,43220,7780,51000,August
3863,MOUNTAIN DEW 2LTR,PIECE,37,4500,141102,25398,166500,August
3864,MOUNTAIN DEW 300MLS,PIECE,110,1000,93220,16780,110000,August
3867,MOUSE &RAT TRAPS GREEN,PIECE,13,3000,33051,5949,39000,August
3869,MOVIT BABY JELLY 110G,PIECE,1,3000,2542,458,3000,August
3875,MOVIT BABYJELLY 50g,PIECE,4,1500,5085,915,6000,August
3878,MOVIT BODY MILK 240ML LOTION,PIECE,1,3500,2966,534,3500,August
3886,MOVIT EGG SHAMPOO 1LTR,PIECE,1,7000,5932,1068,7000,August
3887,MOVIT FAMILY SOAP 230G,PIECE,3,4000,10169,1831,12000,August
3888,MOVIT FAMILY SOAP ALOE 120G,PIECE,3,2500,6356,1144,7500,August
3889,MOVIT FAMILY SOAP ALOE 230G,PIECE,7,4000,23729,4271,28000,August
3890,MOVIT FAMILY SOAP ALOE V.P,PIECE,2,7000,11864,2136,14000,August
3891,MOVIT FAMILY SOAP COCOMUT 125G,PIECE,3,2500,6356,1144,7500,August
3892,MOVIT FAMILY SOAP COCONUT 230G,PIECE,2,4000,6780,1220,8000,August
3893,MOVIT FAMILY SOAP LEMON V.P,PIECE,4,7000,23729,4271,28000,August
3894,MOVIT FAMILY SOAP ROSE 125G,PIECE,3,2500,6356,1144,7500,August
3895,MOVIT FAMILY SOAP ROSE 230G,PIECE,5,4000,16949,3051,20000,August
3896,MOVIT FAMILY SOAP V.P COCONUT,PIECE,4,7000,23729,4271,28000,August
3897,MOVIT FAMILY SOAP V.P ROSE,PIECE,2,7000,11864,2136,14000,August
3903,MOVIT HAIR FOOD 70G,PIECE,3,3000,7627,1373,9000,August
3906,MOVIT HERBAL JELLY 120G,PIECE,1,3500,2966,534,3500,August
3911,MOVIT HERBAL SOAP 120G,PIECE,3,3000,7627,1373,9000,August
3913,MOVIT JELLY 200G,PIECE,2,5250,8898,1602,10500,August
3915,MOVIT JELLY 50G,PIECE,1,1500,1271,229,1500,August
3932,MOVIT SULPHUR 60G,PIECE,3,2500,6356,1144,7500,August
3933,MOVIT SULPHUR 90G,PIECE,1,5000,4237,763,5000,August
3935,MOZZARELLA CHEESE 500G,PIECE,2,13000,22034,3966,26000,August
3937,MR GREEN SCOURING PADS,PIECE,1,6000,5085,915,6000,August
3939,MR.ZECO SWEETS,PIECE,1,300,254,46,300,August
3944,MUKISA CAKE 2500,PIECE,17,2500,36017,6483,42500,August
3945,MUKISA MANDAZI,PIECE,2,3000,5085,915,6000,August
3946,MUKISA MANDAZI 1000,PIECE,2,1500,2542,458,3000,August
3954,MUKWANO OIL 1LTR JERRYCAN,PIECE,1,10000,8475,1525,10000,August
3956,MUKWANO OIL 500ML JERRYCAN,PIECE,12,5500,55932,10068,66000,August
3958,MUKWANO TEA BAGS 100G,PIECE,1,5500,4661,839,5500,August
3967,MUSAWO BODY JELLY,PIECE,1,2500,2119,381,2500,August
3972,MUSAWO SOAP 120G,PIECE,1,2000,1695,305,2000,August
3973,MUSAWO SOAP 240G,PIECE,3,3500,8898,1602,10500,August
3994,NACET 500 PCS,PIECE,5,500,2119,381,2500,August
3995,NACET BLADES 2500 PKT,PIECE,5,2500,10593,1907,12500,August
3996,Nail cutter,PIECE,2,1000,1695,305,2000,August
3997,NAIL CUTTER 2500,PIECE,7,2500,14831,2669,17500,August
3998,NAIL CUTTERS 1500,PIECE,8,1500,10169,1831,12000,August
4000,NAN OPTIPRO 1 400G,PIECE,1,62000,52542,9458,62000,August
4001,NANA HERBAL MOUTH 60MLS,PIECE,3,7500,19068,3432,22500,August
4019,NASA HAIR REMOVAL LEMON 50ML,PIECE,1,7000,5932,1068,7000,August
4023,NATARAJ PENCILS 6000,PIECE,1,6000,5085,915,6000,August
4024,NATARAJ PENS,PIECE,17,700,10085,1815,11900,August
4030,NATURAL SPONGE 2000,PIECE,2,2000,3390,610,4000,August
4034,NEEK YOGHURT 1LTR,PIECE,13,7000,77119,13881,91000,August
4035,NEEK YOGHURT 300G 2000,PIECE,4,2500,8475,1525,10000,August
4036,NEEK YOGHURT 500G 3500,PIECE,10,3500,29661,5339,35000,August
4043,NESCAFE CLASSIC 100G,PIECE,1,25000,21186,3814,25000,August
4044,NESCAFE CLASSIC 200G,PIECE,3,29000,73729,13271,87000,August
4045,NESCAFE CLASSIC 2G,PIECE,104,500,44068,7932,52000,August
4046,NESCAFE CLASSIC 50G,PIECE,6,14667,74576,13424,88000,August
4047,NESCAFE CLASSIC SACHETS 1.6G,PIECE,2,500,847,153,1000,August
4050,NESCAFE ORIGINAL 1000,PIECE,26,1500,33051,5949,39000,August
4051,NESTLE KITKAT,PIECE,2,3500,5932,1068,7000,August
4052,NEVIA PEARL&BEAUTY ROLLON,PIECE,1,11000,9322,1678,11000,August
4055,NEWFARM BANANA JUICE 320ML,PIECE,7,2500,14831,2669,17500,August
4056,NEWFARM BANANA JUICE 500ML,PIECE,13,3500,38559,6941,45500,August
4081,NICE CLEAR PENS,PIECE,26,500,11017,1983,13000,August
4082,NICE TOOTHBRUSH,PIECE,12,1000,10169,1831,12000,August
4083,NICE& LOVELY ALOE 48HRS 400ML,PIECE,2,10000,16949,3051,20000,August
4085,NICE&LOVELY ALOE 200ML,PIECE,1,6000,5085,915,6000,August
4096,NIGHTROSE POWDER 1OOMLS,PIECE,1,4000,3390,610,4000,August
4117,NISA CUCUMBER HAIR REMOVAL 20ML,PIECE,3,2000,5085,915,6000,August
4119,NISA HAIR REMOVAL CUCUMBER 50ML,PIECE,2,7000,11864,2136,14000,August
4120,NISA HAIR REMOVAL LEMON 100ML,PIECE,1,10000,8475,1525,10000,August
4121,NISA HAIR REMOVAL ROSE 100ML,PIECE,2,10000,16949,3051,20000,August
4123,NISA LEMON HAIR REMOVAL CREME 20ML,PIECE,1,2000,1695,305,2000,August
4124,NISA NORMAL SKIN,PIECE,1,5500,4661,839,5500,August
4125,NISA ROSE HAIR REMOVAL CREAM 20ML,PIECE,1,2000,1695,305,2000,August
4128,NIVANA 500MLS,PIECE,246,500,104237,18763,123000,August
4131,NIVANA WATER 1.5L,PIECE,69,1500,87712,15788,103500,August
4134,NIVEA BLACK & WHITE 50ML,PIECE,3,11000,27966,5034,33000,August
4137,NIVEA BLACK&WHITE ROLLON,PIECE,1,11000,9322,1678,11000,August
4139,NIVEA COOL KICK 400MLS,PIECE,2,20000,33898,6102,40000,August
4140,NIVEA COOL KICK ROLLON,PIECE,4,11750,39831,7169,47000,August
4141,NIVEA DEEP AMAZONIA,PIECE,6,11000,55932,10068,66000,August
4143,NIVEA DRY IMPACT ROLLON,PIECE,2,11000,18644,3356,22000,August
4144,NIVEA DRYCOMFORT SPRAY,PIECE,1,17000,14407,2593,17000,August
4147,NIVEA FRESH ENERGY 50ML,PIECE,3,11000,27966,5034,33000,August
4158,NIVEA MEN DEEP ROLLON,PIECE,2,11000,18644,3356,22000,August
4162,NIVEA MEN FRESH ACTIVE 50ML,PIECE,2,11000,18644,3356,22000,August
4167,NIVEA MEN MAXIMUM HYDRATION 400ML,PIECE,2,20000,33898,6102,40000,August
4168,NIVEA MEN REVITALIZING,PIECE,2,20000,33898,6102,40000,August
4173,NIVEA NOURISHING COCOA LOTION 400ML,PIECE,1,20000,16949,3051,20000,August
4178,NIVEA REPAIR& CARE 72H 400ML,PIECE,1,20000,16949,3051,20000,August
4190,NOMI 250G BUCKET,PIECE,9,4000,30508,5492,36000,August
4191,NOMI BUCKET 1KG,PIECE,6,12500,63559,11441,75000,August
4192,NOMI BUCKET 500G,PIECE,5,6500,27542,4958,32500,August
4195,NOTE BOOK 2000,PIECE,3,2000,5085,915,6000,August
4196,NOTE BOOK 3000,PIECE,4,3000,10169,1831,12000,August
4198,NOTE BOOK 4000,PIECE,9,4000,30508,5492,36000,August
4199,NOTE BOOK 5500,PIECE,15,5500,69915,12585,82500,August
4201,NOTE BOOK SPIRAL 10000,PIECE,3,10000,25424,4576,30000,August
4208,NOVIDA 350MLS,PIECE,75,1000,63559,11441,75000,August
4209,NOVIDA 500MLS,PIECE,44,1500,55932,10068,66000,August
4217,NTALE HERBAL SOAP 100G,PIECE,2,3500,5932,1068,7000,August
4218,NUMA BUSHERA 1KG,PIECE,16,6500,88136,15864,104000,August
4219,NUMA BUSHERA 2KG,PIECE,7,12000,71186,12814,84000,August
4220,NUMA KARO 1KG,PIECE,3,6500,16525,2975,19500,August
4222,NUMA RICE FLOUR 1KG,PIECE,4,7500,25424,4576,30000,August
4223,NUMA SOYA RICE 1KG,PIECE,3,7000,17797,3203,21000,August
4225,NUMA SOYARICE WITH NKEJJE 500G,PIECE,1,5000,4237,763,5000,August
4229,NUSS CHOCOLATE,PIECE,17,1000,14407,2593,17000,August
4235,NUTRO CHOC CREAM WAFERS,PIECE,7,6500,38559,6941,45500,August
4236,NUTRO CHOCOLATE BISCUITS,PIECE,60,1200,61017,10983,72000,August
4239,NUTRO CREAM WAFERS 3,PIECE,3,6500,16525,2975,19500,August
4241,NUTRO DIGESTIVE LIGHT,PIECE,1,6500,5508,992,6500,August
4247,NUTRO TEA BISCUIT,PIECE,19,3605,58051,10449,68500,August
4248,NUTRO VANILLA 30G,PIECE,93,1200,94576,17024,111600,August
4251,NUTRO WAFERS CHOCOLATE,PIECE,1,3500,2966,534,3500,August
4252,NUTRO WAFERS VANILLA,PIECE,11,3500,32627,5873,38500,August
4263,NUVITA CHOCO BISCUITS,PIECE,7,2000,11864,2136,14000,August
4264,NUVITA CHOCOLATE CREAM,PIECE,5,1500,6356,1144,7500,August
4267,NUVITA GINGER BISCUITS 75G,PIECE,8,2000,13559,2441,16000,August
4270,NUVITA GLUCOSE 75G,PIECE,12,1500,15254,2746,18000,August
4271,NUVITA GO COOKIES,PIECE,16,2000,27119,4881,32000,August
4272,NUVITA LEMON BISCUITS 750,PIECE,7,1500,8898,1602,10500,August
4274,NUVITA ORANGE CREAM BISCUITS,PIECE,8,1375,9322,1678,11000,August
4275,NUVITA STRAWBERRY CREAMS 75G,PIECE,5,1500,6356,1144,7500,August
4276,NUVITA VITAMILK BISCUITS,PIECE,10,1500,12712,2288,15000,August
4284,OATIBIX 500G,PIECE,4,12000,40678,7322,48000,August
4292,ODO SMILE TOILET BALLS,PIECE,8,6500,44068,7932,52000,August
4296,OFFICE POINT PENS,PIECE,1,700,593,107,700,August
4318,OLITALIA EXTRA VIRGIN OIL 500ML,PIECE,2,48000,81356,14644,96000,August
4323,OLITALIA OLIVE OIL POMACE 500ML,PIECE,1,35000,29661,5339,35000,August
4324,OLITALIA OLIVE POMACE 100ML,PIECE,2,13000,22034,3966,26000,August
4326,OLIVE OIL BODY WHIP 444ML,PIECE,3,28000,71186,12814,84000,August
4333,OMO 40G FRESH,PIECE,1,500,424,76,500,August
4334,OMO AUTO WASHING POWDER 1KG,PIECE,3,21000,53390,9610,63000,August
4335,OMO BLEACH COLOUR SAFE 700ML.,PIECE,6,9000,45763,8237,54000,August
4336,OMO BLEACH LEMON,PIECE,2,8000,13559,2441,16000,August
4337,OMO BLEACH MULTI -PURPOSE,PIECE,6,4000,20339,3661,24000,August
4339,OMO BLEACH REGULAR,PIECE,3,8000,20339,3661,24000,August
4340,OMO BLEACH REGULAR 250ML,PIECE,1,3500,2966,534,3500,August
4342,OMO COMFORT 1KG,PIECE,2,13000,22034,3966,26000,August
4343,OMO COMFORT 500G,PIECE,4,7500,25424,4576,30000,August
4344,OMO FAST ACTION 1KG,PIECE,4,13000,44068,7932,52000,August
4345,OMO FAST ACTION 3.5KG,PIECE,2,40000,67797,12203,80000,August
4346,OMO FAST ACTION 500G,PIECE,4,7500,25424,4576,30000,August
4347,ONER APPLE JUICE DRINK,PIECE,144,2500,305085,54915,360000,August
4348,ONER BERRIES 300ML,PIECE,181,1500,230085,41415,271500,August
4349,ONER BERRIES JUICE DRINK,PIECE,99,2500,209746,37754,247500,August
4350,ONER MANGO 1LTR,PIECE,9,5000,38136,6864,45000,August
4351,ONER MANGO 500MLS,PIECE,154,2500,326271,58729,385000,August
4364,ORANGES 2000,PIECE,57,2000,96610,17390,114000,August
4365,ORCHID VALLEY APPLE 1LTR,PIECE,5,7500,31780,5720,37500,August
4367,ORCHID VALLEY GUAVA 1LTR,PIECE,11,7500,69915,12585,82500,August
4368,ORCHID VALLEY MANGO 1LTR6161101061483,PIECE,11,7500,69915,12585,82500,August
4370,ORCHID VALLEY PASSION 1LTR,PIECE,7,7214,42797,7703,50500,August
4416,OX FORD SETS 11000,PIECE,4,11000,37288,6712,44000,August
4430,PADLOCK 3000,PIECE,1,3000,2542,458,3000,August
4433,PADLOCK 5000,PIECE,1,5000,4237,763,5000,August
4444,PAMPER 2 L.C,PIECE,3,9000,22881,4119,27000,August
4445,PAMPER 3 H.C,PIECE,1,40000,33898,6102,40000,August
4446,PAMPER 3 JUMBO,PIECE,1,73000,61864,11136,73000,August
4447,PAMPER 3 L.C PANTS,PIECE,2,9000,15254,2746,18000,August
4450,PAMPER 4 L.C PANTS,PIECE,8,9000,61017,10983,72000,August
4454,PAMPER 5 L.C PANTS,PIECE,6,9000,45763,8237,54000,August
4459,PAMPER S.6 JUMBO 48DIAP,PIECE,1,73000,61864,11136,73000,August
4461,PAMPERS 3 H.C DRY BABY,PIECE,1,40000,33898,6102,40000,August
4465,PANASONIC AAA,PIECE,5,2000,8475,1525,10000,August
4467,PANASONIC C,PIECE,2,3250,5508,992,6500,August
4469,PANASUPER D,PIECE,4,3000,10169,1831,12000,August
4470,PANCHAVATI,PIECE,2,3000,5085,915,6000,August
4477,PANT PEG QIYUSHI 22000,PIECE,1,22000,18644,3356,22000,August
4484,PAPERLINE EXERCISE BK,PIECE,2,4000,6780,1220,8000,August
4495,PARLE NICE BISCUITS,PIECE,1,10000,8475,1525,10000,August
4497,PARLE-G BISCUITS PCS,PIECE,16,2500,33898,6102,40000,August
4516,PELIKAN RUBBER,PIECE,4,1000,3390,610,4000,August
4518,PENCIL BAG 1000,PIECE,1,1000,847,153,1000,August
4523,PENCIL BAGS 7000,PIECE,1,7000,5932,1068,7000,August
4534,PEPSI,PIECE,42,1500,53390,9610,63000,August
4535,PEPSI 2LTR,PIECE,34,4500,129661,23339,153000,August
4536,PEPSI 330ML,PIECE,64,1000,54237,9763,64000,August
4537,PEPSI MAX,PIECE,34,1000,28814,5186,34000,August
4538,PEPSI MAX 500ML,PIECE,3,1500,3814,686,4500,August
4539,PEPSODENT CAVITY 65G,PIECE,3,2500,6356,1144,7500,August
4540,PEPSODENT CAVITY FIGHTER 150G,PIECE,13,5000,55085,9915,65000,August
4541,PEPSODENT HERBAL 65G,PIECE,7,2500,14831,2669,17500,August
4546,PEPTANG KETCHUP 400G,PIECE,4,7500,25424,4576,30000,August
4552,PERMANENT MAKER,PIECE,3,1000,2542,458,3000,August
4573,PIANO TOYS 4000,PIECE,1,4000,3390,610,4000,August
4575,PIAO PIAO TP ORIGINAL,PIECE,44,2000,74576,13424,88000,August
4576,PIAO PIAO TP,PIECE,2,2000,3390,610,4000,August
4580,PICFARE 4 QUIRE 10000,PIECE,5,10000,42373,7627,50000,August
4581,PICFARE 48PGS,PIECE,6,500,2542,458,3000,August
4583,PICFARE 96PGS,PIECE,2,1000,1695,305,2000,August
4585,PICFARE GRAPH BOOK 48PGS,PIECE,2,2000,3390,610,4000,August
4589,PICFARE PENCILS PIECES 300,PIECE,3,300,763,137,900,August
4591,PICFARE RULED PAPER SMALL,PIECE,2,11000,18644,3356,22000,August
4592,PICFARE SET,PIECE,3,6000,15254,2746,18000,August
4595,PICK n PEEL APPLE 1LTR,PIECE,16,9500,128814,23186,152000,August
4597,PICK n PEEL MANGO 1LTR,PIECE,13,9500,104661,18839,123500,August
4615,PK CHEWING GUM 500,PIECE,42,500,17797,3203,21000,August
4616,PK CHEWING GUM BIG,PIECE,63,1000,53390,9610,63000,August
4625,PLASTIC GLASSES 2500,PIECE,1,2500,2119,381,2500,August
4649,PLAYING CARDS,PIECE,4,1000,3390,610,4000,August
4663,POMEGRANATE ED PASSION,PIECE,3,17000,43220,7780,51000,August
4664,POP & CONE SWEETS,PIECE,13,500,5508,992,6500,August
4665,POPPER 4500,PIECE,3,4500,11441,2059,13500,August
4667,POPPER 7000,PIECE,1,7000,5932,1068,7000,August
4668,POPPER 8500,PIECE,3,8500,21610,3890,25500,August
4675,POTATO BABY CUP,PIECE,1,18000,15254,2746,18000,August
4680,POTATO FEEDING BOTTLE 18000,PIECE,1,18000,15254,2746,18000,August
4681,POTATO FEEDING BOTTLE BRUSH,PIECE,1,8000,6780,1220,8000,August
4694,POULTRY VIENNAS 1KG,PIECE,1,42000,35593,6407,42000,August
4695,POULTRY VIENNAS 250G,PIECE,4,13000,44068,7932,52000,August
4696,POULTRY VIENNAS 500G,PIECE,5,22000,93220,16780,110000,August
4699,POWER PUFF SNACKS,PIECE,5,1000,4237,763,5000,August
4700,POWERPLAY 400MLS,PIECE,2,2000,3390,610,4000,August
4701,PRADIP CHOCOLATE ESSENCE,PIECE,1,5500,4661,839,5500,August
4705,PRADIP VANILLA CLEAR FLAVOURING,PIECE,9,5000,38136,6864,45000,August
4706,PRADIP VANILLA ESSENCE,PIECE,2,5000,8475,1525,10000,August
4711,PREDATOR ENERGY DRINK,PIECE,10,2000,16949,3051,20000,August
4716,PRESTIGE 1KG,PIECE,1,14000,11864,2136,14000,August
4717,PRESTIGE 250G,PIECE,20,4500,76271,13729,90000,August
4718,PRESTIGE 500G,PIECE,13,7500,82627,14873,97500,August
4720,PRICETAGS 1000,PIECE,1,1000,847,153,1000,August
4735,PRINGLES BBQ 40G,PIECE,1,5500,4661,839,5500,August
4737,PRINGLES CHEESY CHEESE 165G,PIECE,1,12000,10169,1831,12000,August
4742,PRINGLES ORIGINAL 165G BURSTING,PIECE,8,11625,78814,14186,93000,August
4743,PRINGLES ORIGINAL 40G,PIECE,4,6000,20339,3661,24000,August
4746,PRINGLES SOUR CREAM 165G,PIECE,4,12000,40678,7322,48000,August
4747,PRINGLES SOUR CREAM 40G,PIECE,3,6000,15254,2746,18000,August
4748,PRIVE BLACK OPTION BODYSPLASH,PIECE,2,16000,27119,4881,32000,August
4754,PRIVE KANZ SPLASH,PIECE,2,14000,23729,4271,28000,August
4760,PRIVE SENA POUR FEMME,PIECE,3,16000,40678,7322,48000,August
4777,PROTEX HERBAL 150G,PIECE,1,6500,5508,992,6500,August
4778,PROTEX HERBAL 90G,PIECE,1,4000,3390,610,4000,August
4782,PUCELLE BLISSFUL SENSE 150ML,PIECE,2,7000,11864,2136,14000,August
4783,PUCELLE BLISSFUL SENSE 75ML,PIECE,4,5500,18644,3356,22000,August
4786,PUCELLE ELECTRIC SUNRISE,PIECE,1,7500,6356,1144,7500,August
4789,PUCELLE JOLLY RHYTHM 150MLS,PIECE,1,7500,6356,1144,7500,August
4791,PUCELLE JOYFUL SUMMER,PIECE,3,5500,13983,2517,16500,August
4799,PUCELLE WAVY OCEAN 150MLS,PIECE,1,7500,6356,1144,7500,August
4802,PUFF HOLDERS 1500,PIECE,1,1500,1271,229,1500,August
4803,PUFF HOLDERS 2000,PIECE,1,2000,1695,305,2000,August
4820,QUAKER WHITE OATS,PIECE,2,13000,22034,3966,26000,August
4828,RADIANT ANTI DANDRUFF CREAM 90G,PIECE,1,4500,3814,686,4500,August
4838,RADIANT HAIR DYE 25ML,PIECE,1,3000,2542,458,3000,August
4842,RADIANT OLIVE OIL SHEEN SPRAY,PIECE,1,14000,11864,2136,14000,August
4850,RAHA COCOA 200G,PIECE,1,14000,11864,2136,14000,August
4871,RASPBERRY MIST PASSION,PIECE,4,17000,57627,10373,68000,August
4875,RAYAN BLACK PERFUME,PIECE,2,12000,20339,3661,24000,August
4879,RAZAC HAND&BODY LOTION 40Z,PIECE,1,7500,6356,1144,7500,August
4890,RECEIPT BOOKS NORMAL,PIECE,3,3000,7627,1373,9000,August
4896,RED BULL 250MLS,PIECE,15,7000,88983,16017,105000,August
4897,RED COCK 2KG,PIECE,4,27000,91525,16475,108000,August
4898,RED COCK BASMATI 1KG,PIECE,9,14000,106780,19220,126000,August
4901,REDCOCK RICE 5KG,PIECE,1,60000,50847,9153,60000,August
4902,RELAX NAPKINS,PIECE,26,2500,55085,9915,65000,August
4903,RELAX TP,PIECE,73,1500,92797,16703,109500,August
4911,RETYPE WHITE WASH,PIECE,2,3000,5085,915,6000,August
4933,RIBBONS 1000,PIECE,2,1000,1695,305,2000,August
4934,RIBBONS 2500,PIECE,1,2500,2119,381,2500,August
4936,RIBENA 1LTR,PIECE,20,10000,169492,30508,200000,August
4937,RIBENA 250MLS,PIECE,25,3000,63559,11441,75000,August
4945,RIHAM COFFEE MALT,PIECE,30,1500,38136,6864,45000,August
4947,RIHAM COLA 320MLS,PIECE,10,1000,8475,1525,10000,August
4951,RIHAM CREAMY CRUNCH STRAWBERRY,PIECE,1,3500,2966,534,3500,August
4956,RIHAM EXOTIC TAMARIND,PIECE,14,1000,11864,2136,14000,August
4960,RIHAM ONER APPLE 300ML,PIECE,106,1500,134746,24254,159000,August
4961,RIHAM ONER MANGO 300ml,PIECE,181,1500,230085,41415,271500,August
4964,RIHAM WATER 1.5LTRS,PIECE,13,2000,22034,3966,26000,August
4965,RIHAM WATER 600ML,PIECE,23,1000,19492,3508,23000,August
4975,RINSUN 1LTR,PIECE,1,13000,11017,1983,13000,August
4984,ROCK BOOM 320MLS,PIECE,73,2000,123729,22271,146000,August
4985,ROCK BOOM CAN 250ML,PIECE,4,3000,10169,1831,12000,August
4988,ROK SWEET POPS,PIECE,1,100,85,15,100,August
4989,ROKI 5LTRS,PIECE,3,41000,104237,18763,123000,August
4990,ROKI OIL 1LTR,PIECE,5,9600,40678,7322,48000,August
4991,ROKI OIL 3LTRS,PIECE,1,27000,22881,4119,27000,August
4992,ROKI OIL 500ML,PIECE,7,5000,29661,5339,35000,August
5004,ROSE PARIS FACIAL WIPES,PIECE,1,3500,2966,534,3500,August
5011,ROYAL NATURAL HONEY 500ML,PIECE,1,20000,16949,3051,20000,August
5015,ROYALE BLUE SPRAY,PIECE,1,12000,10169,1831,12000,August
5016,ROYCO BEEF 200G,PIECE,18,6000,91525,16475,108000,August
5018,ROYCO BEEF 500G,PIECE,3,12000,30508,5492,36000,August
5020,ROYCO BEEF 60G,PIECE,2,1200,2034,366,2400,August
5021,ROYCO CHICKEN 200G,PIECE,4,6000,20339,3661,24000,August
5022,ROYCO CHICKEN 500G,PIECE,4,12000,40678,7322,48000,August
5023,ROYCO CHICKEN 60G,PIECE,16,1200,16271,2929,19200,August
5024,ROYCO CUBE CHICKEN FLAVOUR,PIECE,8,4000,27119,4881,32000,August
5025,ROYCO CUBES BEEF,PIECE,3,4000,10169,1831,12000,August
5026,ROYCO CURRY+MCHUZI,PIECE,4,6500,22034,3966,26000,August
5029,RUBEE LOTION 113G,PIECE,1,7000,5932,1068,7000,August
5031,RUGS 3000,PIECE,1,3000,2542,458,3000,August
5036,RWENZORI 1.5LTRS,PIECE,143,2000,242373,43627,286000,August
5043,RWENZORI WATER 500ML,PIECE,78,1000,66102,11898,78000,August
5048,SAFA HONEY 400G,PIECE,2,16000,27119,4881,32000,August
5049,SAFA TOMATO PASTE 400G,PIECE,5,6000,25424,4576,30000,August
5050,SAFA TOMATO PASTE 70GM,PIECE,54,1500,68644,12356,81000,August
5053,SAFARI TEA 50G,PIECE,9,2000,15254,2746,18000,August
5054,SAFEGUARD PURE WHITE SOAP160G,PIECE,4,3000,10169,1831,12000,August
5059,SAF-INSTANT YEAST 500G,PIECE,3,16000,40678,7322,48000,August
5062,SAFISHA OCEAN GLASSCLEANER,PIECE,1,10000,8475,1525,10000,August
5063,SAF-LEVURE 125G,PIECE,5,8500,36017,6483,42500,August
5079,SAMONA HERBAL JELLY 250G,PIECE,1,8000,6780,1220,8000,August
5090,SANTA LUCIA 250G,PIECE,48,2500,101695,18305,120000,August
5091,SANTA LUCIA 450G,PIECE,19,5000,80508,14492,95000,August
5095,SANTA LUCIA LUMACA,PIECE,13,6000,66102,11898,78000,August
5148,SAVANNAH MANGO 5LTRS,PIECE,1,33000,27966,5034,33000,August
5151,SAVANNAH PINEAPPLE 2LTR,PIECE,1,19000,16102,2898,19000,August
5152,SAVANNAH PINEAPPLE 3LTR,PIECE,1,24000,20339,3661,24000,August
5154,SAVANNAH PUNCH 5LTRS,PIECE,1,33000,27966,5034,33000,August
5170,SCHOOL SOCKS RED/GREEN YELLOW,PIECE,2,4000,6780,1220,8000,August
5174,SCHOOL STOCKINGS WHITE,PIECE,2,4500,7627,1373,9000,August
5180,SCOURER 1000,PIECE,12,1000,10169,1831,12000,August
5181,SCOURING PADS 500,PIECE,2,500,847,153,1000,August
5182,SCOURING PADS 5000 6PCS,PIECE,8,2000,13559,2441,16000,August
5189,SCRUBBING BRUSH LONG 5000,PIECE,1,6000,5085,915,6000,August
5190,SCRUBBING HAND BRUSH 5000,PIECE,1,5000,4237,763,5000,August
5191,SCRUBBING HAND BRUSH 8000,PIECE,1,9000,7627,1373,9000,August
5209,SECRETS PADS,PIECE,3,4000,10169,1831,12000,August
5214,SENSITIVE BABY WIPES,PIECE,6,7000,35593,6407,42000,August
5219,SENSODYNE FRESH MINT 75ML,PIECE,1,16000,13559,2441,16000,August
5222,SENSODYNE MULTI CARE 75MLS,PIECE,8,14125,95763,17237,113000,August
5223,SENSODYNE MULTICARE 40MLS,PIECE,11,8091,75424,13576,89000,August
5229,SERVING SPOONS 3000,PIECE,1,3000,2542,458,3000,August
5233,SESACO SOYACUP 150G,PIECE,3,4000,10169,1831,12000,August
5235,SESAME SNACKS,PIECE,4,5000,16949,3051,20000,August
5236,SESAME SNACKS 100G,PIECE,6,2500,12712,2288,15000,August
5252,SHAKERS 1000,PIECE,4,1000,3390,610,4000,August
5253,SHAKERS 12000,PIECE,1,12000,10169,1831,12000,August
5255,SHAKERS 4000,PIECE,1,4000,3390,610,4000,August
5259,SHARPENER SMALL,PIECE,4,500,1695,305,2000,August
5264,SHENKE COIL 4500,PIECE,2,4500,7627,1373,9000,August
5265,SHENKE FLOWER REPELLENT,PIECE,3,8000,20339,3661,24000,August
5267,SHENKE LEMON SCENT,PIECE,7,8000,47458,8542,56000,August
5268,SHENKE LOTUS SCENT,PIECE,6,8000,40678,7322,48000,August
5269,SHENKE MOSQUITO COIL,PIECE,3,6000,15254,2746,18000,August
5270,SHENKE MOSQUITO COIL LOW SMOKE,PIECE,3,6000,15254,2746,18000,August
5272,SHENKE MOSQUITO REPELLANT,PIECE,2,16000,27119,4881,32000,August
5273,SHENKE MOSQUITO REPELLANT DOUBLE 20000,PIECE,3,22000,55932,10068,66000,August
5274,SHENKE ORANGE,PIECE,5,8000,33898,6102,40000,August
5275,SHENKE REPELLANT ORDOLESS,PIECE,1,8000,6780,1220,8000,August
5281,SHIVA HONEY 250G,PIECE,2,8500,14407,2593,17000,August
5283,SHIVA HONEY 500G,PIECE,1,15000,12712,2288,15000,August
5284,SHIVA HONEY 80G,PIECE,6,4500,22881,4119,27000,August
5287,SHOE BRUSH 5000,PIECE,3,5000,12712,2288,15000,August
5289,SHOE BRUSHES 1500,PIECE,1,1500,1271,229,1500,August
5290,SHOE BRUSHES 2000,PIECE,1,2000,1695,305,2000,August
5301,SHOWER 2 SHOWER CONFIDENT,PIECE,2,6000,10169,1831,12000,August
5302,SHOWER CAPS,PIECE,2,2000,3390,610,4000,August
5304,SHOWER TO SHOWER INVISIBLE DRY,PIECE,1,6000,5085,915,6000,August
5307,SHOWER TO SHOWER SPRING RAIN,PIECE,4,6000,20339,3661,24000,August
5308,SHOWER TOSHOWER FRESH MORNING,PIECE,4,6000,20339,3661,24000,August
5313,SHOWERTO SHOWER MUSK ALIVE,PIECE,4,6000,20339,3661,24000,August
5315,SHOWERTOSHOWER FRESH POWDER,PIECE,1,6000,5085,915,6000,August
5321,SHREEJI BOOK 200PGS,PIECE,3,4000,10169,1831,12000,August
5324,SHREEJI GRAPH BOOK 96,PIECE,1,3000,2542,458,3000,August
5331,SHUYA 240 MM,PIECE,8,6000,40678,7322,48000,August
5332,SHUYA 280MM,PIECE,6,6000,30508,5492,36000,August
5333,SHUYA 330MM,PIECE,8,6000,40678,7322,48000,August
5334,SHUYA PANT LINERS,PIECE,9,6000,45763,8237,54000,August
5345,SILKEE DESIGNER SERVIETTES,PIECE,18,2500,38136,6864,45000,August
5347,SILKEE JUMBO TP,PIECE,115,2000,194915,35085,230000,August
5354,SILVER PLATE 1000,PIECE,13,1000,11017,1983,13000,August
5355,SILVER PLATE 300,PIECE,1,300,254,46,300,August
5356,SILVER PLATE 500,PIECE,76,500,32203,5797,38000,August
5360,SIMBA MBILI 100G,PIECE,1,7000,5932,1068,7000,August
5361,SIMBA MBILI 200G,PIECE,1,9500,8051,1449,9500,August
5362,SIMBA MBILI 500G,PIECE,1,20000,16949,3051,20000,August
5363,SIMBA MBILI 50G,PIECE,2,5500,9322,1678,11000,August
5366,SIMKA CHOC- VAN 300ML,PIECE,15,3500,44492,8008,52500,August
5367,SIMKA CHOCO BAR 100MLS,PIECE,44,2500,93220,16780,110000,August
5368,SIMKA CHOC-VAN 120MLS,PIECE,143,1000,121186,21814,143000,August
5369,SIMKA CHOC-VAN 230MLS,PIECE,74,2000,125424,22576,148000,August
5371,SIMKA CHOC-VANILLA 500ML,PIECE,12,4500,45763,8237,54000,August
5373,SIMKA PINE-VANILLA 120ML,PIECE,3,1000,2542,458,3000,August
5374,SIMKA STRAW-VAN 120MLS,PIECE,258,1000,218644,39356,258000,August
5375,SIMKA STRAW-VAN 230MLS,PIECE,104,2000,176271,31729,208000,August
5376,SIMKA STRAW-VAN 300MLS,PIECE,30,3500,88983,16017,105000,August
5377,SIMKA STRAW-VAN 500MLS,PIECE,24,4500,91525,16475,108000,August
5378,SIMKA STRAW-VANILLA,PIECE,1,10000,8475,1525,10000,August
5379,SIMKA VANILLA 120MLS,PIECE,26,1000,22034,3966,26000,August
5380,SIMKA VANILLA 230MLS,PIECE,23,2000,38983,7017,46000,August
5381,SIMKA VANILLA 300MLS,PIECE,4,3500,11864,2136,14000,August
5382,SIMKA VANILLA 500MLS,PIECE,2,4500,7627,1373,9000,August
5394,SKALA PAPAYA CREAM 200G,PIECE,1,4000,3390,610,4000,August
5396,SKALA PERFUMED JELLY 200G,PIECE,1,4500,3814,686,4500,August
5400,SKIN CARE 150G,PIECE,1,4500,3814,686,4500,August
5404,SKIN CARE 50G,PIECE,1,2000,1695,305,2000,August
5408,SKIN DOCTOR HERBAL 250G,PIECE,1,7000,5932,1068,7000,August
5410,SKIN GUARD HAND WASH 550ML,PIECE,1,7000,5932,1068,7000,August
5433,SKY VIEW FRUITII 320ML,PIECE,29,1000,24576,4424,29000,August
5434,SKY VIEW FRUTII 320ML,PIECE,5,1000,4237,763,5000,August
5435,SKY VIEW ORANGE 320ML,PIECE,43,1000,36441,6559,43000,August
5436,SKYVIEW 320MLS,PIECE,29,1000,24576,4424,29000,August
5481,SNICKERS CHOCOLATE,PIECE,22,3500,65254,11746,77000,August
5482,SNOW SPRAYS 4500,PIECE,8,5000,33898,6102,40000,August
5483,SNOWMAN MAKERS,PIECE,4,1000,3390,610,4000,August
5484,SO SOFT FRESH 2.5L,PIECE,2,28500,48305,8695,57000,August
5485,SO SOFT KITCHEN TOWEL,PIECE,3,8000,20339,3661,24000,August
5491,SOAP DISH 2000,PIECE,1,1000,847,153,1000,August
5497,SOAP DISH KENPOLY 1000,PIECE,2,2000,3390,610,4000,August
5508,SOFINE PURE OLIVE OIL 120ML,PIECE,2,7000,11864,2136,14000,August
5513,SOFT BALL 2000,PIECE,1,2000,1695,305,2000,August
5514,SOFT BROOM 10000,PIECE,1,10000,8475,1525,10000,August
5515,SOFT BROOM 15000,PIECE,2,15000,25424,4576,30000,August
5521,SOFT CARE BABY WIPES,PIECE,17,7000,100847,18153,119000,August
5527,SOFTCARE BABY PANTS L40,PIECE,3,27000,68644,12356,81000,August
5528,SOFTCARE BABY PANTS M44,PIECE,3,27000,68644,12356,81000,August
5530,SOFTCARE L40,PIECE,3,25000,63559,11441,75000,August
5531,SOFTCARE M42 GOLD,PIECE,3,25000,63559,11441,75000,August
5538,SOFTCARE S48 GOLD,PIECE,1,25000,21186,3814,25000,August
5539,SOFTCARE SANITARY PADS,PIECE,22,3000,55932,10068,66000,August
5557,SOSOFT BABY 2.5L,PIECE,1,29000,24576,4424,29000,August
5558,SOSOFT BABY 750MLS,PIECE,1,11000,9322,1678,11000,August
5563,SOSOFT PURE CARE 750MLS,PIECE,1,11000,9322,1678,11000,August
5565,SOSOFT VANILLA 750MLS,PIECE,1,11000,9322,1678,11000,August
5566,SOY SAUCE DARK 150G,PIECE,7,5000,29661,5339,35000,August
5567,SOY SAUCE DARK 500G,PIECE,10,10000,84746,15254,100000,August
5568,SOY SAUCE LIGHT 150G,PIECE,1,5000,4237,763,5000,August
5569,SOY SAUCE LIGHT 500G,PIECE,1,10000,8475,1525,10000,August
5575,SPARKLING CANDLES 9000,PIECE,3,9000,22881,4119,27000,August
5591,SPLASH APPLE 1LTR,PIECE,14,8393,99576,17924,117500,August
5592,SPLASH APPLE 250MLS,PIECE,37,2000,62712,11288,74000,August
5593,SPLASH APPLES 150ML,PIECE,1,1500,1271,229,1500,August
5602,SPLASH MANGO 150ML,PIECE,21,1500,26695,4805,31500,August
5603,SPLASH MANGO 250MLS,PIECE,35,2000,59322,10678,70000,August
5604,SPLASH MANGO JUICE 1LTR,PIECE,27,8315,190254,34246,224500,August
5608,SPONGE 1500,PIECE,1,1500,1271,229,1500,August
5609,SPONGE 2000,PIECE,9,2056,15678,2822,18500,August
5610,SPONGE 3000,PIECE,5,3000,12712,2288,15000,August
5611,SPONGE 4000,PIECE,3,4167,10593,1907,12500,August
5613,SPONGES 2500,PIECE,2,2500,4237,763,5000,August
5615,SPONGES WHITE 3000,PIECE,1,3000,2542,458,3000,August
5621,SPOONS 8000/ FORKS ,PIECE,1,8000,6780,1220,8000,August
5624,SPRING FILE 3000,PIECE,10,3400,28814,5186,34000,August
5625,SPRITE 2LTR,PIECE,22,5000,93220,16780,110000,August
5626,SPRITE 350MLS,PIECE,96,1000,81356,14644,96000,August
5627,SPRITE 500MLS,PIECE,29,1500,36864,6636,43500,August
5630,SQUEEZERS 5000,PIECE,1,5000,4237,763,5000,August
5631,SQUEEZERS DOULBLE 10000,PIECE,5,10000,42373,7627,50000,August
5633,SQUISHY BLUE RASBERRY 200ML,PIECE,17,2000,28814,5186,34000,August
5634,SQUISHY FRUIT DRINK 200ML,PIECE,16,2000,27119,4881,32000,August
5635,SQUISHY FRUIT DRINK MANGO 200ML,PIECE,19,2000,32203,5797,38000,August
5651,STAR COFFEE 50G,PIECE,1,10000,8475,1525,10000,August
5656,STA-SOFT LAVENDER 750ML,PIECE,1,13000,11017,1983,13000,August
5657,STA-SOFT LAVENDER FRESH 2LTR,PIECE,1,29000,24576,4424,29000,August
5658,STA-SOFT SPRING FRESH 750MLS,PIECE,3,12667,32203,5797,38000,August
5668,STICK NOTES 8000,PIECE,2,8000,13559,2441,16000,August
5671,STING,PIECE,49,2000,83051,14949,98000,August
5672,STING RED RUSH,PIECE,27,2000,45763,8237,54000,August
5673,STONEY 350MLS,PIECE,26,1000,22034,3966,26000,August
5674,STONEY 500MLS,PIECE,16,1500,20339,3661,24000,August
5693,STRAWBERRY PRADIP COLORED,PIECE,1,5000,4237,763,5000,August
5712,SUCCESS CARD 500,PIECE,2,500,847,153,1000,August
5717,SUGAR 1KG,PIECE,51,5000,216102,38898,255000,August
5724,SULFO GLYCERINE COLORLESS,PIECE,1,2500,2119,381,2500,August
5725,SULFO GLYCERINE PINK,PIECE,1,2500,2119,381,2500,August
5726,SULTAN COCONUT HAIL OIL,PIECE,2,5000,8475,1525,10000,August
5734,SUMZ CORN CRAX CHILLI80G,PIECE,14,1500,17797,3203,21000,August
5735,SUMZ CORN CRAX 160G,PIECE,2,3000,5085,915,6000,August
5736,SUMZ CORN CRAX 80G,PIECE,20,1500,25424,4576,30000,August
5739,SUMZ CRISPS CHILLI 60G,PIECE,6,3000,15254,2746,18000,August
5741,SUMZ CRISPS FRUIT CHUTNEY,PIECE,13,1500,16525,2975,19500,August
5743,SUMZ CRUNCHY DADDIES 150G,PIECE,7,3000,17797,3203,21000,August
5744,SUMZ DADDIES 75G 1000,PIECE,20,1500,25424,4576,30000,August
5746,SUMZ GINGER COOKIES,PIECE,1,4000,3390,610,4000,August
5748,SUMZ GONJA 40G,PIECE,63,1500,80085,14415,94500,August
5749,SUMZ GONJA 90G CRISPS,PIECE,60,3000,152542,27458,180000,August
5750,SUMZ GONJA CRISPS 160G,PIECE,17,5500,79237,14263,93500,August
5753,SUMZ POTATO CRISP BBQ 30G,PIECE,30,1500,38136,6864,45000,August
5754,SUMZ POTATO CRISPS 180G,PIECE,49,5500,228390,41110,269500,August
5755,SUMZ POTATO CRISPS 20G,PIECE,247,600,125593,22607,148200,August
5756,SUMZ POTATO CRISPS 40G,PIECE,281,1500,357203,64297,421500,August
5757,SUMZ POTATO CRISPS 90G,PIECE,107,3000,272034,48966,321000,August
5758,SUMZ POTATO CRISPS TASTY TOMATO12G,PIECE,16,600,8136,1464,9600,August
5761,SUMZ ROASTED NUTS 120G,PIECE,22,3000,55932,10068,66000,August
5763,SUMZ ROASTED NUTS 60G,PIECE,30,1500,38136,6864,45000,August
5764,SUMZ SALT&VINEGAR 30G,PIECE,14,1500,17797,3203,21000,August
5766,SUMZ TANGY LEMON CRISPS 30G,PIECE,5,1500,6356,1144,7500,August
5767,SUMZS CRISPS 500G,PIECE,1,12000,10169,1831,12000,August
5778,SUNLIGHT DISH PASTE,PIECE,4,6000,20339,3661,24000,August
5781,SUNLIGHT DISHWASHING PASTE 800G,PIECE,1,12000,10169,1831,12000,August
5786,SUNLIGHT LAVENDER 500G,PIECE,3,5500,13983,2517,16500,August
5792,SUNLIGHT SOAP 175G,PIECE,2,2500,4237,763,5000,August
5794,SUNLIGHT SPRING IKG,PIECE,3,11000,27966,5034,33000,August
5795,SUNLIGHT SPRING SENSATIONS 500G,PIECE,5,5500,23305,4195,27500,August
5796,SUNLIGHT TROPICAL 1KG,PIECE,4,11000,37288,6712,44000,August
5798,SUNLIGHT TROPICAL 500G,PIECE,7,5500,32627,5873,38500,August
5803,SUNSEED OIL 2LTRS,PIECE,1,23000,19492,3508,23000,August
5807,SUNSHINE BEEF FLAVOR,PIECE,143,500,60593,10907,71500,August
5808,SUNSHINE CHICKEN FLAVOR,PIECE,129,500,54661,9839,64500,August
5809,SUNSHINE ONION FLAVOR,PIECE,126,500,53390,9610,63000,August
5810,SUNSHINE PLAIN FLAVOR,PIECE,121,500,51271,9229,60500,August
5811,SUNSHINE TOMATO FLAVOR,PIECE,136,500,57627,10373,68000,August
5815,SUNSIP BLACKCURRANT 3LTR,PIECE,1,16000,13559,2441,16000,August
5816,SUNSIP BLACKCURRANT 5LTR,PIECE,1,24000,20339,3661,24000,August
5821,SUN-SIP STRAWBERRY 2LTR,PIECE,1,11000,9322,1678,11000,August
5829,SUNVEAT CREAMY ORANGE,PIECE,10,1500,12712,2288,15000,August
5846,SUPERMAN PERFUME,PIECE,1,12000,10169,1831,12000,August
5852,SUPREME BAKING FLOUR,PIECE,10,8600,72881,13119,86000,August
5857,SWEET FANTA&COLA,PIECE,1,700,593,107,700,August
5859,SWEET IVORY PCS,PIECE,11,100,932,168,1100,August
5864,SWEET PEPSI,PIECE,49,100,4153,747,4900,August
5865,SWEET PEPSI PKT 2000,PIECE,2,2000,3390,610,4000,August
5875,SWEETS 100,PIECE,615,100,52119,9381,61500,August
5876,SWEETS 1000,PIECE,7,1000,5932,1068,7000,August
5877,SWEETS 1500 ICECREAMM LOLLIPOP,PIECE,10,1500,12712,2288,15000,August
5878,SWEETS 200,PIECE,146,200,24746,4454,29200,August
5879,SWEETS 300,PIECE,13,300,3305,595,3900,August
5881,SWEETS 500,PIECE,561,500,237712,42788,280500,August
5882,SWEETS 700 BIG FIVE,PIECE,62,700,36780,6620,43400,August
5883,SWEETS PKT 5000,PIECE,2,5000,8475,1525,10000,August
5903,SWT BASMATI 1KG BLUE,PIECE,2,15000,25424,4576,30000,August
5904,SWT CHENAB 2KG,PIECE,1,28000,23729,4271,28000,August
5907,SWT-1 GREEN 2KG,PIECE,2,14000,23729,4271,28000,August
5909,SWT-1 RICE 1KG GREEN,PIECE,2,7500,12712,2288,15000,August
5923,TABLE KNIFE PIECES 3000,PIECE,1,3000,2542,458,3000,August
5962,TEEPEE BRUSH A25,PIECE,3,3500,8898,1602,10500,August
5964,TEEPEE BRUSH A9,PIECE,1,3000,2542,458,3000,August
5978,TEMMY'S CORNFLAKES 1KG,PIECE,2,30000,50847,9153,60000,August
5979,TEMMY'S CORNFLAKES 250G,PIECE,3,10000,25424,4576,30000,August
5980,TEMMY'S CORNFLAKES 500G,PIECE,5,17000,72034,12966,85000,August
5999,TIAMO SWEETS,PIECE,2,200,339,61,400,August
6011,TIGER HEAD AA,PIECE,3,1000,2542,458,3000,August
6041,TOCEBA AAA,PIECE,5,1000,4237,763,5000,August
6042,TOCEBAL AA,PIECE,20,1000,16949,3051,20000,August
6043,TODAY WAFFERS,PIECE,12,1500,15254,2746,18000,August
6045,TOILET BLUE BLOCKS 4PCS,PIECE,2,7500,12712,2288,15000,August
6049,TOILET BRUSH TEEPEE10000,PIECE,1,10000,8475,1525,10000,August
6050,TOILET BRUSHES 12000,PIECE,1,12000,10169,1831,12000,August
6057,TOMDECA VESTS,PIECE,2,28000,47458,8542,56000,August
6066,TOOTH PICKS 4000,PIECE,1,1000,847,153,1000,August
6068,TOOTHPICK 1000,PIECE,6,1000,5085,915,6000,August
6069,TOOTHPICK NATURAL,PIECE,3,2500,6356,1144,7500,August
6101,TOP UP 400G,PIECE,24,2000,40678,7322,48000,August
6102,TOP UP 700G,PIECE,10,3500,29661,5339,35000,August
6103,TOP UP CHILL 260G,PIECE,9,2000,15254,2746,18000,August
6116,TORCH 3500,PIECE,3,4000,10169,1831,12000,August
6125,TORCH TH-5098A 3000,PIECE,1,3000,2542,458,3000,August
6127,TORCHES 1500,PIECE,1,1500,1271,229,1500,August
6139,TOTO'S VESTLINE JELLY 500G,PIECE,2,10000,16949,3051,20000,August
6155,TOY PHONES WITH G0GGLES,PIECE,2,10000,16949,3051,20000,August
6185,TROPICAL HEAT BEEF MASALA 100G,PIECE,1,5000,4237,763,5000,August
6187,TROPICAL HEAT BLACK PEPPER 50G,PIECE,3,5500,13983,2517,16500,August
6188,TROPICAL HEAT CHICKEN MASALA 100G,PIECE,1,5000,4237,763,5000,August
6189,TROPICAL HEAT CINNAMON 100G,PIECE,1,9500,8051,1449,9500,August
6190,TROPICAL HEAT CINNAMON 50G,PIECE,1,4500,3814,686,4500,August
6200,TROPICAL HEAT GARLIC POWDER 50G,PIECE,1,4500,3814,686,4500,August
6201,TROPICAL HEAT GINGER 100G,PIECE,3,8500,21610,3890,25500,August
6203,TROPICAL HEAT MEAT TENDERISER50G,PIECE,2,4000,6780,1220,8000,August
6206,TROPICAL HEAT MIXED SPICES 50G,PIECE,1,5000,4237,763,5000,August
6208,TROPICAL HEAT PAPRIKA,PIECE,5,4000,16949,3051,20000,August
6209,TROPICAL HEAT PILAU MASALA 100G,PIECE,3,11000,27966,5034,33000,August
6210,TROPICAL HEAT PILAU MASALA 50G,PIECE,4,6000,20339,3661,24000,August
6215,TROPICAL HEAT TEA MASALA 100G,PIECE,8,10000,67797,12203,80000,August
6216,TROPICAL HEAT TEA MASALA 45G,PIECE,9,5444,41525,7475,49000,August
6217,TROPICAL HEAT TURMERIC 100G,PIECE,2,7500,12712,2288,15000,August
6218,TROPICAL HEAT TURMERIC 50G,PIECE,4,4000,13559,2441,16000,August
6221,TROPICAL MINT SWEETS,PIECE,42,200,7119,1281,8400,August
6227,TROPIKAL WILD MUSK A.F,PIECE,1,12000,10169,1831,12000,August
6268,U.S.A BEAUTY SOAP BLACK,PIECE,5,6500,27542,4958,32500,August
6288,U-FRESH MANGO,PIECE,5,700,2966,534,3500,August
6290,UGACHICK DRUMSTICK WHOLE 500G,PIECE,1,13000,11017,1983,13000,August
6301,UGACHICK WINGS 500G,PIECE,1,13000,11017,1983,13000,August
6304,UGANDA SAFARI TEA 100G,PIECE,5,4000,16949,3051,20000,August
6307,UGANDA TEA BAGS,PIECE,3,5500,13983,2517,16500,August
6308,UGANDA TEA BAGS 100BAGS,PIECE,1,9000,7627,1373,9000,August
6310,UKWAJU,PIECE,69,1500,87712,15788,103500,August
6318,UMBRELLAS 8000,PIECE,2,8000,13559,2441,16000,August
6322,UMOJA SANDALS 6000,PIECE,1,7000,5932,1068,7000,August
6323,UMOJA SANDALS 8000,PIECE,5,8800,37288,6712,44000,August
6334,URBAN GWEKE 350G,PIECE,3,6500,16525,2975,19500,August
6366,V.L EXTRA HYDRATION LOTION 200ML,PIECE,2,8000,13559,2441,16000,August
6397,VASELINE ALOESOOTHE 200ML,PIECE,2,8000,13559,2441,16000,August
6398,VASELINE ALOESOOTHE LOTION 400ML,PIECE,1,14500,12288,2212,14500,August
6401,VASELINE BLUESEAL COCOA BUTTER250ML,PIECE,2,9500,16102,2898,19000,August
6404,VASELINE BLUESEAL MEN FRESH 100ML,PIECE,6,5000,25424,4576,30000,August
6406,VASELINE BLUESEAL ORIGINAL 250ML,PIECE,2,9500,16102,2898,19000,August
6407,VASELINE COCOA GLOW 200ML,PIECE,1,8000,6780,1220,8000,August
6411,VASELINE COCOAGLOW LOTION 400G radiant,PIECE,1,14500,12288,2212,14500,August
6412,VASELINE DRY SKIN REPAIR 200ML,PIECE,2,8000,13559,2441,16000,August
6421,VASELINE MEN COOLING 400MLS,PIECE,2,14500,24576,4424,29000,August
6422,VASELINE MEN COOLING JELLY 240ML,PIECE,5,9500,40254,7246,47500,August
6423,VASELINE MEN COOLING LOTION 200ML,PIECE,4,8000,27119,4881,32000,August
6424,VASELINE MEN EXTRA HYDRATION,PIECE,1,14500,12288,2212,14500,August
6427,VASELINE MEN JELLY FRESH 240ML,PIECE,2,9500,16102,2898,19000,August
6428,VASELINE ORIGINAL 100ML,PIECE,1,5000,4237,763,5000,August
6451,VESTLINE ALOEVERA CREAM,PIECE,2,4000,6780,1220,8000,August
6452,VESTLINE GARLIC 200G,PIECE,1,4000,3390,610,4000,August
6453,VESTLINE GARLIC JELLY 200G,PIECE,2,5000,8475,1525,10000,August
6458,VICTAN SINGLE VEST,PIECE,3,5000,12712,2288,15000,August
6460,VICTOR BODY CREAM 250,PIECE,2,5000,8475,1525,10000,August
6461,VICTOR CREME 120G,PIECE,3,2500,6356,1144,7500,August
6464,VIGOS HAZELNUT CHOCOLATE 800,PIECE,5,800,3390,610,4000,August
6468,VIM LAVENDER 1KG,PIECE,2,8000,13559,2441,16000,August
6469,VIM LAVENDER 500G,PIECE,5,5000,21186,3814,25000,August
6470,VIM LEMON 1KG,PIECE,1,8000,6780,1220,8000,August
6471,VIM LEMON FRESH 500G,PIECE,7,5000,29661,5339,35000,August
6474,VINEGAR WHITE 700MLS,PIECE,8,2500,16949,3051,20000,August
6497,WANDAZ PETROLEUM JELLY 500G,PIECE,1,11500,9746,1754,11500,August
6500,WATCHES 10000,PIECE,1,10000,8475,1525,10000,August
6517,WATER GAMES 2000,PIECE,1,2000,1695,305,2000,August
6533,WEET CORNFLAKES 750G,PIECE,3,24000,61017,10983,72000,August
6534,WEETABIX 112G,PIECE,8,4500,30508,5492,36000,August
6535,WEETABIX 225G,PIECE,6,8500,43220,7780,51000,August
6537,WEETABIX 450G,PIECE,6,15500,78814,14186,93000,August
6544,WEETABIX CORNFLAKES 500G,PIECE,6,16500,83898,15102,99000,August
6557,WELLICE SHOWER GEL OLIVE OIL 1LTR,PIECE,1,23000,19492,3508,23000,August
6568,WHITE CHALK 5000,PIECE,2,5000,8475,1525,10000,August
6572,WHITE STAR SOAP 1KG,PIECE,43,6500,236864,42636,279500,August
6573,WHITE VINEGAR,PIECE,3,2500,6356,1144,7500,August
6579,WHITEDENT HERBAL 110G,PIECE,4,5000,16949,3051,20000,August
6581,WHITEDENT HERBAL 250G,PIECE,2,8000,13559,2441,16000,August
6583,WHITEDENT HERBAL 70G,PIECE,4,3000,10169,1831,12000,August
6588,WIG CAP HAIR NET,PIECE,2,1500,2542,458,3000,August
6606,WRAPPERS 500,PIECE,14,500,5932,1068,7000,August
6607,WRAPPING PAPER 1000,PIECE,4,1000,3390,610,4000,August
6619,YARRISON UNDER SHIRT 30000,PIECE,1,35000,29661,5339,35000,August
6642,YOJUS APPLE DRINK,PIECE,27,1000,22881,4119,27000,August
6643,YOJUS MANGO 150ML,PIECE,31,1026,26949,4851,31800,August
6650,YOUR CHOICE SAUSAGE 1KG,PIECE,2,32000,54237,9763,64000,August
6651,YOUR CHOICE SAUSAGES 500G,PIECE,4,17000,57627,10373,68000,August
6665,ZESTA 300 G,PIECE,8,7500,50847,9153,60000,August
6666,ZESTA 500G,PIECE,2,11000,18644,3356,22000,August
6674,ZESTA STRAWBERRY JAM,PIECE,4,11000,37288,6712,44000,August
6676,ZESTA TOMATO KETCHUP,PIECE,5,7000,29661,5339,35000,August
6677,ZESTA TOMATO KETCHUP 700G,PIECE,7,12000,71186,12814,84000,August
6684,ZIKUSOOKA NATURAL 50G,PIECE,1,5000,4237,763,5000,August
6698,SOFINE GENLESE ROSE NOURISH 1L,PIECE,1,22000,18644,3356,22000,August
6707,VASELINE BLUESEAL MEN COOLING 95ML,PIECE,6,5000,25424,4576,30000,August
6708,VASELINE BLUESEAL BABY 95ML,PIECE,2,5000,8475,1525,10000,August
6709,VASELINE BLUESEAL JELLY ORIGINAL 95ML,PIECE,7,5000,29661,5339,35000,August
6710,VASELINE BLUESEAL COCOA BUTTER 95ML,PIECE,5,5000,21186,3814,25000,August
6711,NIVEA RICH NOURISHING 200ML,PIECE,1,14000,11864,2136,14000,August
6723,BRITANIA GINGER BISCUITS 1KG,PIECE,1,20000,16949,3051,20000,August
6724,US MUSTARD 227G-8000,PIECE,2,8000,13559,2441,16000,August
6765,BIRTHDAY CANDLE 2K,PIECE,4,1875,6356,1144,7500,August
6773,VEGETABLE SAMOSA 1000,PIECE,241,1000,204237,36763,241000,August
6775,CHAPS 3000,PIECE,253,3000,643220,115780,759000,August
6776,KEBAB 3000,PIECE,96,3000,244068,43932,288000,August
6778,PILAO PLAIN 5000,PIECE,16,5063,68644,12356,81000,August
6779,PILAO PLAIN 10000,PIECE,257.34,9955,2171017,390783,2561800,August
6780,CHIPS PLAIN 5000,PIECE,13,3738,41186,7414,48600,August
6781,VEGETABLE RICE 7000,PIECE,228.05,6748,1304110,234740,1538850,August
6782,CHICKEN STEW 8000,PIECE,1,4000,3390,610,4000,August
6784,LIVER STEW 8000,PIECE,119.42,6959,704237,126763,831000,August
6787,VEGETABLE RICE 3500,PIECE,8,3700,25085,4515,29600,August
6788,BEEF SAUSAGES 1000,PIECE,1714,1000,1452542,261458,1714000,August
6790,KATOGO 4000,PIECE,218.39,3931,727475,130945,858420,August
6792,CHIPS 2500,PIECE,445.12,2572,970169,174631,1144800,August
6793,LIVER 4000,PIECE,3,3333,8475,1525,10000,August
6794,KATOGO 2500,PIECE,6,3167,16102,2898,19000,August
6795,KATOGO 2000,PIECE,3,2000,5085,915,6000,August
6798,CADBURY DAIRY MILK 35G,PIECE,23,4000,77966,14034,92000,August
6799,SPRING ROLLS VEGETABLE 1000,PIECE,33,1000,27966,5034,33000,August
6805,PANCAKES 500,PIECE,574,500,243220,43780,287000,August
6807,BEAN STEW 2000,PIECE,223.12,1946,368034,66246,434280,August
6808,CRACKERS 1500,PIECE,286,2000,484746,87254,572000,August
6812,BEEF STEW 6000,PIECE,471,2017,805085,144915,950000,August
6813,GRILLED CHICKEN 7000,PIECE,74,7014,439831,79169,519000,August
6816,BLUE BAND 250G,PIECE,35,5000,148305,26695,175000,August
6817,BALLET BABY SOAP ALOEVERA,PIECE,2,4000,6780,1220,8000,August
6820,BEEF SAMOSA 1500,PIECE,360,1500,457627,82373,540000,August
6821,CHAPATI 1000,PIECE,2435,1000,2063559,371441,2435000,August
6825,TROPIKAL AIR FRESHNER VANILLA 300ML,PIECE,1,12000,10169,1831,12000,August
6829,"SOFINE SHOWER GEL ROSE, TEA 750ML",PIECE,1,20000,16949,3051,20000,August
6831,JESA MIXED BERRY YOGHURT 250G,PIECE,19,2500,40254,7246,47500,August
6840,GONJA FRIED 1000,PIECE,287,1056,256780,46220,303000,August
6841,PIZZA CHICKEN SLICE BIG ,PIECE,161,6000,818644,147356,966000,August
6848,PIZZA 16'' CHICKEN ,PIECE,9,35000,266949,48051,315000,August
6859,ROLEX NORMAL 2EGGS,PIECE,67,2500,141949,25551,167500,August
6864,SWEET POTATOES FRIED,PIECE,1,1000,847,153,1000,August
6868,SPAGHETI 2500,PIECE,223.24,2483,469661,84539,554200,August
6869,MASALA CHIPS ,PIECE,1,2800,2373,427,2800,August
6871,POSHO KG,PIECE,19.74,3772,63102,11358,74460,August
6876,"GREENS (NAKATI,DODO ETC)",PIECE,55.94,4225,200288,36052,236340,August
6885,JAGO SCRUB 110G,PIECE,6,4500,22881,4119,27000,August
6887,JESA BLUEBERRY FRUIT YOGHURT 450G,PIECE,11,6000,55932,10068,66000,August
6889,EGGS BOILED 500,PIECE,596,500,252542,45458,298000,August
6894,SQUISHY JUICE APPLE,PIECE,10,2000,16949,3051,20000,August
6906,BRUSHES 2000,PIECE,1,3000,2542,458,3000,August
6921,ZENDEN PLASTIC PLAYING CARDS ,PIECE,1,5000,4237,763,5000,August
6930,JINYI EAR BUDS 1000,PIECE,6,1417,7203,1297,8500,August
6935,SHREEJI 96 PAGES A4 ,PIECE,2,2000,3390,610,4000,August
6936,JESA MIXED BERRY YOGHURT 500G,PIECE,10,3700,31356,5644,37000,August
6940,JAMIES CAKE @100k,PIECE,1,80000,67797,12203,80000,August
6943,SUMZ POTATO CRISPS FRUIT CHUTNEY 12G,PIECE,30,600,15254,2746,18000,August
6948,NIVEA DOULBLE EFFECT 48HRS,PIECE,3,11000,27966,5034,33000,August
6953,STRIKE NUTS CHOCOLATE BAR,PIECE,40,1100,37288,6712,44000,August
6959,S CONTROL HAIR TEXTURIZER 125ML,PIECE,1,6000,5085,915,6000,August
6960,NAN GUEST BATHING SOAP,PIECE,5,4000,16949,3051,20000,August
6967,HORSE TOY 10000,PIECE,1,10000,8475,1525,10000,August
6970,YAM SLICE 1000,PIECE,136,1000,115254,20746,136000,August
6971,SWEET POTATOES BOILED 1000,PIECE,203,1000,172034,30966,203000,August
6976,SUMZ POTATO CRIPS TASTY TOMATO 30G,PIECE,29,1500,43500,0,43500,August
6978,PUCELLE ELECTRIC SUNRISE 75ML,PIECE,1,5500,4661,839,5500,August
6983,STRIKE COCONUT CHOCOLATE BAR,PIECE,12,1000,10169,1831,12000,August
6987,DOMS CUBOID PEN ,PIECE,4,700,2373,427,2800,August
6997,PELIKAN HB PENCILS 12PCS,PIECE,1,6000,5085,915,6000,August
7000,MASTER MATH SET A006 5000,PIECE,2,5000,8475,1525,10000,August
7008,GRILLED CHICKEN 8000,PIECE,44,8000,298305,53695,352000,August
7010,"HIT ORANGE,GREEN TEA,NATURAL 750ML",PIECE,1,26000,22034,3966,26000,August
7015,JESA STRAWBERRY&CHOCOLATE 450G,PIECE,16,6000,81356,14644,96000,August
7025,FACE TOWELS 6000,PIECE,3,6000,15254,2746,18000,August
7026,CHICKEN STEW 4000,PIECE,246,4000,833898,150102,984000,August
7037,POTTIES 15000,PIECE,1,15000,12712,2288,15000,August
7053,TREET SHAVER 1000,PIECE,13,1000,11017,1983,13000,August
7054,MARSHMALLOW TARBLEX LONG TWISTED,PIECE,4,2000,6780,1220,8000,August
7077,VASELINE BLUESEAL ALOEVERA 95ML,PIECE,4,5000,16949,3051,20000,August
7078,VASELINE BLUESEAL ALOEVERA 240ML,PIECE,3,9500,24153,4347,28500,August
7089,JAMIES WHITE SALT BREAD 500G,PIECE,1,3000,2542,458,3000,August
7100,FOIL BALLOON 3000,PIECE,2,3000,5085,915,6000,August
7101,JAMIES DADDIES TIN 17000,PIECE,8,17000,115254,20746,136000,August
7104,AMERICAN GREEN GARDEN BEE HONEY 350G,PIECE,1,16000,13559,2441,16000,August
7112,PUMPKIN SLICE 1000,PIECE,129,1000,109322,19678,129000,August
7115,CLAIRMEN CREAM 300ML,PIECE,1,14000,11864,2136,14000,August
7120,JAMIES DADDIES 500G 10000,PIECE,5,10000,42373,7627,50000,August
7130,JAMIES MUFFINS 2000,PIECE,77,2000,130508,23492,154000,August
7133,HUGGIES PANTS DRY COMFORT S.5,PIECE,1,32000,27119,4881,32000,August
7139,SUMZ BBQ CRISPS 12G,PIECE,25,600,12712,2288,15000,August
7142,JAMIES MARBLE CAKE 3000,PIECE,171,3000,434746,78254,513000,August
7143,GRAVY SOUP 1000,PIECE,103.62,993,87195,15695,102890,August
7144,JAMIES DOUGHNUT BIG CHOCOLATE 2500,PIECE,69,2500,146186,26314,172500,August
7146,JAMIES COOKIES TIN 500G 10000,PIECE,1,10000,8475,1525,10000,August
7147,JAMIES COOKIES 800G TIN 17000,PIECE,3,17000,43220,7780,51000,August
7158,BIO PLUS CARROT CREME 175ML,PIECE,1,7500,6356,1144,7500,August
7160,PAWPAW OIL 60ML,PIECE,1,6000,5085,915,6000,August
7164,NUTRO ORANGE BISCUIT 1200,PIECE,23,1200,23390,4210,27600,August
7165,ONER APPLE DRINK 1LTR,PIECE,2,5000,8475,1525,10000,August
7172,HIGHLAND TEA 50G,PIECE,2,2500,4237,763,5000,August
7173,D.L FIESTA WHITE 70ML,PIECE,18,3000,45763,8237,54000,August
7174,JAMIES LIQUID SOAP 5LTR 10000,PIECE,2,10000,16949,3051,20000,August
7175,JAMIES LIQUID SOAP 3LTR,PIECE,1,5000,4237,763,5000,August
7239,BEEF PILAU 20000,PIECE,39,5554,183559,33041,216600,August
7240,CHICKEN PILAU 20000,PIECE,1,5800,4915,885,5800,August
7277,DOUGHNUTS WHOLESALE 2500,PIECE,2,2500,4237,763,5000,August
7278,JUICE 2000 300ML,PIECE,66,2000,111864,20136,132000,August
7279,JUICE 4000 500ml,PIECE,37,4000,125424,22576,148000,August
7284,SUMZ SALT& VIEGAR,PIECE,9,600,4576,824,5400,August
7295,PLASTIC SWINGING CANDLE 2500,PIECE,4,2500,8475,1525,10000,August
7297,CLERE PETROLEUM JELLY 50G,PIECE,2,2000,3390,610,4000,August
7301,AMERICAN CROWN BAKHOUR AIR.F 300ML,PIECE,2,7000,11864,2136,14000,August
7308,COTTON EAR SWABS 4000,PIECE,5,4000,16949,3051,20000,August
7321,ECLAIRS 300,PIECE,2,300,508,92,600,August
7339,SOFTCARE GOLD S48,PIECE,1,25000,21186,3814,25000,August
7344,COMB 1000,PIECE,3,1000,2542,458,3000,August
7373,VASELINE BLUESEAL BABY 240ML,PIECE,4,9500,32203,5797,38000,August
7374,JAMIES WHOLE SALE SWEET YELLOW 5000,PIECE,109,5000,461864,83136,545000,August
7375,JAMIES WHOLE SALE SWEET BROWN 5000,PIECE,89,5000,377119,67881,445000,August
7376,JAMIES WHOLE SALE SWEET WHITE 5000,PIECE,128,5000,542373,97627,640000,August
7381,RIGGS HERO BODY SPRAY 250ML,PIECE,1,16000,13559,2441,16000,August
7383,MOVIT BABY JELLY 200G,PIECE,2,5250,8898,1602,10500,August
7387,HB PENCILS,PIECE,1,1500,1271,229,1500,August
7388,HIKMA YELLOW BAGIYA 4000,PIECE,2,4500,7627,1373,9000,August
7389,HIKMA YELLOW BAGIYA 2000,PIECE,9,1500,11441,2059,13500,August
7390,HIKMA BAGIYA 1500,PIECE,4,1500,5085,915,6000,August
7391,HIKMA BAGIYA 2500,PIECE,20,2500,42373,7627,50000,August
7392,HIKMA DADDIES 5000,PIECE,1,5000,4237,763,5000,August
7393,HIKMA DADDIES 2000,PIECE,4,2500,8475,1525,10000,August
7394,HIKMA G.NUTS 3000,PIECE,3,2000,5085,915,6000,August
7395,HIKMA HARD CORNS 2500,PIECE,1,2000,1695,305,2000,August
7396,JAMIES SWEET WHITE WHOLESALE 500G 2500,PIECE,88,2500,186441,33559,220000,August
7397,JAMIES SWEET YELLOW 500G WHOLE SALE 2500,PIECE,100,2500,211864,38136,250000,August
7398,JAMIES SWEET BROWN 500G WHOLE SALE 2500,PIECE,133,2500,281780,50720,332500,August
7404,MELEX SIMSIM BALLS 250G,PIECE,5,5000,21186,3814,25000,August
7410,ONER TAMARIND 500ML,PIECE,72,2500,152542,27458,180000,August
7411,PAMPERS PANTS 6,PIECE,1,40000,33898,6102,40000,August
7419,Sandals,PIECE,1,8000,6780,1220,8000,August
7421,JAMIES COOKIES 300G 7000,PIECE,4,7000,23729,4271,28000,August
7426,JAMIES SWEET CAKE BREAD WHOLESALE 5000,PIECE,3,5000,12712,2288,15000,August
7429,TROPICAL HEAT PAPRIKA SPICE 100G,PIECE,2,8000,13559,2441,16000,August
7430,JAMIES SWEET YELLOW BUNS WHOLESALE 2500,PIECE,323,2500,684322,123178,807500,August
7432,FRESCO BODY OIL 100ML 4000,PIECE,2,4500,7627,1373,9000,August
7433,COCA COLA CAN 300ML3000,PIECE,2,3000,5085,915,6000,August
7434,FANTA CAN 330ML 3000,PIECE,2,3000,5085,915,6000,August
7436,MOODLENA NOODLES CHICKEN 1000,PIECE,31,1000,26269,4729,30998,August
7445,COSMO SHOWER GEL CHERRY BLOSSOM ,PIECE,2,25000,42373,7627,50000,August
7455,CANDLE NUMBER BIG 3500,PIECE,2,3500,5932,1068,7000,August
7473,ARTIN MASSAGE OIL OLIVE OIL 1LTR,PIECE,1,13000,11017,1983,13000,August
7476,MENTOS MINT 29G,PIECE,8,2500,16949,3051,20000,August
7486,APPLES PACKED 11000,PIECE,17,11000,158475,28525,187000,August
7488,VERSMAN ACTIVE LOTION 400ML,PIECE,1,17000,14407,2593,17000,August
7489,HAPPY TIME WATER GAME 10000,PIECE,1,10000,8475,1525,10000,August
7490,BIRTHDAY CANDLES STAR 4000,PIECE,2,4000,6780,1220,8000,August
7492,CS MUKENESNACK 100G 3500,PIECE,3,6000,15254,2746,18000,August
7497,JAMIES SWEET BUNS BROWN 6PCS WHOLESALE,PIECE,326,2500,690678,124322,815000,August
7500,KABODY BABY BODY IMMUNE BOOSTER,PIECE,2,7500,12712,2288,15000,August
7522,JUST WOW 250ML,PIECE,1,15000,12712,2288,15000,August
7523,SPARKING CANDLE 7000,PIECE,1,7000,5932,1068,7000,August
7524,TOYS 2000,PIECE,11,1955,18220,3280,21500,August
7540,NUMA KARO 2KG 12000,PIECE,1,12000,10169,1831,12000,August
7547,TOYS 15000,PIECE,7,10857,64407,11593,76000,August
7548,TOYS 35000,PIECE,1,35000,29661,5339,35000,August
7552,TOYS 5000,PIECE,3,6000,15254,2746,18000,August
7553,TOYS 3000,PIECE,8,3375,22881,4119,27000,August
7554,AFIA LEMON 500ML,PIECE,1,3000,2542,458,3000,August
7558,HISS,PIECE,1,2500,2119,381,2500,August
7559,MOPPER 20000,PIECE,2,20000,33898,6102,40000,August
7564,HISCENTS RAMBO,PIECE,1,15000,12712,2288,15000,August
7575,AMERICAN SRAWBERRY GEL,PIECE,1,23000,19492,3508,23000,August
7590,WEETABIX SUPER SAVER 850G,PIECE,2,26000,44068,7932,52000,August
7592,COLGATE CHARCOAL 210G 10000,PIECE,6,11000,55932,10068,66000,August
7593,COLGATE CHARCOAL 35G 2500,PIECE,19,2500,40254,7246,47500,August
7615,NOVICOL WOOD GLUE 500G,PIECE,1,8000,6780,1220,8000,August
7620,SPRITE CAN 330ML,PIECE,11,3000,27966,5034,33000,August
7621,MINTORE X PLUS 500,PIECE,2,500,847,153,1000,August
7645,SOFTCARE GOLD XL36,PIECE,1,25000,21186,3814,25000,August
7647,SKY VIEW APPLE 320ML,PIECE,40,1000,33898,6102,40000,August
7650,JAMIES SWEET WHITE BUNS @4000,PIECE,153,4000,518644,93356,612000,August
7656,JAMIES MANDAZ 1000,PIECE,5,1000,4237,763,5000,August
7658,HANDSOME BOXER 18000,PIECE,2,18000,30508,5492,36000,August
7667,SCHOOL SOCKS WHITE 6000,PIECE,1,6000,5085,915,6000,August
7687,NOTE BOOK 6500,PIECE,13,6500,71610,12890,84500,August
7693,HAND BRUSH 2500,PIECE,2,2500,4237,763,5000,August
7697,BODY SCRUBBER GLOVE 5000,PIECE,14,5000,59322,10678,70000,August
7701,CLEAR BAGS 1500,PIECE,5,1500,6356,1144,7500,August
7703,TOYS 1000,PIECE,4,1000,3390,610,4000,August
7704,JAMIES MILK BREAD 5500,PIECE,185,5981,937712,168788,1106500,August
7705,JAMIES CAKE SLICE@8000,PIECE,63,8000,427119,76881,504000,August
7706,JAMIES MILK BREAD 500G,PIECE,43,3500,127542,22958,150500,August
7713,REXONA INVISIBLE DRY BLACK+ WHITE 50ML,PIECE,1,10000,8475,1525,10000,August
7720,SECRETS PADS ULTRA OVER NIGHT BLUE,PIECE,2,5500,9322,1678,11000,August
7722,JAMIES BRONCH BREAD 1KG,PIECE,2,6000,10169,1831,12000,August
7724,JAMIES DOUGHNUTS SMALL 6PCS,PIECE,9,3000,22881,4119,27000,August
7725,JAMIES BRONCH BREAD 500G,PIECE,1,3500,2966,534,3500,August
7726,DABUR CHARCOAL 150G,PIECE,7,7000,41525,7475,49000,August
7727,JAMIES SWEET WHITE BUNS WHOLESALE,PIECE,342,2500,855000,0,855000,August
7746,SWEETS 1500,PIECE,5,1500,6356,1144,7500,August
7750,TOYS 4000,PIECE,1,4000,3390,610,4000,August
7760,LOVE CUP AND BEAR 10000,PIECE,1,17000,14407,2593,17000,August
7770,PREDATOR ENERGY 350ML,PIECE,25,2000,42373,7627,50000,August
7771,SUMZ HONEY BUTTER FLAVOUR 12G,PIECE,10,600,5085,915,6000,August
7783,MENTOS PEACH ORANGE,PIECE,12,2500,25424,4576,30000,August
7784,TOUCH AKY,PIECE,2,1250,2119,381,2500,August
7789,JAMIES DANISH BREAD@3500,PIECE,22,3500,65254,11746,77000,August
7790,JAMIES CINNAMON BREAD,PIECE,240,6496,1321186,237814,1559000,August
7794,TOY 12000,PIECE,1,11000,9322,1678,11000,August
7806,FACE MASK PINK 120ML 10000,PIECE,2,10000,16949,3051,20000,August
7808,PICNIK CHOCOLATE 10G,PIECE,19,1000,16102,2898,19000,August
7811,FLAMINGO ROSE& HONEY 200G,PIECE,1,3500,2966,534,3500,August
7813,PETIT BEURRE 78G,PIECE,17,1200,17288,3112,20400,August
7815,7UP 330ML,PIECE,25,1000,21186,3814,25000,August
7816,FRUIT VILLE STRAWBERRY BANANA 500ML,PIECE,20,3500,59322,10678,70000,August
7822,DOVE REVIVING GEL 500ML,PIECE,1,22000,18644,3356,22000,August
7823,DOVE REFRESHING 500ML,PIECE,1,20000,16949,3051,20000,August
7826,JAMIES CINNAMON BREAD 500G,PIECE,46,3500,136441,24559,161000,August
7829,KICK PRINCESS CHICKEN FLAVOUR ,PIECE,193,500,81780,14720,96500,August
7831,7UP 500ML,PIECE,18,1500,22881,4119,27000,August
7832,FANEST BEEF SAUSAGES 500G,PIECE,4,13000,44068,7932,52000,August
7833,FANEST BEEF SAUSAGES 1KG,PIECE,5,21000,88983,16017,105000,August
7853,U BEATY GEL 1.8L,PIECE,1,20000,16949,3051,20000,August
7857,MOOISTE CHOCOLATE,PIECE,8,2500,16949,3051,20000,August
7858,MOOISTE COCOA,PIECE,4,2500,8475,1525,10000,August
7861,ROYAL SHAVERS,PIECE,5,3500,14831,2669,17500,August
7865,SWEETS 700,PIECE,57,700,33806,6085,39891,August
7867,ROCK BOOM 500ML,PIECE,43,3000,109322,19678,129000,August
7871,DOVE ESSENTIAL CARE LOTION 400ML,PIECE,1,19000,16102,2898,19000,August
7876,GRILLED GOATS MEAT 8000,PIECE,58,8000,393220,70780,464000,August
7878,BLUE BAND WITH CHOCO 250G,PIECE,9,6500,49576,8924,58500,August
7879,WEETABIX VANILLA 230G,PIECE,1,9500,8051,1449,9500,August
7884,ROKI COOKING OIL 1L,PIECE,1,9000,7627,1373,9000,August
7885,ROKI COOKING OIL 500ML,PIECE,2,4500,7627,1373,9000,August
7886,PAKA MATCH BOX,PIECE,2,1000,1695,305,2000,August
7887,LIFEBUOY MOISTURE PLUS 175G,PIECE,2,6000,10169,1831,12000,August
7888,REXONA INVISIBLE DRY FRESH ROLLON 72JAM,PIECE,1,10000,8475,1525,10000,August
7894,NUVITA CHOCOLATE COOKIES 100GM,PIECE,18,2500,38136,6864,45000,August
7895,NUVITA BUTTER COOKIES 100GM,PIECE,2,2500,4237,763,5000,August
7901,YULU CLASSIC BOXERS 3PCS 22000,PIECE,1,22000,18644,3356,22000,August
7903,BLUE BAND WITH CHOCO 500G,PIECE,3,11000,27966,5034,33000,August
7905,SAFEGUARD LEMON SOAP,PIECE,4,1500,5085,915,6000,August
7906,SAFEGUARD PURE WHITE ,PIECE,9,1500,11441,2059,13500,August
7907,WEETABIX CORNFLAKES CRUNCHY 250G,PIECE,6,11000,55932,10068,66000,August
7909,ONER APPLE DRINK 200ML,PIECE,130,1000,110169,19831,130000,August
7910,ONER MANGO 200ML,PIECE,66,1000,55932,10068,66000,August
7911,RIHAM X ENERGY 400ML,PIECE,13,2000,22034,3966,26000,August
7913,CLERE BABY JELLY 50G,PIECE,1,2000,1695,305,2000,August
7915,"AMERICAN CROWN LAVENDER A.F, CITRU, LEMON",PIECE,1,7000,5932,1068,7000,August
7918,JAMIES MILK BREAD WHOLESALE 1KG,PIECE,2,5500,9322,1678,11000,August
7919,JAMIES CINNAMON BREAD WHOLESALE 1KG,PIECE,3,5500,13983,2517,16500,August
7922,AKABOGA ONION CHILI PASTE 200ML,PIECE,1,6500,5508,992,6500,August
7923,7UP SODA 2LTR,PIECE,12,4500,45763,8237,54000,August
7927,AMARA MACADAMIA LOTION 400ML,PIECE,1,8500,7203,1297,8500,August
7929,GROW NATURAL HONEY 400G,PIECE,2,12000,20339,3661,24000,August
7930,KELLOGS CORNFLAKES 1KG,PIECE,1,45000,38136,6864,45000,August
7931,RAHA DRINKING CHOCOLATE 400G,PIECE,1,18000,15254,2746,18000,August
7932,DOWNY LUXURY PERFUME 900ML ,PIECE,3,24000,61017,10983,72000,August
7933,WEETABIX CORNFLAKES 50G,PIECE,12,2000,20339,3661,24000,August
7934,SOFTCARE WIPES 10PCS,PIECE,1,1500,1271,229,1500,August
7936,DOWNY LAVENDER CALM900ML,PIECE,2,24000,40678,7322,48000,August
7938,DOWNY SWEET ELEGANCE 300ML,PIECE,3,8500,21610,3890,25500,August
7940,FANEST MINCED BEEF 500G,PIECE,3,13000,33051,5949,39000,August
7943,HIKMA DADDIES 1000,PIECE,6,1000,5085,915,6000,August
7944,HIKMA YELLOW BAGIYA 2500,PIECE,8,2500,16949,3051,20000,August
7953,SAFISHA SCOURING PAD,PIECE,2,2000,3390,610,4000,August
7954,ROYCO 2-IN-1 200G,PIECE,6,6500,33051,5949,39000,August
7956,JAMIES COOKIES TIN 7000,PIECE,1,7000,5932,1068,7000,August
7957,NSUUBE ROASTED GROUND COFFEE 65G,PIECE,4,4000,13559,2441,16000,August
7958,NSUUBE ROASTED COFFEE 100G,PIECE,2,7000,11864,2136,14000,August
7959,"ANKIT CRIMBLES STRAWBERY BISCUIT, VAN,CHO ",PIECE,13,4500,49576,8924,58500,August
7960,BERTINI OLIVE OIL EXTRA VIRGIN 250ML,PIECE,2,15000,25424,4576,30000,August
7962,PIAO PIAO SANITARY PADS ULTRA THIN,PIECE,1,4000,3390,610,4000,August
7963,PIAO PIAO SANITARY PADS EXTRA LENGTH,PIECE,1,4000,3390,610,4000,August
7964,PIAO PIAO HANDKERCHIEF,PIECE,4,1500,5085,915,6000,August
7965,TIFFANY NUTTYBITES CHO&HAZLENUT,PIECE,8,2500,16949,3051,20000,August
7966,TIFFANY NUTTYBITES ALMOND,PIECE,9,2500,19068,3432,22500,August
7967,SUNVEAT PETIT BEURRE CHO-VAN BISCUIT 75G,PIECE,13,1200,13220,2380,15600,August
7968,SUNVEAT MIXED NUT COOKIES 100G,PIECE,15,2000,25424,4576,30000,August
7969,CREMCA GOLDEN BITES BUTTER COOKIES,PIECE,6,2500,12712,2288,15000,August
7970,FINI CINEMA MAX 165G,PIECE,4,13000,44068,7932,52000,August
7971,FINI LITTLE MIX 165G,PIECE,5,13000,55085,9915,65000,August
7972,MARSHMALLOW TIANS CONFECTION 327G,PIECE,1,22000,18644,3356,22000,August
7973,AMERICAN GARDEN HONEY BBQ SAUCE 510G,PIECE,1,25000,21186,3814,25000,August
7974,KIVUUVU 1000,PIECE,53,1000,44915,8085,53000,August
7975,WISDOM JUNIOR TOOTHBRUSH,PIECE,6,2500,12712,2288,15000,August
7976,ACE TOILET CLEANER OCEAN FRESH 250ML,PIECE,3,5000,12712,2288,15000,August
7977,BIRTHDAY CANDLE NO. 3500,PIECE,2,3500,5932,1068,7000,August
7978,STUNT CAR 23000,PIECE,2,23000,38983,7017,46000,August
7979,MAGIC CUBE 10000,PIECE,1,10000,8475,1525,10000,August
7980,KINGKAT 1500,PIECE,19,1500,24153,4347,28500,August
7982,DAILY FRESH SIMSIM BAR 1500,PIECE,20,1500,25424,4576,30000,August
7983,DAILY FRESH PEANUT BAR 1500,PIECE,9,1500,11441,2059,13500,August
7984,JESA BON-GA COCONUT YOGHURT 330G,PIECE,3,3500,8898,1602,10500,August
7985,JESA BON-GA MANGO 330G,PIECE,15,3500,44492,8008,52500,August
7986,JESA BON-GA STRAWBERRY YOGHURT 330G,PIECE,16,3500,47458,8542,56000,August
7987,SOFTCARE BABY PANTS L8,PIECE,3,9000,22881,4119,27000,August
7988,OASIS HAND WASH 500ML,PIECE,1,7000,5932,1068,7000,August
7989,GONJA FRIED 2000,PIECE,36,2000,61017,10983,72000,August
7990,GONJA FRIED 1500,PIECE,28,1554,36864,6636,43500,August
7991,COLGATE TOOTHBRUSH KIDS 2000,PIECE,3,2000,5085,915,6000,August
7993,JAMIES MARBLE CAKE @5000,PIECE,8,5000,33898,6102,40000,August
7997,NUVITA COOKIES APPLE CINNAMON 100G,PIECE,2,2500,4237,763,5000,August
7998,RINSUN SUNFLOWER OIL 2LTRS,PIECE,3,25000,63559,11441,75000,August
7999,TIC TACK CHOCOLATE 27G 1500/ TOUCH CHOC.,PIECE,2,1500,2542,458,3000,August
8000,BREAKTIME WAFER 1000,PIECE,8,1000,6780,1220,8000,August
8002,AMERICAN CROWN APPLE& CINNAMON A.F,PIECE,1,7000,5932,1068,7000,August
4,180ML DISPOSABLE GLASSES,PIECE,3,3000,7627,1373,9000,September
7,300MLS DISPOSABLE GLASSES,PIECE,7,5000,29661,5339,35000,September
9,500MLS DISPOSABLE GLASSES,PIECE,1,6000,5085,915,6000,September
10,5LTR JERRICAN 3000,PIECE,1,4000,3390,610,4000,September
12,7 DAYS BABY WIPES,PIECE,2,8500,14407,2593,17000,September
14,7 DAYS WIPES,PIECE,1,5000,4237,763,5000,September
15,7DAYS ANTIBACTERIAL BABY WIPES,PIECE,1,8500,7203,1297,8500,September
16,7DAYS ANTIBACTERIAL WIPES,PIECE,16,5000,67797,12203,80000,September
26,ABC BABY WIPES,PIECE,4,9000,30508,5492,36000,September
35,ACTIVE MAN SPRAY,PIECE,2,10000,16949,3051,20000,September
36,ACTIVE WOMAN BODY SPRAY,PIECE,3,10000,25424,4576,30000,September
49,AFIA APPLE 500ML,PIECE,13,3000,33051,5949,39000,September
51,AFIA MANGO 500MLS,PIECE,18,3000,45763,8237,54000,September
52,AFIA MIXED FRUIT 500MLS,PIECE,5,3000,12712,2288,15000,September
54,AFIA ORANGE 500ML,PIECE,7,3000,17797,3203,21000,September
55,AFIA WHITE GUAVA,PIECE,13,3000,33051,5949,39000,September
58,AFRICANA TEA BAGS 50,PIECE,2,5000,8475,1525,10000,September
60,AFROCARE BODY LOTION 400ML,PIECE,1,6000,5085,915,6000,September
61,AFROCARE JELLY 100G,PIECE,1,3000,2542,458,3000,September
63,AFROCARE PETROLEUM JELLY,PIECE,4,4500,15254,2746,18000,September
73,ALPER DRAJE CHOCOLATE,PIECE,2,3500,5932,1068,7000,September
81,ALWAYS COTTON EXTRA LONG,PIECE,2,3000,5085,915,6000,September
83,ALWAYS COTTON MAXITHICK,PIECE,8,3000,20339,3661,24000,September
86,ALWAYS EXTRA LONG,PIECE,18,3500,53390,9610,63000,September
88,ALWAYS LONG,PIECE,15,3500,44492,8008,52500,September
91,ALWAYS ULTRA THIN,PIECE,17,4000,57627,10373,68000,September
93,ALWAYS V.P EXTRA LONG,PIECE,3,6500,16525,2975,19500,September
95,ALWAYS VALUE PACK LONG,PIECE,1,6500,5508,992,6500,September
98,AMARA ALOEVERA 400ML,PIECE,1,8500,7203,1297,8500,September
107,AMARA COCONUT 400ML,PIECE,1,8500,7203,1297,8500,September
114,AMARA MEN COOLING,PIECE,3,6500,16525,2975,19500,September
116,AMARA RAW SHEA LOTION 400ML,PIECE,4,8500,28814,5186,34000,September
126,AMERICAN GARDEN KETCHUP 340G,PIECE,4,8500,28814,5186,34000,September
136,AMERICAN GREEN GARDEN HONEY 200G,PIECE,2,8500,14407,2593,17000,September
146,AMLA HAIR OIL 100ML,PIECE,1,7000,5932,1068,7000,September
154,AMRAF HIGH STREET MIST,PIECE,1,17000,14407,2593,17000,September
157,ANKIT BOURBON,PIECE,3,5000,12712,2288,15000,September
173,ANKLE STOCKS,PIECE,7,1500,8898,1602,10500,September
175,ANTOL SOAP 75G,PIECE,1,3000,2542,458,3000,September
179,APPLE CIDER VINEGAR 473MLS,PIECE,3,11000,27966,5034,33000,September
182,APPLES GREEN,PIECE,356,1500,452542,81458,534000,September
183,APPLES RED,PIECE,639,1500,812288,146212,958500,September
192,AQUAFRESH 50MLS,PIECE,1,5000,4237,763,5000,September
212,ARIEL DOWNY 500G,PIECE,1,7500,6356,1144,7500,September
213,ARIEL DOWNY LAVENDER500G,PIECE,1,7500,6356,1144,7500,September
218,ARMAF AIR FRESHNER SPRING,PIECE,2,11000,18644,3356,22000,September
226,ARMAF ENCHANTED VINTAGE,PIECE,2,11000,18644,3356,22000,September
231,ARMAF LE FEMME MIST,PIECE,1,17000,14407,2593,17000,September
240,ARMAF TAG-HIM SPRAY,PIECE,1,15000,12712,2288,15000,September
253,AROMAT 200G,PIECE,6,12000,61017,10983,72000,September
254,AROMAT 75G,PIECE,7,5714,33898,6102,40000,September
270,ART BOOK BIG,PIECE,4,4000,13559,2441,16000,September
271,ART BOOK SMALL,PIECE,9,2000,15254,2746,18000,September
273,ART PENCILS 2B,PIECE,2,1000,1695,305,2000,September
274,ART PENCILS 3B,PIECE,4,1000,3390,610,4000,September
275,ART PENCILS 4B,PIECE,2,1000,1695,305,2000,September
276,ART PENCILS 5B,PIECE,2,1000,1695,305,2000,September
277,ART PENCILS 6B,PIECE,8,1000,6780,1220,8000,September
299,ATIS CREAM CHOCOLATE,PIECE,5,500,2119,381,2500,September
311,AUNT PORRIDGE 1KG,PIECE,6,14000,71186,12814,84000,September
312,AUNT PORRIDGE 2KG,PIECE,1,28000,23729,4271,28000,September
313,AUNT PORRIDGE 6MONTHS,PIECE,5,14000,59322,10678,70000,September
326,AXE BLACK,PIECE,1,13000,11017,1983,13000,September
332,AXE EXCITE BODY SPRAY,PIECE,1,13000,11017,1983,13000,September
334,AXE MUSK,PIECE,2,13000,22034,3966,26000,September
339,AXESS AQUA,PIECE,6,9000,45763,8237,54000,September
344,AZAM BAKING FLOUR 2KG,PIECE,4,8500,28814,5186,34000,September
346,AZAM EMBE MANGO,PIECE,10,1500,12712,2288,15000,September
347,AZAM ENERGY DRINK 300MLS,PIECE,36,1500,45763,8237,54000,September
348,AZAM MALT 300MLS,PIECE,16,1500,20339,3661,24000,September
349,AZAM MALT 500MLS,PIECE,14,3000,35593,6407,42000,September
353,B.D CANDLE NUMBERS,PIECE,7,1500,8898,1602,10500,September
354,B.D CANDLES 1500,PIECE,2,1500,2542,458,3000,September
389,BABY BOTTLES BEIKU 3PCS13000,PIECE,2,15000,25424,4576,30000,September
434,BABY FORKS 1200,PIECE,1,1200,1017,183,1200,September
440,BABY JUNIOR 50G,PIECE,4,1750,5932,1068,7000,September
441,BABY JUNIOR BABY OIL 90ML,PIECE,2,3500,5932,1068,7000,September
442,BABY JUNIOR JELLY 200g,PIECE,1,6000,5085,915,6000,September
443,BABY JUNIOR JELLY 24ML,PIECE,5,1000,4237,763,5000,September
450,BABY LOVE TOY 15000,PIECE,1,15000,12712,2288,15000,September
464,BABY PLATES 7000,PIECE,2,7000,11864,2136,14000,September
466,BABY RATTLES,PIECE,1,12000,10169,1831,12000,September
497,BABY& ME BABYJELLY 240ML,PIECE,4,5000,16949,3051,20000,September
501,BABY&ME JELLY 120ML,PIECE,2,3000,5085,915,6000,September
504,BACK PACK OUTDOOR SPORT SPRAY,PIECE,2,13000,22034,3966,26000,September
523,BALLET ACTIVE VITAMIN 120MLS,PIECE,1,5500,4661,839,5500,September
524,BALLET ACTIVE VITAMIN 300MLS,PIECE,1,10000,8475,1525,10000,September
525,BALLET ALMOMD OIL 125ML,PIECE,2,10000,16949,3051,20000,September
526,BALLET ALOE VERA 120MLS,PIECE,4,5500,18644,3356,22000,September
528,BALLET BABY JELLY 120MLS,PIECE,13,5500,60593,10907,71500,September
529,BALLET BABY JELLY 300MLS,PIECE,4,11000,37288,6712,44000,September
532,BALLET BABY LOTION 240ML,PIECE,1,12000,10169,1831,12000,September
537,BALLET BUTTER BLEND 120MLS,PIECE,6,5500,27966,5034,33000,September
542,BALLET REGULAR,PIECE,6,4000,20339,3661,24000,September
543,BALLET SHEA BUTTER SOAP,PIECE,4,4000,13559,2441,16000,September
552,BALLS 15000,PIECE,1,15000,12712,2288,15000,September
556,BALLS AND DOLLS LIGHTING 7000,PIECE,1,7000,5932,1068,7000,September
563,BALOON 300,PIECE,134,300,34068,6132,40200,September
570,BAMBOO TOOTHPICK 2500,PIECE,3,2667,6780,1220,8000,September
589,BASKETS 3000,PIECE,1,3000,2542,458,3000,September
590,BASKETS 5000,PIECE,1,5000,4237,763,5000,September
613,BECCA COUNTERBOOK 5000,PIECE,2,3500,5932,1068,7000,September
627,BEIKU BABY SOOTHERS,PIECE,1,2500,2119,381,2500,September
636,BESSA MILLET DRINK 500MLS,PIECE,7,4500,26695,4805,31500,September
637,BESSA MILLET MALT DRINK 330ML,PIECE,9,3000,22881,4119,27000,September
639,BEST RULER 1000,PIECE,9,1000,7627,1373,9000,September
646,BIC LADY SHAVER 1500,PIECE,4,1500,5085,915,6000,September
647,BIC PENS,PIECE,105,700,62288,11212,73500,September
648,BIC SHEVARS,PIECE,50,1000,42373,7627,50000,September
649,BI-CARBONATE SODA,PIECE,6,1000,5085,915,6000,September
653,BIG BOSS CREAM 200ML,PIECE,3,5000,12712,2288,15000,September
654,BIG BOSS FOR MEN 100ML,PIECE,1,3000,2542,458,3000,September
659,BIKERS ST MICHAEL 10000,PIECE,1,10000,8475,1525,10000,September
662,BIO- OIL 25ML 10000,PIECE,2,13000,22034,3966,26000,September
664,BIRTHDAY CANDLES 3500,PIECE,7,4000,23729,4271,28000,September
665,BIRTHDAY CANDLES 4000,PIECE,2,3500,5932,1068,7000,September
667,BIRTHDAY CROWNS 5000,PIECE,1,5000,4237,763,5000,September
676,BIRTHDAYCROWNS 3500,PIECE,1,3000,2542,458,3000,September
681,BIYINZIKA CHICKEN GIZZARDS 500G,PIECE,1,11000,9322,1678,11000,September
684,BIYINZIKA DRUMSTICKS 500G,PIECE,2,15000,25424,4576,30000,September
685,BIYINZIKA GIANT 1.7KG 23000,PIECE,1,27000,22881,4119,27000,September
688,BIYINZIKA STANDARD1.2KG,PIECE,3,25000,63559,11441,75000,September
689,BIYINZIKA SUPA 1KG,PIECE,2,20000,33898,6102,40000,September
690,BIYINZIKA THIGHS 500G,PIECE,1,11000,9322,1678,11000,September
691,BIYINZIKA WINGS 500G,PIECE,2,13000,22034,3966,26000,September
703,BLESSED KISUBI TEA 125G,PIECE,5,5000,21186,3814,25000,September
704,BLESSED KISUBI TEA 200G,PIECE,3,6000,15254,2746,18000,September
712,BLUE 4 MEN SPRAY,PIECE,1,12000,10169,1831,12000,September
713,BLUE BAND 100G,PIECE,44,2500,93220,16780,110000,September
714,BLUE BAND 1KG,PIECE,2,19000,32203,5797,38000,September
716,BLUE BAND 500G,PIECE,2,10000,16949,3051,20000,September
717,BLUE BAND LOW FAT,PIECE,2,6500,11017,1983,13000,September
718,BLUE BAND LOW SPREAD 250G,PIECE,12,4000,40678,7322,48000,September
722,BLUE LADY LOTION 300ML,PIECE,1,6000,5085,915,6000,September
723,BLUE LADY PERFUMED TALC,PIECE,1,8000,6780,1220,8000,September
731,BLUEBAND LOW FAT 100G,PIECE,2,2000,3390,610,4000,September
732,BLUEBAND PEANUT BUTTER,PIECE,4,8000,27119,4881,32000,September
733,BLUEBAND PEANUT BUTTER 400G,PIECE,1,14000,11864,2136,14000,September
738,BODY LUXE GLYCERINE,PIECE,2,2500,4237,763,5000,September
740,BODY LUXE PETROLEUM JELLY,PIECE,2,4500,7627,1373,9000,September
745,BODYLUXE JELLY 500G,PIECE,2,10000,16949,3051,20000,September
765,BOTTLES 12000,PIECE,1,12000,10169,1831,12000,September
766,BOTTLES 17000,PIECE,2,17000,28814,5186,34000,September
767,BOTTLES 10000,PIECE,2,10000,16949,3051,20000,September
769,BOTTLES 15000,PIECE,2,15000,25424,4576,30000,September
771,BOTTLES 18000,PIECE,1,18000,15254,2746,18000,September
776,BOTTLES 7000,PIECE,1,7000,5932,1068,7000,September
781,BOUNTY CHOCOLATE,PIECE,19,3500,56356,10144,66500,September
790,BOX FILES 6000,PIECE,1,7000,5932,1068,7000,September
795,BRAS 20000,PIECE,1,20000,16949,3051,20000,September
815,BRITANIA ASSORTED 1KG,PIECE,1,20000,16949,3051,20000,September
820,BRITANIA DIGESTIVE 1KG,PIECE,1,20000,16949,3051,20000,September
824,BRITANIA MILK BISCUIT,PIECE,19,500,8051,1449,9500,September
826,BRITANIA MUNCHIES BISCUITS,PIECE,94,500,39831,7169,47000,September
829,BRITANIA NICE COCONUT BISCUITS,PIECE,8,4000,27119,4881,32000,September
830,BRITANIA SHORT CAKE 200G,PIECE,11,4000,37288,6712,44000,September
833,BRITANIA SHORTCAKE BISCUITS 1KG,PIECE,2,20000,33898,6102,40000,September
836,BROOKSIDE FRUIT STRAWBERRIES,PIECE,29,5500,135169,24331,159500,September
838,BROOKSIDE FRUIT VANILLA 250G,PIECE,4,3000,10169,1831,12000,September
842,BROOKSIDE LEMON 250G,PIECE,5,3000,12712,2288,15000,September
843,BROOKSIDE LEMON BISCUITS 450G,PIECE,23,5500,107203,19297,126500,September
844,BROOKSIDE MILK 500ML,PIECE,23,2300,44831,8069,52900,September
845,BROOKSIDE PEAR CARAMEL,PIECE,1,5000,4237,763,5000,September
846,BROOKSIDE PEAR CARAMEL 250G,PIECE,16,3000,40678,7322,48000,September
849,BROOKSIDE STRAWBERRIES 250G,PIECE,15,3000,38136,6864,45000,September
869,BUCKETS ANGEL 6500,PIECE,1,6500,5508,992,6500,September
882,BUFFER,PIECE,2,4500,7627,1373,9000,September
888,BUILDING BLOCKS GOOD PARTNER 18000,PIECE,1,18000,15254,2746,18000,September
890,BUSHENYI HONEY 250G,PIECE,6,6000,30508,5492,36000,September
891,BUSHENYI HONEY 5OOG,PIECE,5,9000,38136,6864,45000,September
892,BUSHENYI HONEY 90G,PIECE,5,3500,14831,2669,17500,September
898,C' WARM CHOCOLATE,PIECE,2,500,847,153,1000,September
901,C.B CHOCOLATE CHOCO CHIP 120ML,PIECE,2,2500,4237,763,5000,September
902,C.B CHOCOLATE CHOCO CHIPS 200ML,PIECE,1,5000,4237,763,5000,September
904,C.B CLASSIC VANILLA 1LTR,PIECE,1,19500,16525,2975,19500,September
911,C.B MAGIC STRAWBERRY 1LTR,PIECE,1,19500,16525,2975,19500,September
913,C.B RIPPLES CHOCOLATE 200ML,PIECE,8,4000,27119,4881,32000,September
914,C.B RIPPLES MIXED 200MLS,PIECE,5,4000,16949,3051,20000,September
916,C.B RIPPLES STRAWBERRY 200ML,PIECE,7,4000,23729,4271,28000,September
917,C.B ROYAL MANGO 120ML,PIECE,2,2500,4237,763,5000,September
918,C.B ROYAL MANGO 200ML,PIECE,9,4500,34322,6178,40500,September
920,C.B VANILA CHOCO 1LTR,PIECE,3,19500,49576,8924,58500,September
927,CA MAN BODY SPRAY,PIECE,2,12000,20339,3661,24000,September
939,CADBURY DAIRY MILK MINT CRISP 80G,PIECE,8,8000,54237,9763,64000,September
941,CADBURY DAIRYMILK 10G CHOCOLATE,PIECE,22,1500,27966,5034,33000,September
943,CADBURY DREAM WHITE CREAMY 80G,PIECE,22,8000,149153,26847,176000,September
944,CADBURY DRINKING CHOCOLATE 125G,PIECE,5,9000,38136,6864,45000,September
946,CADBURY FRUIT & NUT 80G,PIECE,6,8000,40678,7322,48000,September
949,CADBURY RUM&RAISIN 80G,PIECE,2,8000,13559,2441,16000,September
951,CADBURY TOPDECK MINT,PIECE,1,8000,6780,1220,8000,September
965,CAKE TOPPER 5000,PIECE,1,5000,4237,763,5000,September
966,CAKE WRAPPER 1000,PIECE,1,1000,847,153,1000,September
988,CAMLIN ERASERS,PIECE,2,2500,4237,763,5000,September
1029,CARROT CAKE,PIECE,40,5000,169492,30508,200000,September
1037,CASHO CALC,PIECE,1,15000,12712,2288,15000,September
1038,CASIO 401/991MS CALCULATOR,PIECE,1,45000,38136,6864,45000,September
1045,CB CHOC-VANILLA 120MLS,PIECE,3,2500,6356,1144,7500,September
1046,CB CLASSIC VANILLA 120MLS,PIECE,3,2500,6356,1144,7500,September
1047,CB CLASSIC VANILLA 200MLS,PIECE,2,4000,6780,1220,8000,September
1048,CB CLASSIC VANILLA 500ML,PIECE,1,10000,8475,1525,10000,September
1052,CB LICKS ORANGE,PIECE,2,2000,3390,610,4000,September
1053,CB MAGIC S-BERRY 200MLS,PIECE,6,4000,20339,3661,24000,September
1054,CB MAGIC STRAW 500ML,PIECE,1,10000,8475,1525,10000,September
1055,CB STRAWBERRY VANILLA,PIECE,1,20000,16949,3051,20000,September
1058,CELOTAPE 2000,PIECE,1,2500,2119,381,2500,September
1060,CELOTAPE BLACK,PIECE,1,1500,1271,229,1500,September
1061,CELOTAPE BROWN BIG,PIECE,2,6000,10169,1831,12000,September
1062,CELOTAPE BROWN SMALL,PIECE,3,3000,7627,1373,9000,September
1064,CELOTAPE SMALL 1000,PIECE,5,1000,4237,763,5000,September
1066,CERELAC 12MONTHS 400G,PIECE,1,30000,25424,4576,30000,September
1067,CERELAC 6MONTHS,PIECE,1,30000,25424,4576,30000,September
1087,CERES TROPICAL 1LTR,PIECE,11,12000,111864,20136,132000,September
1093,CHAMPION A4 200PAGES,PIECE,2,4000,6780,1220,8000,September
1095,CHAPA BAKING POWDER,PIECE,1,1500,1271,229,1500,September
1096,CHAPA NYOTA BLUE 600G,PIECE,7,4000,23729,4271,28000,September
1097,CHAPA NYOTA BROWN 600G,PIECE,4,4000,13559,2441,16000,September
1110,CHELSEA CROWN PERFUME,PIECE,1,12000,10169,1831,12000,September
1112,CHERRY COTTON BUDS 150,PIECE,1,3000,2542,458,3000,September
1131,CHINA GREEN TEA 50G,PIECE,2,6000,10169,1831,12000,September
1134,CHOCOLATE 500,PIECE,15,500,6356,1144,7500,September
1163,CLAIRMEN CREAM 120ML,PIECE,3,7000,17797,3203,21000,September
1164,CLASSIC 96 PAGES,PIECE,19,2000,32203,5797,38000,September
1166,PICFARE GOLD 96PGS,PIECE,13,1269,13983,2517,16500,September
1169,CLASSIC G.B.K WHOLE MILK 500ML,PIECE,46,2183,85085,15315,100400,September
1170,CLASSIC LEADER BOOKS 200PGS,PIECE,1,3000,2542,458,3000,September
1171,CLASSIC MILK BOX 23000,BOX,1,24000,20339,3661,24000,September
1176,CLEAR BAG 1000,PIECE,10,1000,8475,1525,10000,September
1177,CLEAR TIN,PIECE,2,1500,2542,458,3000,September
1182,CLEOS HOT SAUCE 125G,PIECE,1,3500,2966,534,3500,September
1184,CLERE ALOEVERA 100G,PIECE,1,3500,2966,534,3500,September
1185,CLERE ALOEVERA 250G,PIECE,1,7000,5932,1068,7000,September
1191,CLERE MEN ICE 100G,PIECE,1,3500,2966,534,3500,September
1192,CLERE MEN STORM 100G,PIECE,1,3000,2542,458,3000,September
1193,CLERE PETROLEUM JELLY 250G,PIECE,1,6000,5085,915,6000,September
1195,CLIMAX BERRIES 170G,PIECE,1,6000,5085,915,6000,September
1197,CLIMAX CITRUS FRUITS 170G,PIECE,2,6000,10169,1831,12000,September
1199,CLIMAX EXOTIC TROPICAL FRUITS 170G,PIECE,2,6000,10169,1831,12000,September
1200,CLIMAX FOREST FRUITS 170G,PIECE,3,6000,15254,2746,18000,September
1201,CLIMAX FOREST FRUITS 50G,PIECE,1,2500,2119,381,2500,September
1202,CLIMAX TROPICAL FRUITS 50G,PIECE,1,2500,2119,381,2500,September
1212,CLOSEUP TRIPLEFRESH 60G,PIECE,3,3000,7627,1373,9000,September
1213,CLOSEUP TRIPPLE FRESH 125G,PIECE,2,5000,8475,1525,10000,September
1221,COCACOLA 2LTRS,PIECE,74,5000,313559,56441,370000,September
1222,COCACOLA 350MLS,PIECE,124,1000,105085,18915,124000,September
1223,COCACOLA 500MLS,PIECE,76,1500,96610,17390,114000,September
1224,COCACOLA CAN 330ML,PIECE,15,3000,38136,6864,45000,September
1227,COCACOLA ZERO 350ML,PIECE,1,1000,847,153,1000,September
1239,COCOPULP CREME 100ML,PIECE,3,8000,20339,3661,24000,September
1244,COLGATE 0-2YEARS,PIECE,5,4500,19068,3432,22500,September
1245,COLGATE CHARCOAL GENTLE CLEAN,PIECE,21,7500,133475,24025,157500,September
1246,COLGATE CHARCOAL TWIN TOOTHBRUSH,PIECE,27,4000,91525,16475,108000,September
1247,COLGATE CHILDREN 50MLS,PIECE,13,4500,49576,8924,58500,September
1248,COLGATE DEEP CLEAN,PIECE,10,1500,12712,2288,15000,September
1249,COLGATE DOUBLE ACTION,PIECE,18,4000,61017,10983,72000,September
1252,COLGATE HERBAL 140G,PIECE,13,7500,82627,14873,97500,September
1253,COLGATE HERBAL 230G,PIECE,4,10000,33898,6102,40000,September
1254,COLGATE HERBAL 35G,PIECE,21,2500,44492,8008,52500,September
1255,COLGATE HERBAL 70G,PIECE,22,4500,83898,15102,99000,September
1256,COLGATE KIDS 2-5YEARS,PIECE,7,5000,29661,5339,35000,September
1257,COLGATE MAX FRESH 65G,PIECE,8,3500,23729,4271,28000,September
1259,COLGATE MAX-FRESH 130G,PIECE,8,6500,44068,7932,52000,September
1261,COLGATE MAXIMUM CAVITY 140G,PIECE,2,7500,12712,2288,15000,September
1262,COLGATE MAXIMUM CAVITY 35G,PIECE,7,2500,14831,2669,17500,September
1263,COLGATE MAXIMUM CAVITY 70G,PIECE,8,4500,30508,5492,36000,September
1265,COLGATE TOOTBRUSH,PIECE,20,2500,42373,7627,50000,September
1266,COLGATE TOOTHBRUSH 1500,PIECE,6,1500,7627,1373,9000,September
1267,COLGATE TOOTHBRUSH CHARCOAL,PIECE,20,2500,42373,7627,50000,September
1269,COLGATE TRIPLE ACTION 140G,PIECE,6,6500,33051,5949,39000,September
1270,COLGATE TRIPPLE ACTION 70G,PIECE,2,4000,6780,1220,8000,September
1274,COLORES NEW ELITE COLOURS BIG,PIECE,5,2000,8475,1525,10000,September
1277,COMB 1500,PIECE,7,1500,8898,1602,10500,September
1280,COMB WITH MIRROR 2500,PIECE,3,2500,6356,1144,7500,September
1286,COMFORT T.P 1000,PIECE,134,1000,113559,20441,134000,September
1289,COMPACT T.P,PIECE,107,1000,90678,16322,107000,September
1290,COMPO PENS,PIECE,1,3000,2542,458,3000,September
1301,CONTAINERS 10000,PIECE,1,5000,4237,763,5000,September
1330,COTTON BUDS WOODEN,PIECE,4,2500,8475,1525,10000,September
1338,COVERTINA MILK CHOCOLATE,PIECE,1,3500,2966,534,3500,September
1343,COW & GATE 1 400GM,PIECE,4,44000,149153,26847,176000,September
1344,COW & GATE 2,PIECE,1,44000,37288,6712,44000,September
1349,COWBOY 500G,PIECE,2,7500,12712,2288,15000,September
1356,CREAMBELL MAGIC STRAW120ML,PIECE,4,2500,8475,1525,10000,September
1357,CREAMBELL STRAWBERRY VAN 500ML,PIECE,3,10000,25424,4576,30000,September
1358,CREAMBELL STRAW-VAN 120ML,PIECE,3,2500,6356,1144,7500,September
1359,CREAMY EFFECT WIPES,PIECE,6,6000,30508,5492,36000,September
1389,CUSSON SOAP MILD&GENTLE,PIECE,3,3500,8898,1602,10500,September
1391,CUSSONS BABY OIL 100MLS,PIECE,5,9000,38136,6864,45000,September
1393,CUSSONS BABY OIL PINK 200MLS,PIECE,2,16000,27119,4881,32000,September
1394,CUSSONS BABY PERFUMED JELLY 200ML,PIECE,4,12000,40678,7322,48000,September
1397,CUSSONS BABY UNPERFUMED JELLY 200ML,PIECE,1,12000,10169,1831,12000,September
1401,CUSSONS PERFUMED JELLY A&R 100ML,PIECE,4,6000,20339,3661,24000,September
1406,CUSSONS SOAP SOFT&SMOOTH,PIECE,7,3500,20763,3737,24500,September
1412,CUTTERS 1000,PIECE,3,1000,2542,458,3000,September
1413,CUTTERS 1500,PIECE,2,1500,2542,458,3000,September
1419,D.L BLUEBERRY SWIRL 500ML,PIECE,5,10000,42373,7627,50000,September
1422,D.L CHOCOLATE RIPPLE 500ML,PIECE,5,10000,42373,7627,50000,September
1423,D.L FIESTA CLASSIC 100MLS,PIECE,19,3500,56356,10144,66500,September
1424,D.L FIESTA SALTED CARAMEL,PIECE,31,3984,104661,18839,123500,September
1425,D.L MANGO 250ML,PIECE,9,5000,38136,6864,45000,September
1426,D.L MAXIMO BISCOTTI 175ML,PIECE,9,4500,34322,6178,40500,September
1427,D.L MAXIMO CARAMEL NUTS,PIECE,13,4500,49576,8924,58500,September
1428,D.L MAXIMO VAN-CHOCO FLAKES 175ML,PIECE,10,4500,38136,6864,45000,September
1429,D.L MEGA CONE VANILLA,PIECE,29,3500,86017,15483,101500,September
1430,D.L MINI FIESTA CARAMEL,PIECE,28,3000,71186,12814,84000,September
1431,D.L MINI FIESTA CLASSIC 70MLS,PIECE,35,3000,88983,16017,105000,September
1435,D.L STRAWBERRY RIPPLE 500ML,PIECE,3,10000,25424,4576,30000,September
1437,D.L VAN.STRAW 250ML,PIECE,26,5000,110169,19831,130000,September
1440,D.L VAN-CHOC 500ML,PIECE,6,10000,50847,9153,60000,September
1443,D.L VANILLA 500ML,PIECE,7,10000,59322,10678,70000,September
1444,D.L VANILLA CREAM 120MLS,PIECE,21,2000,35593,6407,42000,September
1445,D.L VAN-STRAW 120ML,PIECE,20,2000,33898,6102,40000,September
1447,D.L VAN-STRAW 500ML,PIECE,8,10000,67797,12203,80000,September
1450,DABUR HERBAL CLOVE 150G,PIECE,11,6000,55932,10068,66000,September
1453,DABUR NEEM TOOTHPASTE 150G,PIECE,2,6000,10169,1831,12000,September
1457,DAIRIES 12000,PIECE,6,12000,61017,10983,72000,September
1461,DAIRY MILK PLAIN 80G,PIECE,19,8000,128814,23186,152000,September
1462,DAIRY MILK TOP DECK 80G,PIECE,5,8000,33898,6102,40000,September
1464,DAIRY TOP YOGHURT STRAWBERRY 250G,PIECE,93,1000,78814,14186,93000,September
1465,DAIRY TOP YOGHURT VANILLA 250G,PIECE,6,1000,5085,915,6000,September
1484,DATES 1000,PIECE,25,1000,21186,3814,25000,September
1485,DATES 2000,PIECE,23,2500,48729,8771,57500,September
1486,DATES 3000,PIECE,11,3500,32627,5873,38500,September
1500,DEAR BODY THURSDAY BODY MIST,PIECE,1,16000,13559,2441,16000,September
1501,DEAR BODY TUESDAY BODY MIST,PIECE,1,16000,13559,2441,16000,September
1510,DELIDENT MAX 70G,PIECE,7,2000,11864,2136,14000,September
1511,DELLA CHOCOLATE,PIECE,13,3000,33051,5949,39000,September
1512,DELUXE ALUMINIUM FOIL,PIECE,3,6500,16525,2975,19500,September
1514,DEMICH PORRIDGE ENERGY BOOSTER 1KG,PIECE,6,7000,35593,6407,42000,September
1527,DENTEX TOOTHBRUSH SOFT,PIECE,3,3500,8898,1602,10500,September
1539,DETTOL 125MLS,PIECE,5,9000,38136,6864,45000,September
1540,DETTOL ACTIVE 175G,PIECE,2,6500,11017,1983,13000,September
1542,DETTOL COOL 105G,PIECE,2,4500,7627,1373,9000,September
1543,DETTOL COOL 175G,PIECE,2,6500,11017,1983,13000,September
1544,DETTOL EVENTONE 175G,PIECE,1,6500,5508,992,6500,September
1547,DETTOL FRESH 175G,PIECE,3,6500,16525,2975,19500,September
1550,DETTOL HERBAL 105G,PIECE,3,4500,11441,2059,13500,September
1551,DETTOL HERBAL 175G,PIECE,8,6500,44068,7932,52000,September
1552,DETTOL JUNIORS GLYCERINE SOAP 100G,PIECE,5,4500,19068,3432,22500,September
1553,DETTOL LIQUID 250 MLS,PIECE,2,15000,25424,4576,30000,September
1555,DETTOL LIQUID 50MLS,PIECE,5,4000,16949,3051,20000,September
1557,DETTOL ORIGINAL 100G,PIECE,7,4500,26695,4805,31500,September
1558,DETTOL ORIGINAL 175G,PIECE,2,6500,11017,1983,13000,September
1559,DETTOL SENSITIVE 175G,PIECE,2,6500,11017,1983,13000,September
1560,DETTOL SKINCARE 175G,PIECE,1,6500,5508,992,6500,September
1561,DETTOL SKINCARE 90G,PIECE,2,4500,7627,1373,9000,September
1568,DEXE BLACK HAIR SHAMPOO,PIECE,9,2000,15254,2746,18000,September
1594,DISPOSABLE BOWLS 3500,PIECE,1,3500,2966,534,3500,September
1599,DISPOSABLE PLATES 12000,PIECE,1,12000,10169,1831,12000,September
1602,DISPOSABLE PLATES 9 ROUND,PIECE,3,7000,17797,3203,21000,September
1607,DIVINE 300MLS,PIECE,24,2500,50847,9153,60000,September
1608,DIVINE 500MLS,PIECE,48,4000,162712,29288,192000,September
1633,DOLBY SPORT SPRAY,PIECE,2,12000,20339,3661,24000,September
1634,DOLBY SPRAY,PIECE,2,10000,16949,3051,20000,September
1641,DOLL 25000,PIECE,1,25000,21186,3814,25000,September
1654,"DOLLS 30000 DAN,FROZN FROST",PIECE,1,30000,25424,4576,30000,September
1661,DOLLS YONG 17000,PIECE,1,17000,14407,2593,17000,September
1662,DOLPHIN MONDI PAPERS,PIECE,4,26500,89831,16169,106000,September
1666,DOMS COLOUR PENCILS LONG,PIECE,2,7000,11864,2136,14000,September
1667,DOMS COLOUR PENCILS SHORT,PIECE,1,4000,3390,610,4000,September
1668,DOMS GEOMETRY SET,PIECE,7,8500,50424,9076,59500,September
1670,DOMS PENCILS A1 5000,PIECE,3,5000,12712,2288,15000,September
1687,DOUBLE A REAM,PIECE,5,30000,127119,22881,150000,September
1688,DOUBLE REFINED SALT 650G,PIECE,2,7000,11864,2136,14000,September
1695,DOVE CUCUMBER 750ML,PIECE,3,28000,71186,12814,84000,September
1700,DOVE FRESH TOUCH 100G,PIECE,1,6000,5085,915,6000,September
1702,DOVE GLOWING RITUAL SHOWER GEL,PIECE,1,21000,17797,3203,21000,September
1723,DOVE PINK ROSA SOAP 135G,PIECE,6,7500,38136,6864,45000,September
1750,DOWNY FEEL LUX 20ML,PIECE,7,700,4153,747,4900,September
1753,DOWNY VALLEY DEW 20ML,PIECE,9,700,5339,961,6300,September
1758,DREAM PANT LINERS,PIECE,2,2500,4237,763,5000,September
1759,DRINKING CHOCOLATE 225G,PIECE,1,15000,12712,2288,15000,September
1769,DURACELL AA PLUS,PIECE,6,6000,30508,5492,36000,September
1771,DURACELL AAA PLUS,PIECE,2,6000,10169,1831,12000,September
1772,DURU CARING MILK,PIECE,2,4500,7627,1373,9000,September
1774,DURU DOLCE ALMOND,PIECE,1,4500,3814,686,4500,September
1775,DURU ENERGIZING HONEY,PIECE,1,4500,3814,686,4500,September
1779,DURU FRESH SENSATION 4PCS,PIECE,1,16000,13559,2441,16000,September
1780,DURU GLYCERINE,PIECE,3,5000,12712,2288,15000,September
1783,DURU MISKET 4PCS,PIECE,1,16000,13559,2441,16000,September
1785,DURU NATURAL CARE,PIECE,3,4500,11441,2059,13500,September
1788,DURU OCEAN BREEZE SOAP,PIECE,1,14000,11864,2136,14000,September
1816,EAST AFRICAN HONEY 350G,PIECE,3,13000,33051,5949,39000,September
1818,EAST AFRICAN ORGANIC HONEY 100G,PIECE,4,3500,11864,2136,14000,September
1820,EAST AFRICAN ORGANIC HONEY 450G,PIECE,2,12000,20339,3661,24000,September
1823,ECLAIRS,PIECE,5,200,847,153,1000,September
1825,ECO STYLING GEL 236ML,PIECE,3,13000,33051,5949,39000,September
1840,EDEN BODY MILK 500ML,PIECE,1,26000,22034,3966,26000,September
1853,EGGS HALF TRAY,PIECE,2,7000,11864,2136,14000,September
1855,EGGS PIECES,PIECE,123,500,52119,9381,61500,September
1856,EGGS TRAY,PIECE,6,14000,71186,12814,84000,September
1861,ELEGANCE COCOA BUTTER,PIECE,1,6000,5085,915,6000,September
1878,ELEGANT LAVENDER AR.F,PIECE,3,7000,17797,3203,21000,September
1892,ELGON BLEND SASACOFFEE 500G,PIECE,1,26500,22458,4042,26500,September
1893,ELITE HANGERS,PIECE,1,8000,6780,1220,8000,September
1908,ENVELOPE A4,PIECE,3,500,1271,229,1500,September
1909,ENVELOPES 1000,PIECE,2,1000,1695,305,2000,September
1910,ENVELOPES 200,PIECE,67,200,11356,2044,13400,September
1911,ENVELOPES 300,PIECE,13,300,3305,595,3900,September
1912,EPIC ADVENTURE 250ML,PIECE,2,16000,27119,4881,32000,September
1914,ERASER RUBBER,PIECE,2,500,847,153,1000,September
1915,ERASER RUBBER BIG,PIECE,18,1000,15254,2746,18000,September
1923,EURO SILK 2200 ORIGINAL,PIECE,128,2200,238644,42956,281600,September
1931,EVERVESS,PIECE,21,1000,17797,3203,21000,September
1932,EVERVESS 500ML,PIECE,13,1500,16525,2975,19500,September
1935,EXOTIC 320MLS,PIECE,8,1000,6780,1220,8000,September
1936,F.D CHOCOLATE MILK 250MLS,PIECE,14,2000,23729,4271,28000,September
1937,F.D FLAVOURED CHOCOLATE,PIECE,8,4000,27119,4881,32000,September
1938,F.D FLAVOURED MILK BOX46000,BOX,2,45000,76271,13729,90000,September
1939,F.D MANGO 100G,PIECE,11,1018,9492,1708,11200,September
1941,F.D MANGO 400G,PIECE,17,2500,36017,6483,42500,September
1942,F.D MANGO 450G,PIECE,7,3700,21949,3951,25900,September
1943,F.D MIXED BERRIES 100G,PIECE,14,1200,14237,2563,16800,September
1945,F.D MIXED BERRIES 250G,PIECE,1,2500,2119,381,2500,September
1946,F.D MIXED BERRIES 400G,PIECE,29,2500,61441,11059,72500,September
1948,F.D PLAIN 250G,PIECE,2,2500,4237,763,5000,September
1949,F.D PLAIN YOGHURT 400G,PIECE,5,2500,10593,1907,12500,September
1950,F.D PLAIN YOGHURT 450G,PIECE,22,3700,68983,12417,81400,September
1952,F.D STRAWBERRY 100G,PIECE,129,1200,131186,23614,154800,September
1955,F.D STRAWBERRY 250G,PIECE,62,2500,131356,23644,155000,September
1956,F.D STRAWBERRY 400G,PIECE,128,2500,271186,48814,320000,September
1957,F.D STRAWBERRY 450G,PIECE,77,3700,241441,43459,284900,September
1958,F.D STRAWBERRY FLAVOURED 250ML,PIECE,67,2000,113559,20441,134000,September
1959,F.D STRAWBERRY MILK 500MLS,PIECE,6,4000,20339,3661,24000,September
1960,F.D UHT 200ML MILK,PIECE,32,1000,27119,4881,32000,September
1961,F.D UHT MILK 2000,PIECE,49,2000,83051,14949,98000,September
1962,F.D UNSALTED BUTTER 250G,PIECE,7,11000,65254,11746,77000,September
1963,F.D VANILLA 100G,PIECE,124,1200,126102,22698,148800,September
1966,F.D VANILLA 250G,PIECE,45,2500,95339,17161,112500,September
1967,F.D VANILLA 400G,PIECE,123,2500,260593,46907,307500,September
1968,F.D VANILLA 450G,PIECE,64,3700,200678,36122,236800,September
1969,F.D VANILLA FLAVOURED 250ML,PIECE,28,2000,47458,8542,56000,September
1970,F.D VANILLA MILK 500MLS,PIECE,8,4000,27119,4881,32000,September
1971,F.D YOGHURT MIXED BERRIES 450G,PIECE,14,3700,43898,7902,51800,September
1973,FA AQUA 50MLS,PIECE,5,6500,27542,4958,32500,September
1974,FA CARRIEAN LEMON,PIECE,5,6500,27542,4958,32500,September
1978,FA FLORAL PROTECT 50MLS,PIECE,2,6500,11017,1983,13000,September
1982,FA INVISIBLE POWER,PIECE,4,6500,22034,3966,26000,September
1983,FA MEN ATTRACTION FORCE,PIECE,3,6500,16525,2975,19500,September
1984,FA MEN INVISIBLE POWER,PIECE,2,6500,11017,1983,13000,September
1987,FA MYSTIC MOMENTS,PIECE,2,6500,11017,1983,13000,September
1992,FA SPORT RECHARGE 72H,PIECE,2,6250,10593,1907,12500,September
1999,FACE TOWEL 1000,PIECE,14,1000,11864,2136,14000,September
2000,FACE TOWEL 1500,PIECE,4,1500,5085,915,6000,September
2006,FAMEN FRESHLY FREE,PIECE,2,6500,11017,1983,13000,September
2014,FAMILY CAREPERFUMED JELLY 500G,PIECE,1,10000,8475,1525,10000,September
2023,FAMILY TEA 250G,PIECE,1,8000,6780,1220,8000,September
2026,FANAKA GUAVA 500ML,PIECE,6,3500,17797,3203,21000,September
2029,FANTA 2LTRS ORANGE,PIECE,42,5000,177966,32034,210000,September
2030,FANTA 330ML CAN,PIECE,16,3000,40678,7322,48000,September
2031,FANTA 330MLS,PIECE,103,1000,87288,15712,103000,September
2032,FANTA 500MLS,PIECE,46,1500,58475,10525,69000,September
2033,FANTA FRUIT BLAST 350ML,PIECE,13,1000,11017,1983,13000,September
2040,FAX ARGAN&MILK 225G,PIECE,3,5000,12712,2288,15000,September
2042,FAX FRUIT COCKTAIL,PIECE,1,8500,7203,1297,8500,September
2044,FAX LAVENDER,PIECE,1,8500,7203,1297,8500,September
2045,FAX LAVENDER 400MLS,PIECE,2,8000,13559,2441,16000,September
2047,FAX LEMON FRESH,PIECE,2,8500,14407,2593,17000,September
2052,FAX SUNSHINEAPPLES SOAP,PIECE,3,8500,21610,3890,25500,September
2060,FAY TP,PIECE,20,2000,33898,6102,40000,September
2061,FEATHERS PADS REGULAR,PIECE,3,3000,7627,1373,9000,September
2070,FIDODIDO CHOCOLATE 120ML,PIECE,7,1200,7119,1281,8400,September
2072,FIDODIDO CHOCO-VAN 220ML,PIECE,13,2500,27542,4958,32500,September
2085,FIDODIDO STRAW-VAN 120MLS,PIECE,6,1200,6102,1098,7200,September
2089,FIDODIDO STRWABERRY 220ML,PIECE,9,2500,19068,3432,22500,September
2099,FLASH BALLS 3000,PIECE,1,7500,6356,1144,7500,September
2112,FLOWERS 1500,PIECE,1,1500,1271,229,1500,September
2113,FLOWERS 2000,PIECE,1,2000,1695,305,2000,September
2114,FLYMEEGO VESTS 25000,PIECE,2,26000,44068,7932,52000,September
2117,FOGG ABSOLUTE BODY SPRAY,PIECE,2,18000,30508,5492,36000,September
2118,FOGG ABSOLUTE ROLLON,PIECE,1,8500,7203,1297,8500,September
2120,FOGG BOLD ROLLON 50MLS,PIECE,1,8500,7203,1297,8500,September
2122,FOGG DYNAMIC SPRAY,PIECE,1,18000,15254,2746,18000,September
2123,FOGG ELEGANCE ROLLON,PIECE,1,8500,7203,1297,8500,September
2125,FOGG EXTREME,PIECE,1,18000,15254,2746,18000,September
2128,FOGG MARCO SPRAY,PIECE,1,18000,15254,2746,18000,September
2133,FOGG MONARCH,PIECE,1,18000,15254,2746,18000,September
2137,FOGG SPLENDID ROLLON,PIECE,2,8500,14407,2593,17000,September
2140,FOGG ULTIMATE ROLLON,PIECE,1,8500,7203,1297,8500,September
2141,FOGG VICTOR BODY SPRAY,PIECE,1,18000,15254,2746,18000,September
2153,FOOD COLOUR GREEN,PIECE,1,1000,847,153,1000,September
2154,FOOD COLOUR ORANGE,PIECE,1,1000,847,153,1000,September
2155,FOOD COLOUR PINK,PIECE,1,1000,847,153,1000,September
2174,FORTUNE BUTTO 1LTR,PIECE,3,8500,21610,3890,25500,September
2175,FORTUNE BUTTO 500ML,PIECE,17,4500,64831,11669,76500,September
2176,FORTUNE GOLD 1LTR,PIECE,3,10000,25424,4576,30000,September
2180,FORTUNE SPAGHETTI 250G,PIECE,3,2500,6356,1144,7500,September
2183,FOUNTAIN PEN,PIECE,15,8000,101695,18305,120000,September
2203,FRESH DAIRY MILK UHT 500ML,PIECE,104,2000,176271,31729,208000,September
2205,FRESH DIARY LONG LIFE BOX,BOX,1,23000,19492,3508,23000,September
2209,FRESH UP TOOTHPASTE,PIECE,13,2000,22034,3966,26000,September
2233,FRUITVILLE APPLE DRINK,PIECE,12,3500,35593,6407,42000,September
2234,FRUITVILLE GUAVA 500ML,PIECE,26,3500,77119,13881,91000,September
2235,FRUITVILLE MANGO 500ML,PIECE,10,3500,29661,5339,35000,September
2280,GARDEN TEA 100G,PIECE,2,5500,9322,1678,11000,September
2281,GARDEN TEA 250,PIECE,1,14000,11864,2136,14000,September
2283,GARDEN TEA 50G,PIECE,5,2500,10593,1907,12500,September
2284,GARDEN TEA BAGS 100G,PIECE,3,7000,17797,3203,21000,September
2285,GARDENERS COFFEE,PIECE,2,8000,13559,2441,16000,September
2286,GEISHA ALOE VERA&HONEY,PIECE,12,4000,40678,7322,48000,September
2287,GEISHA ALOE&HONEY 175G,PIECE,1,2500,2119,381,2500,September
2288,GEISHA ALOEVERA &HONEY 125G,PIECE,6,2500,12712,2288,15000,September
2289,GEISHA COCONUT MILK 200G,PIECE,12,4000,40678,7322,48000,September
2290,GEISHA COCONUTMILK 125G,PIECE,5,2500,10593,1907,12500,September
2291,GEISHA LEMON&HONEY,PIECE,15,4000,50847,9153,60000,September
2292,GEISHA LEMON&HONEY 125G,PIECE,17,2500,36017,6483,42500,September
2294,GEISHA MORINGA OIL 125G,PIECE,1,4000,3390,610,4000,September
2295,GEISHA MORINGA OIL 225G,PIECE,5,5500,23305,4195,27500,September
2296,GEISHA ROSE&HONEY,PIECE,11,2500,23305,4195,27500,September
2298,GEISHA ROSE&HONEY 225G,PIECE,8,4000,27119,4881,32000,September
2299,GEISHA SHEA AND ALMOND BUTTER SOAP 225G,PIECE,3,5500,13983,2517,16500,September
2302,GEISHA TRADITIONAL BLACK SOAP,PIECE,14,5500,65254,11746,77000,September
2303,GEISHA TRADITIONAL BLACK SOAP 125G,PIECE,8,4000,27119,4881,32000,September
2310,GIFT BAG 1500,PIECE,5,1500,6356,1144,7500,September
2311,GIFT BAG 2500,PIECE,1,2500,2119,381,2500,September
2315,GIFT BAG 4500,PIECE,14,4500,53390,9610,63000,September
2316,GIFT BAG BIG 4500,PIECE,1,4500,3814,686,4500,September
2317,GIFT BAG FLORAL LARGE,PIECE,6,6000,30508,5492,36000,September
2319,GIFT BAG FLORAL SMALL,PIECE,9,2000,15254,2746,18000,September
2321,GIFT BAGS 2000,PIECE,2,2000,3390,610,4000,September
2336,GILLETTE 2 1500,PIECE,6,1500,7627,1373,9000,September
2342,GILLETTE BLUE2 PLUS,PIECE,13,2500,27542,4958,32500,September
2371,GLOVES 6000,PIECE,1,6000,5085,915,6000,September
2389,GOLDEN ALUMINIUM FOIL,PIECE,1,34000,28814,5186,34000,September
2416,GOOD DOCTOR KIDS TOOTH,PIECE,1,1000,847,153,1000,September
2427,GORILLO'S BBQ BEEF 24G,PIECE,114,500,48305,8695,57000,September
2429,GORILLO'S CHICKEN 24G,PIECE,214,500,90678,16322,107000,September
2431,GORILLO'S CHILLI TOMATO 24G,PIECE,123,500,52119,9381,61500,September
2450,GRAPES 12000,PIECE,18,14000,213559,38441,252000,September
2455,GREEN RIVER POWDER 5G,PIECE,11,1000,9322,1678,11000,September
2473,GUN TOYS 4000,PIECE,1,5000,4237,763,5000,September
2476,HABARI SALT BIG,PIECE,19,1000,16102,2898,19000,September
2477,HABARI SALT SMALL,PIECE,2,700,1186,214,1400,September
2478,HACKER MOSQUITO LOTION,PIECE,1,9000,7627,1373,9000,September
2479,HACO RULER,PIECE,3,2000,5085,915,6000,September
2480,HACO RULER ORIGINAL,PIECE,15,2000,25424,4576,30000,September
2491,HANGER NO 0655,PIECE,1,15000,12712,2288,15000,September
2492,HANGER NO:8834,PIECE,1,15000,12712,2288,15000,September
2493,HANGERS METALLIC 18000,PIECE,2,15000,25424,4576,30000,September
2496,HANKIES 1500,PIECE,10,1500,12712,2288,15000,September
2497,HANKIES 2000,PIECE,4,2000,6780,1220,8000,September
2498,HANKIES 3000,PIECE,42,3000,106780,19220,126000,September
2501,HANYAN EAR BUDS,PIECE,1,2000,1695,305,2000,September
2513,HARMONY POT WATER,PIECE,79,1000,66949,12051,79000,September
2514,HARMONY POT WATER 1LTR,PIECE,74,2000,125424,22576,148000,September
2517,HARPIC MOUNTAIN PINE,PIECE,5,15000,63559,11441,75000,September
2518,HARPIC ORIGINAL PLUS,PIECE,6,15000,76271,13729,90000,September
2519,HARPIC PEACH&JASMINE,PIECE,4,15000,50847,9153,60000,September
2530,HEINZ KETCHUP 300G,PIECE,3,8000,20339,3661,24000,September
2547,HIGH LIGHTER,PIECE,1,1500,1271,229,1500,September
2559,HIT INSECT KILLER GREENTEA 275ML,PIECE,1,12000,10169,1831,12000,September
2560,HIT INSECT KILLER LEMON 275ML,PIECE,2,12000,20339,3661,24000,September
2584,HOOKS 10000,PIECE,3,10000,25424,4576,30000,September
2586,HOOKS 8000,PIECE,1,10000,8475,1525,10000,September
2596,HOT FRESH HOT PEPPER 60ML,PIECE,1,6000,5085,915,6000,September
2613,HUGGIES GOLD PANTS JUMBO 4,PIECE,1,86000,72881,13119,86000,September
2618,HUGGIES PANTS H.C S5,PIECE,1,58000,49153,8847,58000,September
2621,HUGGIES S.2 H.C,PIECE,3,26000,66102,11898,78000,September
2636,IBON ELVAN SWEETS,PIECE,86,200,14576,2624,17200,September
2637,ICE CUPS 8000,PIECE,1,8000,6780,1220,8000,September
2651,IMPERIAL LEATHER 4*175,PIECE,6,13000,66102,11898,78000,September
2654,IMPERIAL LEATHER BODY LOTION 200ML,PIECE,1,8500,7203,1297,8500,September
2663,IMPERIAL LEATHER SOAP RED 175G,PIECE,7,4000,23729,4271,28000,September
2666,IMPERIAL LEATHER SPORT 175G,PIECE,7,4500,26695,4805,31500,September
2676,INDOCAFE CAPPUCCINO CREAMY,PIECE,3,3000,7627,1373,9000,September
2681,INDOMIE BEEF 70G,PIECE,67,1200,68136,12264,80400,September
2682,INDOMIE BEEF NOODLES 120G,PIECE,16,2000,27119,4881,32000,September
2683,INDOMIE NOODLES 70G,PIECE,90,1200,91525,16475,108000,September
2684,INDOMIE NOODLES CHICKEN 120G,PIECE,14,2000,23729,4271,28000,September
2706,JAGO 100MLS,PIECE,1,4000,3390,610,4000,September
2708,JAGO AFTERSHAVE 1LTR,PIECE,1,17000,14407,2593,17000,September
2710,JAGO AFTERSHAVE 300MLS,PIECE,2,7500,12712,2288,15000,September
2714,JAGO SCRUB 250G,PIECE,2,8000,13559,2441,16000,September
2716,JAMAA WHITE WASHING BAR,PIECE,16,6156,83475,15025,98500,September
2718,JAMIES BROWN BUNS 6PCS,PIECE,150,3500,444915,80085,525000,September
2719,JAMIES BROWN SALT BREAD 1KG,PIECE,1,5500,4661,839,5500,September
2720,JAMIES BROWN SALT BREAD 500G,PIECE,29,3000,73729,13271,87000,September
2721,JAMIES CAKE @70k,PIECE,10,70000,593220,106780,700000,September
2724,JAMIES CAKES @ 40K,PIECE,1,40000,33898,6102,40000,September
2725,JAMIES CAKES @50k,PIECE,7,50000,296610,53390,350000,September
2726,JAMIES CAKES @60K,PIECE,14,60714,720339,129661,850000,September
2727,JAMIES COCONUT BREAD 1KG,PIECE,24,5500,111864,20136,132000,September
2728,JAMIES COCONUT BREAD 500G,PIECE,12,3000,30508,5492,36000,September
2729,JAMIE'S COOKIE SCONES,PIECE,77,2000,130508,23492,154000,September
2730,JAMIES CROCKDILE BREAD 1KG,PIECE,2,6000,10169,1831,12000,September
2734,JAMIES DOUGH NUTS HUGE,PIECE,167,2003,283475,51025,334500,September
2735,JAMIES DOUGH NUTS SMALL 4000,PIECE,521,3179,1403814,252686,1656500,September
2736,JAMIES COOKIES 4000,PIECE,59,4000,200000,36000,236000,September
2739,JAMIES HOT DOG BUNS 6PCS,PIECE,65,4000,220339,39661,260000,September
2740,JAMIES MANDAZ 8PCS,PIECE,98,3122,259322,46678,306000,September
2744,JAMIES MUFFINS,PIECE,395,1500,502119,90381,592500,September
2748,JAMIES QUEEN CAKES 6PCS 3000,PIECE,147,3500,436017,78483,514500,September
2751,JAMIES SWEET BROWN BREAD1KG,PIECE,273,5500,1272458,229042,1501500,September
2752,JAMIES SWEET BROWN BREAD 500G,PIECE,112,3000,284746,51254,336000,September
2754,JAMIES SWEET CAKE BREAD 1KG,PIECE,122,6000,620339,111661,732000,September
2755,JAMIES SWEET CAKE BREAD 500G,PIECE,37,3000,94068,16932,111000,September
2756,JAMIES SWEET WHITE BREAD 1KG,PIECE,532,5500,2479661,446339,2926000,September
2757,JAMIES SWEET WHITE BREAD 500,PIECE,168,3000,427119,76881,504000,September
2758,JAMIES SWEET WHITE BUNS 12PCS,PIECE,137,3500,406356,73144,479500,September
2759,JAMIES SWEET WHITE BUNS 6PCS,PIECE,194,3500,575424,103576,679000,September
2760,JAMIES SWEET YELLOW BREAD 1KG,PIECE,413,5500,1925000,346500,2271500,September
2761,JAMIES SWEET YELLOW BREAD 500G,PIECE,134,3000,340678,61322,402000,September
2763,JAMIES SWEET YELLOW BUNS 6PCS,PIECE,120,3500,355932,64068,420000,September
2765,JAMIES TWISTED BREAD 1KG,PIECE,2,6000,10169,1831,12000,September
2769,JEE NAIL REMOVER,PIECE,4,2000,6780,1220,8000,September
2780,JESA CHOCOLATE FLAVOURED MILK 200ML,PIECE,34,1500,43220,7780,51000,September
2781,JESA FINO BOX,BOX,5,24600,104237,18763,123000,September
2782,JESA FLAVOURED CHOCO 500ML,PIECE,15,4000,50847,9153,60000,September
2783,JESA FLAVOURED MILK BOX,BOX,4,35000,118644,21356,140000,September
2784,JESA FLAVOURED STRAW 500ML,PIECE,11,4000,37288,6712,44000,September
2785,JESA FLAVOURED VANILLA 500ML,PIECE,25,4000,84746,15254,100000,September
2786,JESA FRUIT PEACH&PASSION 175,PIECE,9,2500,19068,3432,22500,September
2789,JESA FRUIT STRAWBERRY 500G,PIECE,2,6000,10169,1831,12000,September
2792,JESA MILK 1LTR,PIECE,169,3600,515593,92807,608400,September
2793,JESA MILK 500ML,PIECE,1164,1800,1775593,319607,2095200,September
2794,JESA MILK UHT 500ML,PIECE,57,2200,106271,19129,125400,September
2796,JESA PLAIN YOGHURT 500G,PIECE,9,3700,28220,5080,33300,September
2797,JESA STRAW 250G YOGHURT,PIECE,14,2500,29661,5339,35000,September
2799,JESA STRAW YOGHURT 400G,PIECE,45,2500,95339,17161,112500,September
2800,JESA STRAWBERRY FRUIT 175G,PIECE,1,2500,2119,381,2500,September
2801,JESA STRAWBERRY MILK 200MLS,PIECE,51,1500,64831,11669,76500,September
2802,JESA STRAWBERRY YOGHURT 500G,PIECE,17,3700,53305,9595,62900,September
2803,JESA TOFFEE 250G,PIECE,10,2500,21186,3814,25000,September
2804,JESA TOFFEE YOGHURT 500G,PIECE,20,3700,62712,11288,74000,September
2805,JESA UHT FINO,PIECE,60,2200,111864,20136,132000,September
2809,JESA VANILLA FLAVOURED 200ML,PIECE,32,1500,40678,7322,48000,September
2811,JESA VANILLA YOGHURT 250G,PIECE,12,2500,25424,4576,30000,September
2812,JESA VANILLA YOGHURT 400G,PIECE,45,2500,95339,17161,112500,September
2813,JESA VANILLA YOGHURT 500G,PIECE,19,3700,59576,10724,70300,September
2825,JIB WATER 20LTRS REFILL,PIECE,10,8400,71186,12814,84000,September
2829,JIK COLOURS 1LTRS,PIECE,1,17000,14407,2593,17000,September
2830,JIK COLOURS 250MLS,PIECE,1,7000,5932,1068,7000,September
2831,JIK REGULAR 250MLS,PIECE,7,6500,38559,6941,45500,September
2833,JIK REGULAR 750MLS,PIECE,8,14000,94915,17085,112000,September
2857,JOHNSON BABY JELLY FRANGRANCE FREE 100ML,PIECE,1,10000,8475,1525,10000,September
2858,JOHNSON BABY LOTION SOAP 100G,PIECE,5,6000,25424,4576,30000,September
2859,JOHNSON BABY OIL 125MLS,PIECE,2,20000,33898,6102,40000,September
2868,JOHNSON OIL 200MLS,PIECE,1,25000,21186,3814,25000,September
2874,JOHNSON SOAP 100G BLUE,PIECE,4,6000,20339,3661,24000,September
2882,JOHNSON'S BABY JELLY LIGHTLY FRANGRANCED,PIECE,3,10000,25424,4576,30000,September
2885,JOHNSON'SBABY JELLY PINK 250ML,PIECE,3,16000,40678,7322,48000,September
2916,JUMBO BLUE SWIRL 175ML,PIECE,12,4000,40678,7322,48000,September
2917,JUMBO CHOCOLATE RIPPLE 175MLS,PIECE,8,3500,23729,4271,28000,September
2921,JUMBO STRAWBERRY RIPPLE 175ML,PIECE,9,4000,30508,5492,36000,September
2924,JUNSHENG COTTON SWABS,PIECE,1,2000,1695,305,2000,September
2933,KABODY COCONUT MILK 1KG,PIECE,1,6500,5508,992,6500,September
2934,KABODY COMPOSITE FLOUR,PIECE,2,6250,10593,1907,12500,September
2935,KABODY ENKEJJE SOYA RICE 1KG,PIECE,5,6500,27542,4958,32500,September
2936,KABODY MILLET SOYA PORRIDGE,PIECE,3,6500,16525,2975,19500,September
2937,KABODY MUKENE SOYA RICE1KG,PIECE,4,6250,21186,3814,25000,September
2939,KABODY OATS SOYA RICE 1KG,PIECE,7,6500,38559,6941,45500,September
2940,KABODY PUMPKIN PORRIDGE 1KG,PIECE,3,6167,15678,2822,18500,September
2941,KABODY PUMPKIN SEED 1KG,PIECE,3,6500,16525,2975,19500,September
2942,KABODY PURE MILLET 1KG,PIECE,2,6250,10593,1907,12500,September
2945,KABODY SOYA PORRIDGE,PIECE,2,6000,10169,1831,12000,September
2946,KABODY SOYA RICE 1KG,PIECE,2,6500,11017,1983,13000,September
2947,KABODY WHITE OATS WITH RICE,PIECE,1,6500,5508,992,6500,September
2948,KADIO CALCULATOR,PIECE,1,15000,12712,2288,15000,September
2950,KAKIRA SUGAR 1KG,PIECE,47,5819,231780,41720,273500,September
2952,KAKIRA SUGAR 2KG,PIECE,18,10000,152542,27458,180000,September
2954,KAKIRA SUGAR 5KG,PIECE,2,25000,42373,7627,50000,September
2962,KANGARO STAPLES,PIECE,3,2000,5085,915,6000,September
2966,KANGAROO BLACK SHOE CREAM,PIECE,12,2000,20339,3661,24000,September
2971,KASAF BI-CARBONATE 85G,PIECE,1,1000,847,153,1000,September
2976,KATAASA 3000,PIECE,2,3000,5085,915,6000,September
2985,KAZIRE ALOEVERA,PIECE,20,1500,25424,4576,30000,September
2986,KAZIRE LEMON TEA,PIECE,13,2000,22034,3966,26000,September
2987,KAZIRE ORANGE,PIECE,20,2000,33898,6102,40000,September
2988,KAZIRE POWER TONIC,PIECE,11,2000,18644,3356,22000,September
2989,KAZIRE RED TONIC 350MLS,PIECE,4,2000,6780,1220,8000,September
2990,KAZIRE VIT FRUIT,PIECE,8,2000,13559,2441,16000,September
2992,KELLOGS CORNFLAKES 500g,PIECE,2,27000,45763,8237,54000,September
3032,KENWOOD KETTLE KT-20C3,PIECE,1,80000,67797,12203,80000,September
3047,KEY HOLDER 1500,PIECE,1,1500,1271,229,1500,September
3049,KEY HOLDERS 2000,PIECE,5,2000,8475,1525,10000,September
3051,KEY HOLDERS 3500,PIECE,16,3500,47458,8542,56000,September
3052,KIBIMBA RICE 2KG,PIECE,1,15500,13136,2364,15500,September
3054,KIBIMBA RICE IKG,PIECE,3,8000,20339,3661,24000,September
3060,KICK SNACKS CHICKEN,PIECE,143,500,60593,10907,71500,September
3070,KIDS BOXERS 3000,PIECE,5,3000,12712,2288,15000,September
3078,KIDS PATRAS 3000,PIECE,3,3000,7627,1373,9000,September
3091,KIDS WATCH 10000,PIECE,3,10000,25424,4576,30000,September
3100,KIMBO 500G,PIECE,2,7500,12712,2288,15000,September
3105,KINKIZI TEA 250G,PIECE,1,9000,7627,1373,9000,September
3119,KISUBI 85GM,PIECE,5,1500,6356,1144,7500,September
3128,KITCHEN TOWELS,PIECE,1,4000,3390,610,4000,September
3130,KITUZI,PIECE,20,1000,16949,3051,20000,September
3131,KIWI 20G,PIECE,2,3500,5932,1068,7000,September
3132,KIWI BLACK 160G,PIECE,1,17000,14407,2593,17000,September
3133,KIWI BLACK 80G,PIECE,2,9500,16102,2898,19000,September
3134,KIWI CREME BLACK 100MLS,PIECE,1,4500,3814,686,4500,September
3135,KIWI CREME BLACK 150ML,PIECE,2,6000,10169,1831,12000,September
3140,KIWI POLISH 12G,PIECE,2,2500,4237,763,5000,September
3143,KIWI SHOE POLISH 32G,PIECE,3,5000,12712,2288,15000,September
3144,KIWI SUEDE CLEANER BLACK,PIECE,2,7500,12712,2288,15000,September
3145,KIWI SUEDE CLEANER NEUTRAL,PIECE,1,7500,6356,1144,7500,September
3147,KLEENIT COMBO 1PC,PIECE,2,2500,4237,763,5000,September
3151,KNICKERS 3000,PIECE,13,3000,33051,5949,39000,September
3152,KNICKERS 3500,PIECE,15,3500,44492,8008,52500,September
3153,KNICKERS 4000,PIECE,25,4000,84746,15254,100000,September
3156,KNICKERS 7000,PIECE,5,7000,29661,5339,35000,September
3158,KNICKERS 9000,PIECE,9,9000,68644,12356,81000,September
3159,KNIFE 3000,PIECE,1,3000,2542,458,3000,September
3171,KOFA MATHEMATICAL SET,PIECE,5,4000,16949,3051,20000,September
3214,KOPIKO BROWN COFFEE,PIECE,16,1500,20339,3661,24000,September
3217,KREST 500MLS,PIECE,22,1500,27966,5034,33000,September
3219,KRISHNA MATCH BOX 1000,PIECE,1,1000,847,153,1000,September
3221,KRYSTAL WATER 500ML,PIECE,44,1000,37288,6712,44000,September
3233,KYOGERO BETTER BODY OIL 1OOML,PIECE,1,7500,6356,1144,7500,September
3234,KYOGERO HERBAL JELLY 100ML,PIECE,3,3500,8898,1602,10500,September
3236,KYOGERO HERBAL JELLY 250G,PIECE,1,7500,6356,1144,7500,September
3237,KYOGERO HERBAL JELLY 50G,PIECE,3,2000,5085,915,6000,September
3239,KYOGERO HERBAL SOAP 120G,PIECE,12,3500,35593,6407,42000,September
3246,LA BELLE JELLY 250G,PIECE,1,6500,5508,992,6500,September
3248,LA BELLE SHAMPOO 1LTR,PIECE,1,7500,6356,1144,7500,September
3259,LABELLE BODY LOTION SHEA BUTTER,PIECE,1,11000,9322,1678,11000,September
3275,LANZO ANTI-BACTERIAL SOAP,PIECE,4,3500,11864,2136,14000,September
3284,LATO CHOCO PWDER MILK 15G,PIECE,20,500,8475,1525,10000,September
3285,LATO CHOCOLATE MILK 250MLS,PIECE,19,2000,32203,5797,38000,September
3289,LATO FLAVOURED 250ML 46000,PIECE,1,46000,38983,7017,46000,September
3290,LATO FLAVOURED BOX 23000,BOX,2,23000,38983,7017,46000,September
3293,LATO MILK 250G,PIECE,3,15000,38136,6864,45000,September
3294,LATO MILK 400G,PIECE,7,21000,124576,22424,147000,September
3295,LATO MILK 900G,PIECE,6,51000,259322,46678,306000,September
3296,LATO MILK CHOCOLATE 125ML FLAVOURED,PIECE,74,1000,62712,11288,74000,September
3298,LATO MILK POWDER 15G,PIECE,148,500,62712,11288,74000,September
3299,LATO MILK PWDER STRAWBERRY 15G,PIECE,39,500,16525,2975,19500,September
3300,LATO MILK UHT 200ML,PIECE,6,1000,5085,915,6000,September
3302,LATO MIXED BERRIES 250G,PIECE,8,3000,20339,3661,24000,September
3304,LATO PEACH&CARAMEL 250G,PIECE,17,3000,43220,7780,51000,September
3305,LATO PEACH&CARAMEL FRUIT 450G,PIECE,3,5500,13983,2517,16500,September
3306,LATO PLAIN YOGHURT 500G,PIECE,18,3700,56441,10159,66600,September
3309,LATO STRAWBERRY MILK 125MLS,PIECE,49,1000,41525,7475,49000,September
3310,LATO STRAWBERRY MILK 250MLS,PIECE,31,2000,52542,9458,62000,September
3311,LATO STRAWBERRY YOGHURT 500G,PIECE,25,3700,78390,14110,92500,September
3315,LATO VANILLA 100G,PIECE,9,1200,9153,1647,10800,September
3316,LATO VANILLA 125ML MILK,PIECE,96,1000,81356,14644,96000,September
3317,LATO VANILLA MILK 250MLS,PIECE,10,2000,16949,3051,20000,September
3318,LATO VANILLA YOGHURT 250ML,PIECE,10,2500,21186,3814,25000,September
3319,LATO VANILLA YOGHURT 500G,PIECE,15,3700,47034,8466,55500,September
3321,LATO YOG MIXED BERRIES 450G,PIECE,21,5500,97881,17619,115500,September
3322,LATO YOG STRAWBERRY 100G,PIECE,39,1200,39661,7139,46800,September
3323,LATO YOG STRAWBERRY 250G,PIECE,19,2500,40254,7246,47500,September
3324,LATO YOGHURT 400G VANILLA,PIECE,24,2500,50847,9153,60000,September
3325,LATO YOGHURT SRAWBERRY 200G,PIECE,67,1084,61525,11075,72600,September
3326,LATO YOGHURT STRAWBERRY 400G,PIECE,21,2500,44492,8008,52500,September
3327,LATO YOGHURT VANILLA 200G,PIECE,82,1051,73051,13149,86200,September
3335,LAVITA PINEAPPLE 320MLS,PIECE,18,1000,15254,2746,18000,September
3351,LE FEMME SPRAY,PIECE,1,13000,11017,1983,13000,September
3361,LEMON CAKES 1000,PIECE,38,1200,38644,6956,45600,September
3378,LIGHTERS,PIECE,19,1000,16102,2898,19000,September
3400,LMZ HERBAL 55G,PIECE,3,3000,7627,1373,9000,September
3401,LMZ HREBAL 120G,PIECE,1,5000,4237,763,5000,September
3419,LOVE CHOCOLATE,PIECE,1,3500,2966,534,3500,September
3433,LUCOZADE 1LTR,PIECE,24,10000,203390,36610,240000,September
3434,LUCOZADE 250ML,PIECE,1,3000,2542,458,3000,September
3435,LUCOZADE 250MLS,PIECE,9,3000,22881,4119,27000,September
3456,LUX VESTS,PIECE,1,16000,13559,2441,16000,September
3457,LUXURY CAR TISSUE,PIECE,6,4500,22881,4119,27000,September
3458,LUXURY TOILET PAPER,PIECE,28,668,15847,2853,18700,September
3469,M&G GLUE STICK 15G,PIECE,6,2000,10169,1831,12000,September
3472,M&G HELLO BEARS PEN ERASE,PIECE,14,2500,29661,5339,35000,September
3475,M&G INK CATRIDGE,PIECE,3,4000,10169,1831,12000,September
3479,M&G NOTE BOOK 11000,PIECE,1,12000,10169,1831,12000,September
3484,M&G PAPER CLIPS 1500,PIECE,2,1500,2542,458,3000,September
3485,M&G PENCILS HB12PCS,PIECE,1,6000,5085,915,6000,September
3498,M&G WATER COLOR PAINT,PIECE,1,11000,9322,1678,11000,September
3499,M&G WHITE BOARD MARKER,PIECE,2,1500,2542,458,3000,September
3500,M&G WHITE BOARD MARKERS,PIECE,5,1500,6356,1144,7500,September
3524,MACDO TOMATO SAUCE 5LTR,PIECE,1,10000,8475,1525,10000,September
3525,MACDO TOMATO SAUCE SACHETS,PIECE,2,13000,22034,3966,26000,September
3526,MACRO DENTAL FLOSS,PIECE,22,3000,55932,10068,66000,September
3528,MADAM RANEE PAPAYA SOAP,PIECE,4,8000,27119,4881,32000,September
3533,MAGANJO BABY SOYA 1KG,PIECE,5,6500,27542,4958,32500,September
3535,MAGANJO BABY SOYA WITH MILK 500G,PIECE,4,8500,28814,5186,34000,September
3548,MAGANJO PURE MILLET 1KG,PIECE,4,6500,22034,3966,26000,September
3552,MAGANJO SOYA MILLET,PIECE,3,6500,16525,2975,19500,September
3553,MAGANJO SOYA RICE 1KGS,PIECE,5,7500,31780,5720,37500,September
3557,MAGANJO SUPER RICE 1KG,PIECE,1,6000,5085,915,6000,September
3560,MAGIC 1KG SACHET,PIECE,10,8500,72034,12966,85000,September
3561,MAGIC 1KG BUCKET,PIECE,2,12500,21186,3814,25000,September
3562,MAGIC 250G BUCKET,PIECE,11,4045,37712,6788,44500,September
3563,MAGIC 500G BUCKET,PIECE,2,6500,11017,1983,13000,September
3564,MAGIC 500G SACHET,PIECE,16,4500,61017,10983,72000,September
3566,MAGIC SACHET 45G,PIECE,10,500,4237,763,5000,September
3575,MAKE UP FACIAL WIPES,PIECE,12,3500,35593,6407,42000,September
3584,MAMIS PEANUT PASTE 1KG,PIECE,3,15000,38136,6864,45000,September
3585,MAMIS PEANUT PASTE 500G,PIECE,12,8000,81356,14644,96000,September
3586,MANAGEMENT FILE 2000,PIECE,1,2000,1695,305,2000,September
3588,MANILA PAPERS 1000,PIECE,13,1000,11017,1983,13000,September
3596,MANUSCRIPT,PIECE,2,20000,33898,6102,40000,September
3597,MANUSCRIPT 3Q BOOK,PIECE,3,17000,43220,7780,51000,September
3598,MANUSCRIPT BOOK 2Q,PIECE,4,12000,40678,7322,48000,September
3602,MARHABA AMLA OIL 160ML,PIECE,1,12000,10169,1831,12000,September
3606,MARIKA CORN FLOUR 400G,PIECE,4,5000,16949,3051,20000,September
3607,MARIKA ICING SUGAR 500G,PIECE,7,4000,23729,4271,28000,September
3609,MARS CHOCOLATE,PIECE,11,3500,32627,5873,38500,September
3619,MASTER MATHEMATIC SET,PIECE,2,4500,7627,1373,9000,September
3620,MATHEMATICAL SET,PIECE,6,4000,20339,3661,24000,September
3624,MAXIMO CHOCO,PIECE,4,3500,11864,2136,14000,September
3626,MAYONNAISE BIG 887ML,PIECE,2,32000,54237,9763,64000,September
3628,MAYONNAISE MEDIUM 473ML,PIECE,1,25000,21186,3814,25000,September
3633,MEGA PASTA 400G,PIECE,10,4000,33898,6102,40000,September
3634,MELAMINE PLATES 5000,PIECE,2,5000,8475,1525,10000,September
3635,MELEX BAGIYA 1000,PIECE,7,1000,5932,1068,7000,September
3636,MELEX BAGIYA 2000,PIECE,3,2000,5085,915,6000,September
3644,MELEX G.NUTS 1000,PIECE,31,1000,26271,4729,31000,September
3645,MELEX G.NUTS 2000,PIECE,11,2000,18644,3356,22000,September
3646,MELEX G-NUTS 250GM 6500,PIECE,3,5000,12712,2288,15000,September
3647,MELEX HARDCONES 425G,PIECE,2,5000,8475,1525,10000,September
3648,MELEX HARDCORNS 1000,PIECE,10,1100,9322,1678,11000,September
3649,MELEX HARDCORNS 2000,PIECE,7,2000,11864,2136,14000,September
3653,MELEX SIMSIM 170G 2000,PIECE,3,2000,5085,915,6000,September
3654,MELEX SIMSIM 85G 1000,PIECE,8,1000,6780,1220,8000,September
3655,MELEX SIMSIM BALLS 1000,PIECE,16,1000,13559,2441,16000,September
3656,MELEX SIMSIM BALLS 2000,PIECE,7,2000,11864,2136,14000,September
3659,MELEX SOYA 1000,PIECE,4,1000,3390,610,4000,September
3660,MELEX SOYA 2000,PIECE,4,2000,6780,1220,8000,September
3663,MEN BOXERS 10000,PIECE,10,10000,84746,15254,100000,September
3669,MEN SOCKS 3500,PIECE,6,3750,19068,3432,22500,September
3672,MENTHOXYL,PIECE,13,500,5508,992,6500,September
3674,MENTOS GRAPE,PIECE,15,2500,31780,5720,37500,September
3682,MESSAGE CARDS 500,PIECE,1,500,424,76,500,September
3684,MIA GONJA 1000,PIECE,6,1000,5085,915,6000,September
3690,MIKOSHI GREEN TEA,PIECE,11,6000,55932,10068,66000,September
3696,MILKMAN CHOCOLATE 500,PIECE,1,500,424,76,500,September
3709,MILO 100G,PIECE,1,11000,9322,1678,11000,September
3721,MINUTE MAID 1LTRS,PIECE,62,5000,262712,47288,310000,September
3723,MINUTE MAID BERRY BLAST 400MLS,PIECE,31,2500,65678,11822,77500,September
3725,Minute maid mango,PIECE,99,2500,209746,37754,247500,September
3728,MINUTE MAID ORANGE 280ML,PIECE,1,1000,847,153,1000,September
3729,MINUTEMAID BERRY BLAST 1LTR,PIECE,56,5000,237288,42712,280000,September
3736,MIRINDA APPLE,PIECE,35,1500,44492,8008,52500,September
3737,MIRINDA APPLE 2LTR,PIECE,46,4500,175424,31576,207000,September
3738,MIRINDA APPLE 330ML,PIECE,105,1000,88983,16017,105000,September
3739,MIRINDA FRUITY,PIECE,20,1500,25424,4576,30000,September
3740,MIRINDA FRUITY 2LTR,PIECE,39,4500,148729,26771,175500,September
3741,MIRINDA FRUITY 330MLS,PIECE,94,1000,79661,14339,94000,September
3742,MIRINDA ORANGE 2LTRS,PIECE,24,4500,91525,16475,108000,September
3743,MIRINDA ORANGE 330ML,PIECE,70,1000,59322,10678,70000,September
3744,MIRINDA ORANGE 500ML,PIECE,15,1500,19068,3432,22500,September
3747,MIRINDA PINEAPPLE 330ML,PIECE,56,1000,47458,8542,56000,September
3748,MIRROR 1500,PIECE,3,1500,3814,686,4500,September
3760,MOCACINE SOCKS 2000,PIECE,5,2000,8475,1525,10000,September
3761,MOCACINE SOCKS 2500,PIECE,3,2500,6356,1144,7500,September
3786,MONACO MIST,PIECE,1,16000,13559,2441,16000,September
3809,MOPPER 7000,PIECE,1,7000,5932,1068,7000,September
3813,MOPPERS 15000,PIECE,1,15000,12712,2288,15000,September
3837,MORTEIN DOOM LEMON 400ML,PIECE,1,28000,23729,4271,28000,September
3840,MORTEIN LEMON 180ML,PIECE,1,15000,12712,2288,15000,September
3841,MORTEIN LEMON 300ML,PIECE,1,22000,18644,3356,22000,September
3843,MORTEIN ODOURLESS 180MLS,PIECE,1,15000,12712,2288,15000,September
3844,MORTEIN ODOURLESS 300MLS,PIECE,1,22000,18644,3356,22000,September
3848,MOSQUITO NETS 15000,PIECE,1,15000,12712,2288,15000,September
3855,MOTH BALLS 4000,PIECE,2,7000,11864,2136,14000,September
3860,MOULDIN GEL WAX 125ML,PIECE,1,12000,10169,1831,12000,September
3862,MOUNTAIN DEW,PIECE,33,1500,41949,7551,49500,September
3863,MOUNTAIN DEW 2LTR,PIECE,34,4500,129661,23339,153000,September
3864,MOUNTAIN DEW 300MLS,PIECE,68,1000,57627,10373,68000,September
3867,MOUSE &RAT TRAPS GREEN,PIECE,9,3000,22881,4119,27000,September
3869,MOVIT BABY JELLY 110G,PIECE,3,3000,7627,1373,9000,September
3871,MOVIT BABY JELLY 425g,PIECE,1,11000,9322,1678,11000,September
3878,MOVIT BODY MILK 240ML LOTION,PIECE,1,3500,2966,534,3500,September
3879,MOVIT BODY MILK CREME 250G,PIECE,1,4500,3814,686,4500,September
3887,MOVIT FAMILY SOAP 230G,PIECE,2,4000,6780,1220,8000,September
3888,MOVIT FAMILY SOAP ALOE 120G,PIECE,2,2500,4237,763,5000,September
3889,MOVIT FAMILY SOAP ALOE 230G,PIECE,4,4000,13559,2441,16000,September
3891,MOVIT FAMILY SOAP COCOMUT 125G,PIECE,5,2500,10593,1907,12500,September
3892,MOVIT FAMILY SOAP COCONUT 230G,PIECE,4,4000,13559,2441,16000,September
3893,MOVIT FAMILY SOAP LEMON V.P,PIECE,1,7000,5932,1068,7000,September
3894,MOVIT FAMILY SOAP ROSE 125G,PIECE,1,2500,2119,381,2500,September
3895,MOVIT FAMILY SOAP ROSE 230G,PIECE,2,4000,6780,1220,8000,September
3897,MOVIT FAMILY SOAP V.P ROSE,PIECE,2,7000,11864,2136,14000,September
3899,MOVIT HAIR CONDITIONER 1LTR,PIECE,1,4000,3390,610,4000,September
3902,MOVIT HAIR FOOD 120G,PIECE,1,4000,3390,610,4000,September
3906,MOVIT HERBAL JELLY 120G,PIECE,4,3625,12288,2212,14500,September
3907,MOVIT HERBAL JELLY 200G,PIECE,1,6000,5085,915,6000,September
3910,MOVIT HERBAL JELLY 550G,PIECE,1,12000,10169,1831,12000,September
3911,MOVIT HERBAL SOAP 120G,PIECE,1,3000,2542,458,3000,September
3912,MOVIT JELLY 110G,PIECE,1,3000,2542,458,3000,September
3913,MOVIT JELLY 200G,PIECE,2,5500,9322,1678,11000,September
3914,MOVIT JELLY 425G,PIECE,1,11000,9322,1678,11000,September
3944,MUKISA CAKE 2500,PIECE,15,2500,31780,5720,37500,September
3954,MUKWANO OIL 1LTR JERRYCAN,PIECE,5,10000,42373,7627,50000,September
3956,MUKWANO OIL 500ML JERRYCAN,PIECE,6,5500,27966,5034,33000,September
3958,MUKWANO TEA BAGS 100G,PIECE,3,5500,13983,2517,16500,September
3967,MUSAWO BODY JELLY,PIECE,1,2500,2119,381,2500,September
3972,MUSAWO SOAP 120G,PIECE,5,2000,8475,1525,10000,September
3973,MUSAWO SOAP 240G,PIECE,3,3500,8898,1602,10500,September
3994,NACET 500 PCS,PIECE,4,500,1695,305,2000,September
3995,NACET BLADES 2500 PKT,PIECE,10,2500,21186,3814,25000,September
3997,NAIL CUTTER 2500,PIECE,3,2500,6356,1144,7500,September
3998,NAIL CUTTERS 1500,PIECE,10,1500,12712,2288,15000,September
4001,NANA HERBAL MOUTH 60MLS,PIECE,6,7500,38136,6864,45000,September
4019,NASA HAIR REMOVAL LEMON 50ML,PIECE,1,7000,5932,1068,7000,September
4020,NATARAJ COLOR PENCIL SHORT,PIECE,4,3500,11864,2136,14000,September
4021,NATARAJ COLOR PENCILS,PIECE,11,8000,74576,13424,88000,September
4022,NATARAJ JUMBO WAX CRAYONS,PIECE,3,6000,15254,2746,18000,September
4023,NATARAJ PENCILS 6000,PIECE,15,6000,76271,13729,90000,September
4024,NATARAJ PENS,PIECE,124,700,73559,13241,86800,September
4027,NATARAJ SETS,PIECE,3,10000,25424,4576,30000,September
4034,NEEK YOGHURT 1LTR,PIECE,6,7000,35593,6407,42000,September
4035,NEEK YOGHURT 300G 2000,PIECE,5,2500,10593,1907,12500,September
4036,NEEK YOGHURT 500G 3500,PIECE,9,3500,26695,4805,31500,September
4043,NESCAFE CLASSIC 100G,PIECE,4,25000,84746,15254,100000,September
4045,NESCAFE CLASSIC 2G,PIECE,42,500,17797,3203,21000,September
4046,NESCAFE CLASSIC 50G,PIECE,4,16000,54237,9763,64000,September
4052,NEVIA PEARL&BEAUTY ROLLON,PIECE,4,11000,37288,6712,44000,September
4055,NEWFARM BANANA JUICE 320ML,PIECE,6,2500,12712,2288,15000,September
4056,NEWFARM BANANA JUICE 500ML,PIECE,1,3500,2966,534,3500,September
4061,NEWMAN GONJA 200G,PIECE,4,5500,18644,3356,22000,September
4064,NEWMAN POTATO CRISPS 100G,PIECE,13,2962,32627,5873,38500,September
4065,NEWMAN POTATO CRISPS 500G,PIECE,1,12000,10169,1831,12000,September
4066,NEWMAN POTATO CRISPS 50G,PIECE,20,1500,25424,4576,30000,September
4073,NEWMAN'S POTATO CRISPS 180G,PIECE,5,5300,22458,4042,26500,September
4074,NEWMANS POTATO CRISPS 25G,PIECE,51,600,25932,4668,30600,September
4081,NICE CLEAR PENS,PIECE,8,500,3390,610,4000,September
4082,NICE TOOTHBRUSH,PIECE,16,1000,13559,2441,16000,September
4096,NIGHTROSE POWDER 1OOMLS,PIECE,3,4000,10169,1831,12000,September
4100,NIGINA 10000,PIECE,1,10000,8475,1525,10000,September
4107,NIGINA 8000,PIECE,1,8000,6780,1220,8000,September
4117,NISA CUCUMBER HAIR REMOVAL 20ML,PIECE,4,2000,6780,1220,8000,September
4118,NISA HAIR REMOVAL CUCUMBER 100ML,PIECE,1,10000,8475,1525,10000,September
4122,NISA HAIR REMOVAL ROSE 50ML,PIECE,2,7000,11864,2136,14000,September
4124,NISA NORMAL SKIN,PIECE,2,5500,9322,1678,11000,September
4125,NISA ROSE HAIR REMOVAL CREAM 20ML,PIECE,7,2000,11864,2136,14000,September
4126,NISA SOAP DRY SKIN,PIECE,3,5500,13983,2517,16500,September
4128,NIVANA 500MLS,PIECE,285,500,120763,21737,142500,September
4131,NIVANA WATER 1.5L,PIECE,75,1500,95339,17161,112500,September
4134,NIVEA BLACK & WHITE 50ML,PIECE,1,11000,9322,1678,11000,September
4135,NIVEA BLACK& WHITE INVISIBLE,PIECE,1,11000,9322,1678,11000,September
4137,NIVEA BLACK&WHITE ROLLON,PIECE,1,11000,9322,1678,11000,September
4139,NIVEA COOL KICK 400MLS,PIECE,1,20000,16949,3051,20000,September
4140,NIVEA COOL KICK ROLLON,PIECE,3,12000,30508,5492,36000,September
4141,NIVEA DEEP AMAZONIA,PIECE,1,11000,9322,1678,11000,September
4142,NIVEA DRY COMFORT ROLLON,PIECE,2,11000,18644,3356,22000,September
4143,NIVEA DRY IMPACT ROLLON,PIECE,4,11000,37288,6712,44000,September
4144,NIVEA DRYCOMFORT SPRAY,PIECE,1,17000,14407,2593,17000,September
4158,NIVEA MEN DEEP ROLLON,PIECE,2,11000,18644,3356,22000,September
4162,NIVEA MEN FRESH ACTIVE 50ML,PIECE,3,11000,27966,5034,33000,September
4167,NIVEA MEN MAXIMUM HYDRATION 400ML,PIECE,1,20000,16949,3051,20000,September
4168,NIVEA MEN REVITALIZING,PIECE,1,20000,16949,3051,20000,September
4173,NIVEA NOURISHING COCOA LOTION 400ML,PIECE,1,20000,16949,3051,20000,September
4178,NIVEA REPAIR& CARE 72H 400ML,PIECE,1,19000,16102,2898,19000,September
4190,NOMI 250G BUCKET,PIECE,9,4000,30508,5492,36000,September
4191,NOMI BUCKET 1KG,PIECE,8,12500,84746,15254,100000,September
4192,NOMI BUCKET 500G,PIECE,2,6500,11017,1983,13000,September
4195,NOTE BOOK 2000,PIECE,10,2500,21186,3814,25000,September
4196,NOTE BOOK 3000,PIECE,1,3000,2542,458,3000,September
4198,NOTE BOOK 4000,PIECE,5,4000,16949,3051,20000,September
4199,NOTE BOOK 5500,PIECE,7,5500,32627,5873,38500,September
4201,NOTE BOOK SPIRAL 10000,PIECE,2,10000,16949,3051,20000,September
4207,NOVICOL WOOD GLUE,PIECE,1,5000,4237,763,5000,September
4208,NOVIDA 350MLS,PIECE,74,1000,62712,11288,74000,September
4209,NOVIDA 500MLS,PIECE,43,1500,54661,9839,64500,September
4218,NUMA BUSHERA 1KG,PIECE,16,6500,88136,15864,104000,September
4219,NUMA BUSHERA 2KG,PIECE,9,12000,91525,16475,108000,September
4220,NUMA KARO 1KG,PIECE,2,6500,11017,1983,13000,September
4222,NUMA RICE FLOUR 1KG,PIECE,8,7500,50847,9153,60000,September
4223,NUMA SOYA RICE 1KG,PIECE,2,7000,11864,2136,14000,September
4229,NUSS CHOCOLATE,PIECE,34,1000,28814,5186,34000,September
4235,NUTRO CHOC CREAM WAFERS,PIECE,6,6500,33051,5949,39000,September
4236,NUTRO CHOCOLATE BISCUITS,PIECE,29,1200,29492,5308,34800,September
4239,NUTRO CREAM WAFERS 3,PIECE,8,6500,44068,7932,52000,September
4246,NUTRO STRAWBERRY,PIECE,2,1200,2034,366,2400,September
4247,NUTRO TEA BISCUIT,PIECE,11,4000,37288,6712,44000,September
4248,NUTRO VANILLA 30G,PIECE,52,1200,52881,9519,62400,September
4263,NUVITA CHOCO BISCUITS,PIECE,3,2000,5085,915,6000,September
4264,NUVITA CHOCOLATE CREAM,PIECE,7,1500,8898,1602,10500,September
4267,NUVITA GINGER BISCUITS 75G,PIECE,10,2000,16949,3051,20000,September
4270,NUVITA GLUCOSE 75G,PIECE,7,1500,8898,1602,10500,September
4271,NUVITA GO COOKIES,PIECE,19,2000,32203,5797,38000,September
4272,NUVITA LEMON BISCUITS 750,PIECE,3,1500,3814,686,4500,September
4274,NUVITA ORANGE CREAM BISCUITS,PIECE,3,1300,3305,595,3900,September
4275,NUVITA STRAWBERRY CREAMS 75G,PIECE,4,1500,5085,915,6000,September
4276,NUVITA VITAMILK BISCUITS,PIECE,11,1500,13983,2517,16500,September
4284,OATIBIX 500G,PIECE,5,12000,50847,9153,60000,September
4293,ODONIL DISINFECTANT,PIECE,12,7000,71186,12814,84000,September
4294,OFFICE GLUE 1KG,PIECE,1,7000,5932,1068,7000,September
4295,OFFICE GLUE 90G,PIECE,6,2000,10169,1831,12000,September
4296,OFFICE POINT PENS,PIECE,1,700,593,107,700,September
4297,OFFICE POINT STICK GLUE,PIECE,1,2000,1695,305,2000,September
4316,OLDSPICE FRESH DEODORANT 63G,PIECE,3,20000,50847,9153,60000,September
4324,OLITALIA OLIVE POMACE 100ML,PIECE,1,13000,11017,1983,13000,September
4326,OLIVE OIL BODY WHIP 444ML,PIECE,3,28000,71186,12814,84000,September
4334,OMO AUTO WASHING POWDER 1KG,PIECE,3,21000,53390,9610,63000,September
4335,OMO BLEACH COLOUR SAFE 700ML.,PIECE,5,9000,38136,6864,45000,September
4336,OMO BLEACH LEMON,PIECE,3,8000,20339,3661,24000,September
4339,OMO BLEACH REGULAR,PIECE,5,8000,33898,6102,40000,September
4340,OMO BLEACH REGULAR 250ML,PIECE,13,3500,38559,6941,45500,September
4342,OMO COMFORT 1KG,PIECE,5,13000,55085,9915,65000,September
4343,OMO COMFORT 500G,PIECE,6,7500,38136,6864,45000,September
4344,OMO FAST ACTION 1KG,PIECE,5,13000,55085,9915,65000,September
4345,OMO FAST ACTION 3.5KG,PIECE,5,40000,169492,30508,200000,September
4346,OMO FAST ACTION 500G,PIECE,4,7500,25424,4576,30000,September
4347,ONER APPLE JUICE DRINK,PIECE,124,2500,262712,47288,310000,September
4348,ONER BERRIES 300ML,PIECE,121,1500,153814,27686,181500,September
4349,ONER BERRIES JUICE DRINK,PIECE,98,2500,207627,37373,245000,September
4350,ONER MANGO 1LTR,PIECE,16,5000,67797,12203,80000,September
4351,ONER MANGO 500MLS,PIECE,112,2500,237288,42712,280000,September
4364,ORANGES 2000,PIECE,36,2292,69915,12585,82500,September
4365,ORCHID VALLEY APPLE 1LTR,PIECE,7,7500,44492,8008,52500,September
4367,ORCHID VALLEY GUAVA 1LTR,PIECE,5,7500,31780,5720,37500,September
4368,ORCHID VALLEY MANGO 1LTR6161101061483,PIECE,3,7500,19068,3432,22500,September
4416,OX FORD SETS 11000,PIECE,3,11000,27966,5034,33000,September
4430,PADLOCK 3000,PIECE,1,3000,2542,458,3000,September
4432,PADLOCK 4000,PIECE,2,4000,6780,1220,8000,September
4433,PADLOCK 5000,PIECE,1,5000,4237,763,5000,September
4444,PAMPER 2 L.C,PIECE,2,9000,15254,2746,18000,September
4447,PAMPER 3 L.C PANTS,PIECE,3,9000,22881,4119,27000,September
4449,PAMPER 4 JUMBO,PIECE,1,73000,61864,11136,73000,September
4450,PAMPER 4 L.C PANTS,PIECE,1,9000,7627,1373,9000,September
4451,PAMPER 4 PANTS H.C,PIECE,1,40000,33898,6102,40000,September
4453,PAMPER 5 JUMBO,PIECE,1,73000,61864,11136,73000,September
4454,PAMPER 5 L.C PANTS,PIECE,7,9000,53390,9610,63000,September
4464,PANASONIC AA,PIECE,3,2000,5085,915,6000,September
4465,PANASONIC AAA,PIECE,2,2000,3390,610,4000,September
4466,PANASONIC BIG,PIECE,4,6000,20339,3661,24000,September
4469,PANASUPER D,PIECE,5,3000,12712,2288,15000,September
4470,PANCHAVATI,PIECE,4,3000,10169,1831,12000,September
4473,PANT PEG 5000,PIECE,2,5000,8475,1525,10000,September
4475,PANT PEG COAT HANGER,PIECE,1,9000,7627,1373,9000,September
4484,PAPERLINE EXERCISE BK,PIECE,11,4000,37288,6712,44000,September
4494,PARLE MILK POWER BISCUITS 375G,PIECE,3,10000,25424,4576,30000,September
4495,PARLE NICE BISCUITS,PIECE,2,10000,16949,3051,20000,September
4496,PARLE-G BISCUITS,PIECE,3,10000,25424,4576,30000,September
4497,PARLE-G BISCUITS PCS,PIECE,4,2500,8475,1525,10000,September
4512,PEGS 6000,PIECE,1,6000,5085,915,6000,September
4515,PELIKAN COLOR PENCILS,PIECE,1,8000,6780,1220,8000,September
4520,PENCIL BAG 3500,PIECE,3,3500,8898,1602,10500,September
4522,PENCIL BAGS 3500 205,PIECE,1,3500,2966,534,3500,September
4534,PEPSI,PIECE,46,1500,58475,10525,69000,September
4535,PEPSI 2LTR,PIECE,35,4500,133475,24025,157500,September
4536,PEPSI 330ML,PIECE,79,1000,66949,12051,79000,September
4537,PEPSI MAX,PIECE,50,1000,42373,7627,50000,September
4539,PEPSODENT CAVITY 65G,PIECE,2,2500,4237,763,5000,September
4540,PEPSODENT CAVITY FIGHTER 150G,PIECE,8,5000,33898,6102,40000,September
4541,PEPSODENT HERBAL 65G,PIECE,9,2500,19068,3432,22500,September
4542,PEPSODENT HERBAL TRIPPLE140G,PIECE,8,5000,33898,6102,40000,September
4546,PEPTANG KETCHUP 400G,PIECE,3,8000,20339,3661,24000,September
4549,PEPTANG TOMATO SAUCE 400G,PIECE,6,5000,25424,4576,30000,September
4552,PERMANENT MAKER,PIECE,7,1000,5932,1068,7000,September
4575,PIAO PIAO TP ORIGINAL,PIECE,135,2000,228814,41186,270000,September
4577,PICFARE 192 PAGES 6000,PIECE,30,6000,152542,27458,180000,September
4578,PICFARE 2 QUIRE,PIECE,1,5000,4237,763,5000,September
4579,PICFARE 288PAGES 8500,PIECE,20,8000,135593,24407,160000,September
4580,PICFARE 4 QUIRE 10000,PIECE,6,10000,50847,9153,60000,September
4581,PICFARE 48PGS,PIECE,18,500,7627,1373,9000,September
4582,PICFARE 96 PGS 11000,PIECE,5,11000,46610,8390,55000,September
4583,PICFARE 96PGS,PIECE,32,1000,27119,4881,32000,September
4586,PICFARE GRAPH BOOK 96PGS,PIECE,1,3000,2542,458,3000,September
4588,PICFARE PENCILS 3000,PIECE,3,3000,7627,1373,9000,September
4589,PICFARE PENCILS PIECES 300,PIECE,2,300,508,92,600,September
4591,PICFARE RULED PAPER SMALL,PIECE,4,11000,37288,6712,44000,September
4592,PICFARE SET,PIECE,8,6000,40678,7322,48000,September
4594,PICH n PEEL TROPICAL MIX 1LTR,PIECE,6,9500,48305,8695,57000,September
4595,PICK n PEEL APPLE 1LTR,PIECE,6,9500,48305,8695,57000,September
4597,PICK n PEEL MANGO 1LTR,PIECE,9,9500,72458,13042,85500,September
4615,PK CHEWING GUM 500,PIECE,58,500,24576,4424,29000,September
4616,PK CHEWING GUM BIG,PIECE,52,1000,44068,7932,52000,September
4622,PLASTIC FOOD WRAP,PIECE,1,6500,5508,992,6500,September
4625,PLASTIC GLASSES 2500,PIECE,1,2500,2119,381,2500,September
4626,PLASTIC GLASSES 3500,PIECE,6,3500,17797,3203,21000,September
4638,PLASTIC WINE GLASSES 2500,PIECE,1,2500,2119,381,2500,September
4642,PLATES 3000,PIECE,4,3000,10169,1831,12000,September
4649,PLAYING CARDS,PIECE,5,1000,4237,763,5000,September
4653,PLUTO ADVANCED AA,PIECE,6,6000,30508,5492,36000,September
4664,POP & CONE SWEETS,PIECE,8,500,3390,610,4000,September
4665,POPPER 4500,PIECE,1,4500,3814,686,4500,September
4668,POPPER 8500,PIECE,3,8500,21610,3890,25500,September
4688,POTATO TRAINING CUP AQ819 18000,PIECE,1,20000,16949,3051,20000,September
4695,POULTRY VIENNAS 250G,PIECE,8,13000,88136,15864,104000,September
4696,POULTRY VIENNAS 500G,PIECE,12,22000,223729,40271,264000,September
4699,POWER PUFF SNACKS,PIECE,3,1000,2542,458,3000,September
4700,POWERPLAY 400MLS,PIECE,5,2000,8475,1525,10000,September
4705,PRADIP VANILLA CLEAR FLAVOURING,PIECE,2,5000,8475,1525,10000,September
4706,PRADIP VANILLA ESSENCE,PIECE,7,5000,29661,5339,35000,September
4710,PRATAP LUNCH BOX 13000,PIECE,1,13000,11017,1983,13000,September
4711,PREDATOR ENERGY DRINK,PIECE,10,2000,16949,3051,20000,September
4716,PRESTIGE 1KG,PIECE,1,14000,11864,2136,14000,September
4717,PRESTIGE 250G,PIECE,23,4500,87712,15788,103500,September
4718,PRESTIGE 500G,PIECE,12,7500,76271,13729,90000,September
4732,PRINCESS ULTRA PADS,PIECE,1,2700,2288,412,2700,September
4735,PRINGLES BBQ 40G,PIECE,1,5500,4661,839,5500,September
4737,PRINGLES CHEESY CHEESE 165G,PIECE,1,12000,10169,1831,12000,September
4742,PRINGLES ORIGINAL 165G BURSTING,PIECE,4,12000,40678,7322,48000,September
4743,PRINGLES ORIGINAL 40G,PIECE,5,6000,25424,4576,30000,September
4746,PRINGLES SOUR CREAM 165G,PIECE,3,12000,30508,5492,36000,September
4747,PRINGLES SOUR CREAM 40G,PIECE,6,6000,30508,5492,36000,September
4748,PRIVE BLACK OPTION BODYSPLASH,PIECE,1,16000,13559,2441,16000,September
4751,PRIVE EYE CANDY PARFUM,PIECE,2,16000,27119,4881,32000,September
4760,PRIVE SENA POUR FEMME,PIECE,2,16000,27119,4881,32000,September
4766,PROTEX CLASSIC 100G,PIECE,1,3500,2966,534,3500,September
4775,PROTEX GENTAL 90G,PIECE,3,3500,8898,1602,10500,September
4777,PROTEX HERBAL 150G,PIECE,3,6500,16525,2975,19500,September
4778,PROTEX HERBAL 90G,PIECE,2,4000,6780,1220,8000,September
4782,PUCELLE BLISSFUL SENSE 150ML,PIECE,1,8000,6780,1220,8000,September
4783,PUCELLE BLISSFUL SENSE 75ML,PIECE,1,5500,4661,839,5500,September
4790,PUCELLE JOLLY RYTHM 75ML,PIECE,1,5500,4661,839,5500,September
4791,PUCELLE JOYFUL SUMMER,PIECE,1,5500,4661,839,5500,September
4793,PUCELLE PURE AROOSAH 150ML,PIECE,1,8000,6780,1220,8000,September
4800,PUCELLE WAVY OCEAN 75ML,PIECE,1,5500,4661,839,5500,September
4803,PUFF HOLDERS 2000,PIECE,1,2000,1695,305,2000,September
4804,PUFF HOLDERS 3000,PIECE,1,3000,2542,458,3000,September
4806,PUFF HOLDERS PIN 4500,PIECE,1,4500,3814,686,4500,September
4829,RADIANT ANTIDUNDRUFF CREAM 60G,PIECE,2,3500,5932,1068,7000,September
4836,RADIANT HAIR DYE 120ML,PIECE,1,6000,5085,915,6000,September
4838,RADIANT HAIR DYE 25ML,PIECE,2,3000,5085,915,6000,September
4839,RADIANT HAIR FOOD 100G,PIECE,3,5000,12712,2288,15000,September
4843,RADIANT OLIVE OIL SPRAY 250MLS,PIECE,2,11000,18644,3356,22000,September
4849,RAHA COCOA 100G,PIECE,1,8000,6780,1220,8000,September
4850,RAHA COCOA 200G,PIECE,1,14000,11864,2136,14000,September
4851,RAHA DRINKING CHOCOLATE 100G,PIECE,1,7000,5932,1068,7000,September
4852,RAHA DRINKING CHOCOLATE 200G,PIECE,2,11000,18644,3356,22000,September
4875,RAYAN BLACK PERFUME,PIECE,3,12000,30508,5492,36000,September
4879,RAZAC HAND&BODY LOTION 40Z,PIECE,1,7500,6356,1144,7500,September
4890,RECEIPT BOOKS NORMAL,PIECE,2,3000,5085,915,6000,September
4896,RED BULL 250MLS,PIECE,21,7000,124576,22424,147000,September
4897,RED COCK 2KG,PIECE,2,27000,45763,8237,54000,September
4898,RED COCK BASMATI 1KG,PIECE,5,14000,59322,10678,70000,September
4901,REDCOCK RICE 5KG,PIECE,1,60000,50847,9153,60000,September
4902,RELAX NAPKINS,PIECE,21,2500,44492,8008,52500,September
4903,RELAX TP,PIECE,27,1500,34322,6178,40500,September
4933,RIBBONS 1000,PIECE,2,1000,1695,305,2000,September
4936,RIBENA 1LTR,PIECE,11,10000,93220,16780,110000,September
4937,RIBENA 250MLS,PIECE,8,3000,20339,3661,24000,September
4945,RIHAM COFFEE MALT,PIECE,24,1500,30508,5492,36000,September
4947,RIHAM COLA 320MLS,PIECE,7,1000,5932,1068,7000,September
4950,RIHAM CREAMY CRUNCH CHOCOLATE,PIECE,4,3500,11864,2136,14000,September
4951,RIHAM CREAMY CRUNCH STRAWBERRY,PIECE,11,3500,32627,5873,38500,September
4956,RIHAM EXOTIC TAMARIND,PIECE,14,1000,11864,2136,14000,September
4960,RIHAM ONER APPLE 300ML,PIECE,115,1500,146186,26314,172500,September
4961,RIHAM ONER MANGO 300ml,PIECE,131,1500,166525,29975,196500,September
4963,RIHAM VANILLA CREAMYCRUNCH,PIECE,6,3500,17797,3203,21000,September
4964,RIHAM WATER 1.5LTRS,PIECE,17,2000,28814,5186,34000,September
4965,RIHAM WATER 600ML,PIECE,12,1000,10169,1831,12000,September
4974,RINJU SHEA BUTTER 59ML,PIECE,1,7000,5932,1068,7000,September
4975,RINSUN 1LTR,PIECE,5,13000,55085,9915,65000,September
4984,ROCK BOOM 320MLS,PIECE,61,2000,103390,18610,122000,September
4985,ROCK BOOM CAN 250ML,PIECE,2,3000,5085,915,6000,September
4991,ROKI OIL 3LTRS,PIECE,4,27250,92373,16627,109000,September
4992,ROKI OIL 500ML,PIECE,5,5000,21186,3814,25000,September
5007,ROTATRIM,PIECE,3,25000,63559,11441,75000,September
5015,ROYALE BLUE SPRAY,PIECE,2,12000,20339,3661,24000,September
5016,ROYCO BEEF 200G,PIECE,6,6000,30508,5492,36000,September
5018,ROYCO BEEF 500G,PIECE,5,12000,50847,9153,60000,September
5020,ROYCO BEEF 60G,PIECE,1,1200,1017,183,1200,September
5021,ROYCO CHICKEN 200G,PIECE,6,6000,30508,5492,36000,September
5022,ROYCO CHICKEN 500G,PIECE,1,12000,10169,1831,12000,September
5023,ROYCO CHICKEN 60G,PIECE,3,1200,3051,549,3600,September
5025,ROYCO CUBES BEEF,PIECE,3,4000,10169,1831,12000,September
5026,ROYCO CURRY+MCHUZI,PIECE,1,6500,5508,992,6500,September
5028,RUBBER BAND 4000,PIECE,2,4000,6780,1220,8000,September
5031,RUGS 3000,PIECE,2,3000,5085,915,6000,September
5036,RWENZORI 1.5LTRS,PIECE,136,2000,230508,41492,272000,September
5043,RWENZORI WATER 500ML,PIECE,105,1000,88983,16017,105000,September
5048,SAFA HONEY 400G,PIECE,2,16000,27119,4881,32000,September
5049,SAFA TOMATO PASTE 400G,PIECE,2,6000,10169,1831,12000,September
5050,SAFA TOMATO PASTE 70GM,PIECE,34,1500,43220,7780,51000,September
5053,SAFARI TEA 50G,PIECE,5,2000,8475,1525,10000,September
5054,SAFEGUARD PURE WHITE SOAP160G,PIECE,1,3000,2542,458,3000,September
5062,SAFISHA OCEAN GLASSCLEANER,PIECE,2,10000,16949,3051,20000,September
5072,SALT SHAKERS 4000,PIECE,1,4000,3390,610,4000,September
5087,SANDALS 6000,PIECE,1,6000,5085,915,6000,September
5088,SANDALS 7000,PIECE,2,7000,11864,2136,14000,September
5090,SANTA LUCIA 250G,PIECE,37,2500,78390,14110,92500,September
5091,SANTA LUCIA 450G,PIECE,18,5000,76271,13729,90000,September
5095,SANTA LUCIA LUMACA,PIECE,5,6000,25424,4576,30000,September
5097,SANTA LUCIA RIGATONI 500G,PIECE,1,6000,5085,915,6000,September
5103,SAPIL CHICHI POUR FEMME BODYMIST,PIECE,1,16000,13559,2441,16000,September
5105,SAPIL PINK NANCY,PIECE,1,16000,13559,2441,16000,September
5143,SAVANNAH COCOPINE 3LTR,PIECE,1,24000,20339,3661,24000,September
5147,SAVANNAH MANGO 3LTR,PIECE,2,24000,40678,7322,48000,September
5151,SAVANNAH PINEAPPLE 2LTR,PIECE,1,19000,16102,2898,19000,September
5152,SAVANNAH PINEAPPLE 3LTR,PIECE,1,24000,20339,3661,24000,September
5155,SAVANNAH STRAWBERRY 3LTRS,PIECE,2,24000,40678,7322,48000,September
5167,SCHOOL SOCKS BLUE&WHITE 4000,PIECE,2,4500,7627,1373,9000,September
5168,SCHOOL SOCKS BLUE&WHITE ORIGINAL 7500,PIECE,1,7500,6356,1144,7500,September
5170,SCHOOL SOCKS RED/GREEN YELLOW,PIECE,6,4000,20339,3661,24000,September
5171,SCHOOL SOCKS WHITE 7000,PIECE,2,8500,14407,2593,17000,September
5174,SCHOOL STOCKINGS WHITE,PIECE,16,4500,61017,10983,72000,September
5181,SCOURING PADS 500,PIECE,1,500,424,76,500,September
5189,SCRUBBING BRUSH LONG 5000,PIECE,7,6429,38136,6864,45000,September
5197,SCRUBING HAND BRUSH 2000,PIECE,1,2000,1695,305,2000,September
5198,SCRUBING HAND BRUSH 3000,PIECE,6,3000,15254,2746,18000,September
5214,SENSITIVE BABY WIPES,PIECE,6,7000,35593,6407,42000,September
5219,SENSODYNE FRESH MINT 75ML,PIECE,6,16000,81356,14644,96000,September
5223,SENSODYNE MULTICARE 40MLS,PIECE,8,8500,57627,10373,68000,September
5229,SERVING SPOONS 3000,PIECE,3,3000,7627,1373,9000,September
5233,SESACO SOYACUP 150G,PIECE,1,4000,3390,610,4000,September
5235,SESAME SNACKS,PIECE,6,5000,25424,4576,30000,September
5236,SESAME SNACKS 100G,PIECE,4,2500,8475,1525,10000,September
5250,SHADES 6000,PIECE,1,6000,5085,915,6000,September
5252,SHAKERS 1000,PIECE,2,1000,1695,305,2000,September
5259,SHARPENER SMALL,PIECE,5,500,2119,381,2500,September
5260,SHARPENERS,PIECE,3,1000,2542,458,3000,September
5264,SHENKE COIL 4500,PIECE,4,4500,15254,2746,18000,September
5265,SHENKE FLOWER REPELLENT,PIECE,4,8000,27119,4881,32000,September
5267,SHENKE LEMON SCENT,PIECE,1,8000,6780,1220,8000,September
5268,SHENKE LOTUS SCENT,PIECE,2,8000,13559,2441,16000,September
5269,SHENKE MOSQUITO COIL,PIECE,1,6000,5085,915,6000,September
5270,SHENKE MOSQUITO COIL LOW SMOKE,PIECE,1,6000,5085,915,6000,September
5271,SHENKE MOSQUITO REPELANT HEATER,PIECE,1,25000,21186,3814,25000,September
5272,SHENKE MOSQUITO REPELLANT,PIECE,2,16000,27119,4881,32000,September
5274,SHENKE ORANGE,PIECE,4,8000,27119,4881,32000,September
5275,SHENKE REPELLANT ORDOLESS,PIECE,3,8000,20339,3661,24000,September
5281,SHIVA HONEY 250G,PIECE,1,8500,7203,1297,8500,September
5283,SHIVA HONEY 500G,PIECE,1,15000,12712,2288,15000,September
5287,SHOE BRUSH 5000,PIECE,4,5000,16949,3051,20000,September
5289,SHOE BRUSHES 1500,PIECE,3,1500,3814,686,4500,September
5301,SHOWER 2 SHOWER CONFIDENT,PIECE,3,6000,15254,2746,18000,September
5302,SHOWER CAPS,PIECE,7,2000,11864,2136,14000,September
5303,SHOWER TO SHOWER HAPPY DAYS,PIECE,4,6000,20339,3661,24000,September
5304,SHOWER TO SHOWER INVISIBLE DRY,PIECE,1,6000,5085,915,6000,September
5307,SHOWER TO SHOWER SPRING RAIN,PIECE,5,6000,25424,4576,30000,September
5313,SHOWERTO SHOWER MUSK ALIVE,PIECE,3,6000,15254,2746,18000,September
5314,SHOWERTOSHOWER FRESH DAWN,PIECE,1,6000,5085,915,6000,September
5323,SHREEJI GRAPH BOOK 48PGSS,PIECE,4,2000,6780,1220,8000,September
5324,SHREEJI GRAPH BOOK 96,PIECE,1,3000,2542,458,3000,September
5331,SHUYA 240 MM,PIECE,12,6000,61017,10983,72000,September
5332,SHUYA 280MM,PIECE,3,6000,15254,2746,18000,September
5333,SHUYA 330MM,PIECE,10,6000,50847,9153,60000,September
5334,SHUYA PANT LINERS,PIECE,10,6000,50847,9153,60000,September
5343,SILKEE CAR TISSUES,PIECE,2,7000,11864,2136,14000,September
5345,SILKEE DESIGNER SERVIETTES,PIECE,15,2500,31780,5720,37500,September
5347,SILKEE JUMBO TP,PIECE,141,2000,238983,43017,282000,September
5354,SILVER PLATE 1000,PIECE,61,1000,51695,9305,61000,September
5355,SILVER PLATE 300,PIECE,2,300,508,92,600,September
5356,SILVER PLATE 500,PIECE,34,500,14407,2593,17000,September
5361,SIMBA MBILI 200G,PIECE,1,9500,8051,1449,9500,September
5366,SIMKA CHOC- VAN 300ML,PIECE,13,3500,38559,6941,45500,September
5367,SIMKA CHOCO BAR 100MLS,PIECE,35,2500,74153,13347,87500,September
5368,SIMKA CHOC-VAN 120MLS,PIECE,142,1000,120339,21661,142000,September
5369,SIMKA CHOC-VAN 230MLS,PIECE,50,2000,84746,15254,100000,September
5370,SIMKA CHOC-VANILLA,PIECE,3,10000,25424,4576,30000,September
5371,SIMKA CHOC-VANILLA 500ML,PIECE,20,4500,76271,13729,90000,September
5373,SIMKA PINE-VANILLA 120ML,PIECE,2,1000,1695,305,2000,September
5374,SIMKA STRAW-VAN 120MLS,PIECE,243,1000,205932,37068,243000,September
5375,SIMKA STRAW-VAN 230MLS,PIECE,83,2000,140678,25322,166000,September
5376,SIMKA STRAW-VAN 300MLS,PIECE,33,3500,97881,17619,115500,September
5377,SIMKA STRAW-VAN 500MLS,PIECE,32,4500,122034,21966,144000,September
5378,SIMKA STRAW-VANILLA,PIECE,2,10000,16949,3051,20000,September
5379,SIMKA VANILLA 120MLS,PIECE,48,1000,40678,7322,48000,September
5380,SIMKA VANILLA 230MLS,PIECE,32,2000,54237,9763,64000,September
5381,SIMKA VANILLA 300MLS,PIECE,5,3500,14831,2669,17500,September
5382,SIMKA VANILLA 500MLS,PIECE,7,4500,26695,4805,31500,September
5387,SKALA ALOEVERA CREAM 200G,PIECE,1,4000,3390,610,4000,September
5391,SKALA FOR MEN JELLY,PIECE,1,4500,3814,686,4500,September
5393,SKALA MEN CREME,PIECE,3,4000,10169,1831,12000,September
5395,SKALA PAPAYA LOTION,PIECE,1,6000,5085,915,6000,September
5410,SKIN GUARD HAND WASH 550ML,PIECE,3,7000,17797,3203,21000,September
5433,SKY VIEW FRUITII 320ML,PIECE,17,1000,14407,2593,17000,September
5435,SKY VIEW ORANGE 320ML,PIECE,23,1000,19492,3508,23000,September
5436,SKYVIEW 320MLS,PIECE,29,1000,24576,4424,29000,September
5477,SMILE PENS WAVE 500,PIECE,50,500,21186,3814,25000,September
5481,SNICKERS CHOCOLATE,PIECE,8,3500,23729,4271,28000,September
5483,SNOWMAN MAKERS,PIECE,1,1000,847,153,1000,September
5490,SOAP DISH 10000,PIECE,1,10000,8475,1525,10000,September
5497,SOAP DISH KENPOLY 1000,PIECE,1,2000,1695,305,2000,September
5506,SOFINE MILK BRIGHTEN 1LTR,PIECE,2,20000,33898,6102,40000,September
5508,SOFINE PURE OLIVE OIL 120ML,PIECE,1,7500,6356,1144,7500,September
5509,SOFINE PURE OLIVE OIL 200ML,PIECE,2,10000,16949,3051,20000,September
5515,SOFT BROOM 15000,PIECE,4,15000,50847,9153,60000,September
5521,SOFT CARE BABY WIPES,PIECE,13,7000,77119,13881,91000,September
5522,SOFT COMFY BABY WIPES,PIECE,1,6000,5085,915,6000,September
5527,SOFTCARE BABY PANTS L40,PIECE,3,27000,68644,12356,81000,September
5528,SOFTCARE BABY PANTS M44,PIECE,2,27000,45763,8237,54000,September
5530,SOFTCARE L40,PIECE,2,25000,42373,7627,50000,September
5539,SOFTCARE SANITARY PADS,PIECE,26,3000,66102,11898,78000,September
5558,SOSOFT BABY 750MLS,PIECE,1,11000,9322,1678,11000,September
5565,SOSOFT VANILLA 750MLS,PIECE,1,11000,9322,1678,11000,September
5566,SOY SAUCE DARK 150G,PIECE,6,5000,25424,4576,30000,September
5567,SOY SAUCE DARK 500G,PIECE,5,10000,42373,7627,50000,September
5568,SOY SAUCE LIGHT 150G,PIECE,4,5000,16949,3051,20000,September
5591,SPLASH APPLE 1LTR,PIECE,12,8500,86441,15559,102000,September
5592,SPLASH APPLE 250MLS,PIECE,40,2000,67797,12203,80000,September
5594,SPLASH BOX 42000,BOX,2,45000,76271,13729,90000,September
5603,SPLASH MANGO 250MLS,PIECE,65,2000,110169,19831,130000,September
5604,SPLASH MANGO JUICE 1LTR,PIECE,26,8500,187288,33712,221000,September
5609,SPONGE 2000,PIECE,5,2000,8475,1525,10000,September
5610,SPONGE 3000,PIECE,27,3000,68644,12356,81000,September
5613,SPONGES 2500,PIECE,17,2500,36017,6483,42500,September
5615,SPONGES WHITE 3000,PIECE,2,3000,5085,915,6000,September
5619,SPOONS 5000,PIECE,2,2000,3390,610,4000,September
5624,SPRING FILE 3000,PIECE,8,3500,23729,4271,28000,September
5625,SPRITE 2LTR,PIECE,7,5000,29661,5339,35000,September
5626,SPRITE 350MLS,PIECE,30,1000,25424,4576,30000,September
5627,SPRITE 500MLS,PIECE,11,1500,13983,2517,16500,September
5630,SQUEEZERS 5000,PIECE,1,5000,4237,763,5000,September
5631,SQUEEZERS DOULBLE 10000,PIECE,4,10000,33898,6102,40000,September
5633,SQUISHY BLUE RASBERRY 200ML,PIECE,14,2000,23729,4271,28000,September
5634,SQUISHY FRUIT DRINK 200ML,PIECE,20,2000,33898,6102,40000,September
5635,SQUISHY FRUIT DRINK MANGO 200ML,PIECE,11,2000,18644,3356,22000,September
5636,SQUISHY STRAWBERRY 200ML,PIECE,11,2000,18644,3356,22000,September
5644,STAG SPRAY,PIECE,2,13000,22034,3966,26000,September
5651,STAR COFFEE 50G,PIECE,1,10000,8475,1525,10000,September
5656,STA-SOFT LAVENDER 750ML,PIECE,1,13000,11017,1983,13000,September
5658,STA-SOFT SPRING FRESH 750MLS,PIECE,1,13000,11017,1983,13000,September
5664,STELAR PADLOCK 94MM,PIECE,1,45000,38136,6864,45000,September
5667,GOLDER STICK NOTES,PIECE,7,2000,11864,2136,14000,September
5668,STICK NOTES 8000,PIECE,1,8000,6780,1220,8000,September
5671,STING,PIECE,39,2000,66102,11898,78000,September
5672,STING RED RUSH,PIECE,38,2000,64407,11593,76000,September
5673,STONEY 350MLS,PIECE,36,1000,30508,5492,36000,September
5674,STONEY 500MLS,PIECE,6,1500,7627,1373,9000,September
5693,STRAWBERRY PRADIP COLORED,PIECE,2,5000,8475,1525,10000,September
5717,SUGAR 1KG,PIECE,47,5021,200000,36000,236000,September
5724,SULFO GLYCERINE COLORLESS,PIECE,5,2500,10593,1907,12500,September
5725,SULFO GLYCERINE PINK,PIECE,3,2500,6356,1144,7500,September
5726,SULTAN COCONUT HAIL OIL,PIECE,5,5000,21186,3814,25000,September
5731,SUMZ COCONUT COOKIES,PIECE,3,4000,10169,1831,12000,September
5733,SUMZ CHOCOLATE COOKIES 200G,PIECE,3,4000,10169,1831,12000,September
5735,SUMZ CORN CRAX 160G,PIECE,16,3000,40678,7322,48000,September
5736,SUMZ CORN CRAX 80G,PIECE,31,1500,39407,7093,46500,September
5741,SUMZ CRISPS FRUIT CHUTNEY,PIECE,17,1500,21610,3890,25500,September
5743,SUMZ CRUNCHY DADDIES 150G,PIECE,2,3000,5085,915,6000,September
5744,SUMZ DADDIES 75G 1000,PIECE,18,1500,22881,4119,27000,September
5745,SUMZ DADDIES PKT 13000,PIECE,2,13000,22034,3966,26000,September
5746,SUMZ GINGER COOKIES,PIECE,3,4000,10169,1831,12000,September
5748,SUMZ GONJA 40G,PIECE,50,1500,63559,11441,75000,September
5749,SUMZ GONJA 90G CRISPS,PIECE,31,3000,78814,14186,93000,September
5750,SUMZ GONJA CRISPS 160G,PIECE,21,5500,97881,17619,115500,September
5753,SUMZ POTATO CRISP BBQ 30G,PIECE,45,1500,57203,10297,67500,September
5754,SUMZ POTATO CRISPS 180G,PIECE,34,5500,158475,28525,187000,September
5755,SUMZ POTATO CRISPS 20G,PIECE,326,600,165763,29837,195600,September
5756,SUMZ POTATO CRISPS 40G,PIECE,209,1500,265678,47822,313500,September
5757,SUMZ POTATO CRISPS 90G,PIECE,99,3000,251695,45305,297000,September
5758,SUMZ POTATO CRISPS TASTY TOMATO12G,PIECE,10,600,5085,915,6000,September
5761,SUMZ ROASTED NUTS 120G,PIECE,9,3000,22881,4119,27000,September
5762,SUMZ ROASTED NUTS 400G,PIECE,1,8000,6780,1220,8000,September
5763,SUMZ ROASTED NUTS 60G,PIECE,19,1500,24153,4347,28500,September
5764,SUMZ SALT&VINEGAR 30G,PIECE,13,1500,16525,2975,19500,September
5766,SUMZ TANGY LEMON CRISPS 30G,PIECE,4,1500,5085,915,6000,September
5767,SUMZS CRISPS 500G,PIECE,8,12000,81356,14644,96000,September
5768,SUN L DISH WASHING LIQUID400 ML,PIECE,3,7000,17797,3203,21000,September
5772,SUN SIP PASSION 2LTR,PIECE,2,11000,18644,3356,22000,September
5774,SUN SIP PASSION 5LTRS,PIECE,1,24000,20339,3661,24000,September
5778,SUNLIGHT DISH PASTE,PIECE,6,6417,32627,5873,38500,September
5780,SUNLIGHT DISHWASHING PASTE,PIECE,1,9000,7627,1373,9000,September
5784,SUNLIGHT LAVENDER 1KG,PIECE,2,11000,18644,3356,22000,September
5786,SUNLIGHT LAVENDER 500G,PIECE,4,5500,18644,3356,22000,September
5792,SUNLIGHT SOAP 175G,PIECE,4,3000,10169,1831,12000,September
5794,SUNLIGHT SPRING IKG,PIECE,5,11000,46610,8390,55000,September
5795,SUNLIGHT SPRING SENSATIONS 500G,PIECE,4,5500,18644,3356,22000,September
5796,SUNLIGHT TROPICAL 1KG,PIECE,3,11000,27966,5034,33000,September
5798,SUNLIGHT TROPICAL 500G,PIECE,6,5500,27966,5034,33000,September
5800,SUNQUICK BLACKCURRANT 700ML,PIECE,1,22000,18644,3356,22000,September
5804,SUNSEED OIL 3LTRS,PIECE,4,35000,118644,21356,140000,September
5807,SUNSHINE BEEF FLAVOR,PIECE,142,500,60169,10831,71000,September
5808,SUNSHINE CHICKEN FLAVOR,PIECE,86,500,36441,6559,43000,September
5809,SUNSHINE ONION FLAVOR,PIECE,102,500,43220,7780,51000,September
5810,SUNSHINE PLAIN FLAVOR,PIECE,105,500,44492,8008,52500,September
5811,SUNSHINE TOMATO FLAVOR,PIECE,119,500,50424,9076,59500,September
5812,SUN--SIP APPLE 2LTR,PIECE,2,11000,18644,3356,22000,September
5813,SUNSIP APPLE 3LTRS,PIECE,2,16000,27119,4881,32000,September
5814,SUNSIP APPLE 5LTR,PIECE,2,24000,40678,7322,48000,September
5815,SUNSIP BLACKCURRANT 3LTR,PIECE,3,16000,40678,7322,48000,September
5816,SUNSIP BLACKCURRANT 5LTR,PIECE,1,24000,20339,3661,24000,September
5817,SUN-SIP COCOPINE 3LTR,PIECE,2,16000,27119,4881,32000,September
5819,SUNSIP MANGO 5LTR,PIECE,1,24000,20339,3661,24000,September
5821,SUN-SIP STRAWBERRY 2LTR,PIECE,1,11000,9322,1678,11000,September
5822,SUNSIP STRAWBERRY 3LTR,PIECE,2,16000,27119,4881,32000,September
5830,SUNVEAT CREAMY STRAWBERRY,PIECE,23,1500,29237,5263,34500,September
5852,SUPREME BAKING FLOUR,PIECE,14,8643,102542,18458,121000,September
5859,SWEET IVORY PCS,PIECE,36,100,3051,549,3600,September
5864,SWEET PEPSI,PIECE,61,100,5169,931,6100,September
5865,SWEET PEPSI PKT 2000,PIECE,1,2000,1695,305,2000,September
5875,SWEETS 100,PIECE,235,100,19915,3585,23500,September
5876,SWEETS 1000,PIECE,7,1000,5932,1068,7000,September
5877,SWEETS 1500 ICECREAMM LOLLIPOP,PIECE,2,1500,2542,458,3000,September
5878,SWEETS 200,PIECE,244,200,41356,7444,48800,September
5879,SWEETS 300,PIECE,14,300,3559,641,4200,September
5881,SWEETS 500,PIECE,391,500,165678,29822,195500,September
5882,SWEETS 700 BIG FIVE,PIECE,52,700,30847,5553,36400,September
5902,SWIVVEL HANGERS MUKWANO,PIECE,1,13000,11017,1983,13000,September
5903,SWT BASMATI 1KG BLUE,PIECE,1,15000,12712,2288,15000,September
5904,SWT CHENAB 2KG,PIECE,1,28000,23729,4271,28000,September
5907,SWT-1 GREEN 2KG,PIECE,2,14000,23729,4271,28000,September
5909,SWT-1 RICE 1KG GREEN,PIECE,3,7500,19068,3432,22500,September
5921,TABLE KNIFE 15000,PIECE,1,15000,12712,2288,15000,September
5923,TABLE KNIFE PIECES 3000,PIECE,1,3000,2542,458,3000,September
5962,TEEPEE BRUSH A25,PIECE,3,3500,8898,1602,10500,September
5964,TEEPEE BRUSH A9,PIECE,1,3000,2542,458,3000,September
5965,TEEPEE LONG SCRUBING BRUSH,PIECE,1,9000,7627,1373,9000,September
5966,TEEPEE SCRUBBING BRUSH A1P,PIECE,1,6000,5085,915,6000,September
5977,TEMMY'S CHOCO SCOOPS 250G,PIECE,2,11000,18644,3356,22000,September
5979,TEMMY'S CORNFLAKES 250G,PIECE,6,10000,50847,9153,60000,September
5980,TEMMY'S CORNFLAKES 500G,PIECE,3,17000,43220,7780,51000,September
5999,TIAMO SWEETS,PIECE,2,200,339,61,400,September
6004,TICTAC ORANGE,PIECE,1,1500,1271,229,1500,September
6042,TOCEBAL AA,PIECE,3,1000,2542,458,3000,September
6043,TODAY WAFFERS,PIECE,4,1500,5085,915,6000,September
6049,TOILET BRUSH TEEPEE10000,PIECE,6,10000,50847,9153,60000,September
6068,TOOTHPICK 1000,PIECE,10,1000,8475,1525,10000,September
6069,TOOTHPICK NATURAL,PIECE,2,2500,4237,763,5000,September
6101,TOP UP 400G,PIECE,18,2000,30508,5492,36000,September
6102,TOP UP 700G,PIECE,5,4000,16949,3051,20000,September
6103,TOP UP CHILL 260G,PIECE,6,2000,10169,1831,12000,September
6116,TORCH 3500,PIECE,3,3500,8898,1602,10500,September
6137,TOTOS VESTLINE JELLY 100G,PIECE,3,3000,7627,1373,9000,September
6140,TOWELS 25000,PIECE,1,25000,21186,3814,25000,September
6185,TROPICAL HEAT BEEF MASALA 100G,PIECE,2,5000,8475,1525,10000,September
6188,TROPICAL HEAT CHICKEN MASALA 100G,PIECE,4,5000,16949,3051,20000,September
6189,TROPICAL HEAT CINNAMON 100G,PIECE,1,9500,8051,1449,9500,September
6190,TROPICAL HEAT CINNAMON 50G,PIECE,4,5000,16949,3051,20000,September
6200,TROPICAL HEAT GARLIC POWDER 50G,PIECE,1,5000,4237,763,5000,September
6201,TROPICAL HEAT GINGER 100G,PIECE,1,8500,7203,1297,8500,September
6202,TROPICAL HEAT GINGER 45G,PIECE,5,4000,16949,3051,20000,September
6203,TROPICAL HEAT MEAT TENDERISER50G,PIECE,1,4000,3390,610,4000,September
6206,TROPICAL HEAT MIXED SPICES 50G,PIECE,1,5000,4237,763,5000,September
6208,TROPICAL HEAT PAPRIKA,PIECE,1,4000,3390,610,4000,September
6210,TROPICAL HEAT PILAU MASALA 50G,PIECE,4,6000,20339,3661,24000,September
6215,TROPICAL HEAT TEA MASALA 100G,PIECE,1,10000,8475,1525,10000,September
6216,TROPICAL HEAT TEA MASALA 45G,PIECE,2,5500,9322,1678,11000,September
6217,TROPICAL HEAT TURMERIC 100G,PIECE,1,7500,6356,1144,7500,September
6218,TROPICAL HEAT TURMERIC 50G,PIECE,1,4000,3390,610,4000,September
6221,TROPICAL MINT SWEETS,PIECE,15,200,2542,458,3000,September
6268,U.S.A BEAUTY SOAP BLACK,PIECE,4,6500,22034,3966,26000,September
6270,UBISCO BUTTER BISCUITS 1KG,PIECE,1,18000,15254,2746,18000,September
6271,UBISCO CREAMS CHOCOLATE,PIECE,24,1017,20678,3722,24400,September
6272,UBISCO CREAMS VANILLA,PIECE,24,1000,20339,3661,24000,September
6273,UBISCO DIGESTIVE BISCUITS 1KG,PIECE,2,18000,30508,5492,36000,September
6275,"UBISCO DIGESTIVE, GINGER, CHOCOLATE 700G",PIECE,4,13000,44068,7932,52000,September
6279,UBISCO GINGER BISCUITS,PIECE,2,18000,30508,5492,36000,September
6280,UBISCO KREAMY CREAMS STRAWBERRY,PIECE,23,1026,20000,3600,23600,September
6281,UBISCO MILK&HONEY 108PKTS,PIECE,3,10000,25424,4576,30000,September
6288,U-FRESH MANGO,PIECE,8,700,4746,854,5600,September
6290,UGACHICK DRUMSTICK WHOLE 500G,PIECE,1,13000,11017,1983,13000,September
6304,UGANDA SAFARI TEA 100G,PIECE,2,4000,6780,1220,8000,September
6307,UGANDA TEA BAGS,PIECE,6,5500,27966,5034,33000,September
6308,UGANDA TEA BAGS 100BAGS,PIECE,5,9000,38136,6864,45000,September
6310,UKWAJU,PIECE,55,1500,69915,12585,82500,September
6317,UMBRELLAS 20000 POCKET,PIECE,1,20000,16949,3051,20000,September
6318,UMBRELLAS 8000,PIECE,1,8000,6780,1220,8000,September
6322,UMOJA SANDALS 6000,PIECE,1,7000,5932,1068,7000,September
6323,UMOJA SANDALS 8000,PIECE,5,10000,42373,7627,50000,September
6334,URBAN GWEKE 350G,PIECE,4,6500,22034,3966,26000,September
6366,V.L EXTRA HYDRATION LOTION 200ML,PIECE,4,8000,27119,4881,32000,September
6397,VASELINE ALOESOOTHE 200ML,PIECE,2,8000,13559,2441,16000,September
6398,VASELINE ALOESOOTHE LOTION 400ML,PIECE,1,14500,12288,2212,14500,September
6401,VASELINE BLUESEAL COCOA BUTTER250ML,PIECE,3,9500,24153,4347,28500,September
6402,VASELINE BLUESEAL MEN,PIECE,1,5000,4237,763,5000,September
6404,VASELINE BLUESEAL MEN FRESH 100ML,PIECE,4,5000,16949,3051,20000,September
6406,VASELINE BLUESEAL ORIGINAL 250ML,PIECE,3,9500,24153,4347,28500,September
6407,VASELINE COCOA GLOW 200ML,PIECE,6,8000,40678,7322,48000,September
6411,VASELINE COCOAGLOW LOTION 400G radiant,PIECE,4,14500,49153,8847,58000,September
6412,VASELINE DRY SKIN REPAIR 200ML,PIECE,1,8000,6780,1220,8000,September
6413,VASELINE DRY SKIN REPAIR LOTION 400ML,PIECE,1,15000,12712,2288,15000,September
6421,VASELINE MEN COOLING 400MLS,PIECE,1,14500,12288,2212,14500,September
6422,VASELINE MEN COOLING JELLY 240ML,PIECE,8,9500,64407,11593,76000,September
6424,VASELINE MEN EXTRA HYDRATION,PIECE,2,14500,24576,4424,29000,September
6427,VASELINE MEN JELLY FRESH 240ML,PIECE,2,9500,16102,2898,19000,September
6450,VESTLINE ALOEVERA 400ML,PIECE,1,6500,5508,992,6500,September
6451,VESTLINE ALOEVERA CREAM,PIECE,1,4000,3390,610,4000,September
6452,VESTLINE GARLIC 200G,PIECE,1,4000,3390,610,4000,September
6453,VESTLINE GARLIC JELLY 200G,PIECE,3,5000,12712,2288,15000,September
6458,VICTAN SINGLE VEST,PIECE,1,3000,2542,458,3000,September
6461,VICTOR CREME 120G,PIECE,1,2500,2119,381,2500,September
6468,VIM LAVENDER 1KG,PIECE,3,8000,20339,3661,24000,September
6469,VIM LAVENDER 500G,PIECE,7,5000,29661,5339,35000,September
6470,VIM LEMON 1KG,PIECE,3,8000,20339,3661,24000,September
6471,VIM LEMON FRESH 500G,PIECE,7,5000,29661,5339,35000,September
6474,VINEGAR WHITE 700MLS,PIECE,5,2500,10593,1907,12500,September
6496,WANDAZ PETROLEUM JELLY 250G,PIECE,2,6000,10169,1831,12000,September
6497,WANDAZ PETROLEUM JELLY 500G,PIECE,1,11500,9746,1754,11500,September
6533,WEET CORNFLAKES 750G,PIECE,3,25000,63559,11441,75000,September
6534,WEETABIX 112G,PIECE,16,4500,61017,10983,72000,September
6535,WEETABIX 225G,PIECE,4,8500,28814,5186,34000,September
6536,WEETABIX 37G 1000,PIECE,12,1200,12203,2197,14400,September
6537,WEETABIX 450G,PIECE,6,15500,78814,14186,93000,September
6544,WEETABIX CORNFLAKES 500G,PIECE,6,17000,86441,15559,102000,September
6548,WEETABIX OATIBIX 1KG,PIECE,2,20000,33898,6102,40000,September
6564,WHISPPEX SHAVERS,PIECE,17,3500,50424,9076,59500,September
6568,WHITE CHALK 5000,PIECE,2,5000,8475,1525,10000,September
6572,WHITE STAR SOAP 1KG,PIECE,59,6500,325000,58500,383500,September
6573,WHITE VINEGAR,PIECE,5,2500,10593,1907,12500,September
6579,WHITEDENT HERBAL 110G,PIECE,4,5000,16949,3051,20000,September
6580,WHITEDENT HERBAL 190G,PIECE,1,6500,5508,992,6500,September
6581,WHITEDENT HERBAL 250G,PIECE,2,8000,13559,2441,16000,September
6583,WHITEDENT HERBAL 70G,PIECE,4,3000,10169,1831,12000,September
6598,WISDOM SMOKERS TOOTHBRUSH,PIECE,1,3000,2542,458,3000,September
6606,WRAPPERS 500,PIECE,24,500,10169,1831,12000,September
6607,WRAPPING PAPER 1000,PIECE,4,1000,3390,610,4000,September
6614,YANAH COFFEE 5OG,PIECE,1,6000,5085,915,6000,September
6618,YARRISON BOXERS 3PCS 22000,PIECE,6,24000,122034,21966,144000,September
6619,YARRISON UNDER SHIRT 30000,PIECE,1,35000,29661,5339,35000,September
6620,YARRISON VESTS 3PCS 27000,PIECE,1,27000,22881,4119,27000,September
6642,YOJUS APPLE DRINK,PIECE,6,1000,5085,915,6000,September
6643,YOJUS MANGO 150ML,PIECE,29,1466,36017,6483,42500,September
6650,YOUR CHOICE SAUSAGE 1KG,PIECE,1,32000,27119,4881,32000,September
6651,YOUR CHOICE SAUSAGES 500G,PIECE,6,17000,86441,15559,102000,September
6665,ZESTA 300 G,PIECE,4,7500,25424,4576,30000,September
6666,ZESTA 500G,PIECE,5,11000,46610,8390,55000,September
6674,ZESTA STRAWBERRY JAM,PIECE,1,11000,9322,1678,11000,September
6676,ZESTA TOMATO KETCHUP,PIECE,10,7000,59322,10678,70000,September
6677,ZESTA TOMATO KETCHUP 700G,PIECE,3,12167,30932,5568,36500,September
6700,DOVE NOURISHING SECRETS RELAXING RITUAL 750ML,PIECE,3,30000,76271,13729,90000,September
6706,GLOW PERFUMED PETROLEUM 200G,PIECE,1,5500,4661,839,5500,September
6707,VASELINE BLUESEAL MEN COOLING 95ML,PIECE,11,5000,46610,8390,55000,September
6709,VASELINE BLUESEAL JELLY ORIGINAL 95ML,PIECE,3,5000,12712,2288,15000,September
6710,VASELINE BLUESEAL COCOA BUTTER 95ML,PIECE,8,5000,33898,6102,40000,September
6765,BIRTHDAY CANDLE 2K,PIECE,1,2000,1695,305,2000,September
6771,SUNLIGHT LAVENDER 2KG,PIECE,1,20000,16949,3051,20000,September
6773,VEGETABLE SAMOSA 1000,PIECE,194,1062,174576,31424,206000,September
6775,CHAPS 3000,PIECE,253,3000,643220,115780,759000,September
6776,KEBAB 3000,PIECE,92,3000,233898,42102,276000,September
6778,PILAO PLAIN 5000,PIECE,24,5783,117627,21173,138800,September
6779,PILAO PLAIN 10000,PIECE,254.8,10026,2164915,389685,2554600,September
6780,CHIPS PLAIN 5000,PIECE,6,6000,30508,5491,35999,September
6781,VEGETABLE RICE 7000,PIECE,237.73,6856,1381229,248621,1629850,September
6784,LIVER STEW 8000,PIECE,132.52,7668,861186,155014,1016200,September
6787,VEGETABLE RICE 3500,PIECE,8,3563,24153,4347,28500,September
6788,BEEF SAUSAGES 1000,PIECE,1239,1360,1428390,257110,1685500,September
6790,KATOGO 4000,PIECE,259,3916,859458,154702,1014160,September
6792,CHIPS 2500,PIECE,512.8,2527,1098136,197664,1295800,September
6794,KATOGO 2500,PIECE,2,2650,4492,808,5300,September
6795,KATOGO 2000,PIECE,1,2000,1695,305,2000,September
6796,JESA FRUIT BLUEBERRY 150G,PIECE,1,2500,2119,381,2500,September
6798,CADBURY DAIRY MILK 35G,PIECE,27,4000,91525,16475,108000,September
6805,PANCAKES 500,PIECE,557,500,236017,42483,278500,September
6807,BEAN STEW 2000,PIECE,251.32,1951,415610,74810,490420,September
6808,CRACKERS 1500,PIECE,132,2136,238983,43017,282000,September
6812,BEEF STEW 6000,PIECE,555,2003,941949,169551,1111500,September
6816,BLUE BAND 250G,PIECE,29,5000,122881,22119,145000,September
6817,BALLET BABY SOAP ALOEVERA,PIECE,1,4000,3390,610,4000,September
6820,BEEF SAMOSA 1500,PIECE,327,1500,415678,74822,490500,September
6821,CHAPATI 1000,PIECE,2542,1000,2153393,387611,2541004,September
6829,"SOFINE SHOWER GEL ROSE, TEA 750ML",PIECE,1,20000,16949,3051,20000,September
6831,JESA MIXED BERRY YOGHURT 250G,PIECE,10,2500,21186,3814,25000,September
6840,GONJA FRIED 1000,PIECE,201,1000,170339,30661,201000,September
6841,PIZZA CHICKEN SLICE BIG ,PIECE,204,6000,1037288,186712,1224000,September
6843,PIZZA BEEF SLICE BIG,PIECE,1,5000,4237,763,5000,September
6847,PIZZA 14'' CHICKEN ,PIECE,1,25000,21186,3814,25000,September
6848,PIZZA 16'' CHICKEN ,PIECE,9,35000,266949,48051,315000,September
6851,PIZZA 16'' BEEF,PIECE,1,35000,29661,5339,35000,September
6859,ROLEX NORMAL 2EGGS,PIECE,2,2750,4661,839,5500,September
6868,SPAGHETI 2500,PIECE,225.6,2456,469492,84508,554000,September
6876,"GREENS (NAKATI,DODO ETC)",PIECE,36.51,7415,229390,41290,270680,September
6884,SAFA TOMATO KETCHUP 340G,PIECE,1,6000,5085,915,6000,September
6885,JAGO SCRUB 110G,PIECE,2,5000,8475,1525,10000,September
6887,JESA BLUEBERRY FRUIT YOGHURT 450G,PIECE,1,6000,5085,915,6000,September
6889,EGGS BOILED 500,PIECE,121,500,51271,9229,60500,September
6894,SQUISHY JUICE APPLE,PIECE,9,2000,15254,2746,18000,September
6906,BRUSHES 2000,PIECE,3,3333,8475,1525,10000,September
6912,MELEX CORN CRAX 80G,PIECE,2,1200,2034,366,2400,September
6917,DEAR BODY WILD AT KISS SPLASH,PIECE,1,17000,14407,2593,17000,September
6918,"DEAR BODY BUBBLE DREAM,ROCKING",PIECE,1,17000,14407,2593,17000,September
6921,ZENDEN PLASTIC PLAYING CARDS ,PIECE,3,5000,12712,2288,15000,September
6930,JINYI EAR BUDS 1000,PIECE,2,2000,3390,610,4000,September
6936,JESA MIXED BERRY YOGHURT 500G,PIECE,23,3700,72119,12981,85100,September
6937,OMO BLEACH REGULAR 5LTR,PIECE,1,39000,33051,5949,39000,September
6943,SUMZ POTATO CRISPS FRUIT CHUTNEY 12G,PIECE,11,600,5593,1007,6600,September
6948,NIVEA DOULBLE EFFECT 48HRS,PIECE,2,11000,18644,3356,22000,September
6953,STRIKE NUTS CHOCOLATE BAR,PIECE,40,1000,33898,6102,40000,September
6961,STAR COFFEE 100G TIN,PIECE,1,17000,14407,2593,17000,September
6970,YAM SLICE 1000,PIECE,189,1000,160169,28831,189000,September
6971,SWEET POTATOES BOILED 1000,PIECE,220,1000,186441,33559,220000,September
6976,SUMZ POTATO CRIPS TASTY TOMATO 30G,PIECE,42,1500,63000,0,63000,September
6978,PUCELLE ELECTRIC SUNRISE 75ML,PIECE,1,5500,4661,839,5500,September
6983,STRIKE COCONUT CHOCOLATE BAR,PIECE,2,1000,1695,305,2000,September
6985,LA BELLE BODY LOTION SHEA BUTTER 250ML,PIECE,1,6000,5085,915,6000,September
6988,ELITE BALL PENS 500,PIECE,1,500,424,76,500,September
6990,PAPERLINE SHORTHAND NOTEBOOK,PIECE,1,2000,1695,305,2000,September
6991,GOLDER WHITE BOARD MARKER ,PIECE,11,1500,13983,2517,16500,September
6997,PELIKAN HB PENCILS 12PCS,PIECE,2,6000,10169,1831,12000,September
6999,CASIO SCIENTIFIC CALCULATORS WHITE ,PIECE,1,55000,46610,8390,55000,September
7000,MASTER MATH SET A006 5000,PIECE,1,5000,4237,763,5000,September
7002,M&G OFFICE SCISSORS 190MM,PIECE,1,6500,5508,992,6500,September
7008,GRILLED CHICKEN 8000,PIECE,118,8000,800000,144000,944000,September
7009,VENUS VITAMIN E 200ML LOTION,PIECE,1,6000,5085,915,6000,September
7010,"HIT ORANGE,GREEN TEA,NATURAL 750ML",PIECE,1,26000,22034,3966,26000,September
7015,JESA STRAWBERRY&CHOCOLATE 450G,PIECE,8,6000,40678,7322,48000,September
7025,FACE TOWELS 6000,PIECE,2,6000,10169,1831,12000,September
7026,CHICKEN STEW 4000,PIECE,236,4000,800000,144000,944000,September
7036,SOAP DISH 3500,PIECE,1,3500,2966,534,3500,September
7041,UBISCO BUTTER BISCUITS 700G,PIECE,1,15000,12712,2288,15000,September
7054,MARSHMALLOW TARBLEX LONG TWISTED,PIECE,12,2000,20339,3661,24000,September
7077,VASELINE BLUESEAL ALOEVERA 95ML,PIECE,8,5000,33898,6102,40000,September
7078,VASELINE BLUESEAL ALOEVERA 240ML,PIECE,3,9500,24153,4347,28500,September
7089,JAMIES WHITE SALT BREAD 500G,PIECE,2,3000,5085,915,6000,September
7095,RUBEE HAND$BODY LOTION 453G,PIECE,1,17500,14831,2669,17500,September
7096,FRESH BITE TOMATO KETCHUP 1OOPCS,PIECE,2,12000,20339,3661,24000,September
7101,JAMIES DADDIES TIN 17000,PIECE,11,16091,150000,27000,177000,September
7102,JAMIES DADDIES TIN 20000,PIECE,16,19375,262712,47288,310000,September
7108,RASASI YOYALE BLUE SPRAY ,PIECE,1,12000,10169,1831,12000,September
7112,PUMPKIN SLICE 1000,PIECE,139,1000,117797,21203,139000,September
7120,JAMIES DADDIES 500G 10000,PIECE,6,10000,50847,9153,60000,September
7130,JAMIES MUFFINS 2000,PIECE,91,2000,154237,27763,182000,September
7137,JAMIES COOKIES 2000,PIECE,6,2000,10169,1831,12000,September
7139,SUMZ BBQ CRISPS 12G,PIECE,15,600,7627,1373,9000,September
7142,JAMIES MARBLE CAKE 3000,PIECE,220,3000,559322,100678,660000,September
7143,GRAVY SOUP 1000,PIECE,38.52,990,32305,5815,38120,September
7144,JAMIES DOUGHNUT BIG CHOCOLATE 2500,PIECE,34,2500,72034,12966,85000,September
7146,JAMIES COOKIES TIN 500G 10000,PIECE,3,10000,25424,4576,30000,September
7147,JAMIES COOKIES 800G TIN 17000,PIECE,2,17000,28814,5186,34000,September
7149,SIMKA VANILLA 1LTR ,PIECE,3,12000,30509,5492,36001,September
7163,SPIDERMAN SWEETS 700,PIECE,10,700,5932,1068,7000,September
7165,ONER APPLE DRINK 1LTR,PIECE,16,5000,67797,12203,80000,September
7173,D.L FIESTA WHITE 70ML,PIECE,11,3000,27966,5034,33000,September
7178,VEGETABLE ROLEX 7000,PIECE,0.29,6993,1695,305,2000,September
7239,BEEF PILAU 20000,PIECE,4,5550,18814,3386,22200,September
7259,PLAIN CHIPS 7000,PIECE,3,3733,9492,1708,11200,September
7270,FRIED EGGS 5000,PIECE,1,2000,1695,305,2000,September
7278,JUICE 2000 300ML,PIECE,54,2000,91525,16475,108000,September
7279,JUICE 4000 500ml,PIECE,32,4000,108475,19525,128000,September
7284,SUMZ SALT& VIEGAR,PIECE,1,600,508,92,600,September
7295,PLASTIC SWINGING CANDLE 2500,PIECE,3,2500,6356,1144,7500,September
7303,AMERICAN CROWN VANILLA AIR.F 300ML,PIECE,1,7000,5932,1068,7000,September
7308,COTTON EAR SWABS 4000,PIECE,10,4000,33898,6102,40000,September
7312,SAPIL SECRET ROMANCE 15000,PIECE,1,15000,12712,2288,15000,September
7317,PRIVE CRAZY GIRL 250ML,PIECE,2,15000,25424,4576,30000,September
7328,MOSQUITO REPELLENT,PIECE,2,16000,27119,4881,32000,September
7336,MODY UNDER WEAR,PIECE,1,32000,27119,4881,32000,September
7344,COMB 1000,PIECE,5,1000,4237,763,5000,September
7346,LED TOUCH,PIECE,3,4000,10169,1831,12000,September
7349,BODY SCRUBBER GLOVE,PIECE,16,2500,33898,6102,40000,September
7350,WATER GUN 15000,PIECE,1,15000,12712,2288,15000,September
7361,SUMZ DADDIES 300G,PIECE,2,5000,8475,1525,10000,September
7364,SUMZ BAGGIA 100G,PIECE,3,3000,7627,1373,9000,September
7365,SUMZ BAGGIA 50G,PIECE,8,1500,10169,1831,12000,September
7373,VASELINE BLUESEAL BABY 240ML,PIECE,4,9500,32203,5797,38000,September
7374,JAMIES WHOLE SALE SWEET YELLOW 5000,PIECE,87,5000,368644,66356,435000,September
7375,JAMIES WHOLE SALE SWEET BROWN 5000,PIECE,83,5000,351695,63305,415000,September
7376,JAMIES WHOLE SALE SWEET WHITE 5000,PIECE,110,5000,466102,83898,550000,September
7380,AFROCARE PERFUMED JELLY 500G,PIECE,1,10000,8475,1525,10000,September
7383,MOVIT BABY JELLY 200G,PIECE,2,5500,9322,1678,11000,September
7384,JESA FRUIT SALAD PROBIOTIC 150G,PIECE,3,2500,6356,1144,7500,September
7387,HB PENCILS,PIECE,1,2000,1695,305,2000,September
7388,HIKMA YELLOW BAGIYA 4000,PIECE,1,4500,3814,686,4500,September
7389,HIKMA YELLOW BAGIYA 2000,PIECE,8,1500,10169,1831,12000,September
7390,HIKMA BAGIYA 1500,PIECE,12,1458,14831,2669,17500,September
7391,HIKMA BAGIYA 2500,PIECE,6,2500,12712,2288,15000,September
7392,HIKMA DADDIES 5000,PIECE,11,5909,55085,9915,65000,September
7393,HIKMA DADDIES 2000,PIECE,9,2500,19068,3432,22500,September
7394,HIKMA G.NUTS 3000,PIECE,6,2000,10169,1831,12000,September
7396,JAMIES SWEET WHITE WHOLESALE 500G 2500,PIECE,100,2500,211864,38136,250000,September
7397,JAMIES SWEET YELLOW 500G WHOLE SALE 2500,PIECE,93,2500,197034,35466,232500,September
7398,JAMIES SWEET BROWN 500G WHOLE SALE 2500,PIECE,100,2500,211864,38136,250000,September
7407,FAX LIQUID SOAP OCEAN 400ML,PIECE,1,8000,6780,1220,8000,September
7408,DURU LUX SHOWER GEL ORCHID 450ML,PIECE,1,17000,14407,2593,17000,September
7409,SAFISHA DISINFECTANT WHITE BALLS 200GM,PIECE,2,7800,13220,2380,15600,September
7410,ONER TAMARIND 500ML,PIECE,66,2500,139831,25169,165000,September
7419,Sandals,PIECE,3,8001,20341,3661,24002,September
7421,JAMIES COOKIES 300G 7000,PIECE,5,7000,29661,5339,35000,September
7426,JAMIES SWEET CAKE BREAD WHOLESALE 5000,PIECE,8,5000,33898,6102,40000,September
7427,COLGATE CLEAN MINT 10500,PIECE,1,11000,9322,1678,11000,September
7430,JAMIES SWEET YELLOW BUNS WHOLESALE 2500,PIECE,300,2500,635593,114407,750000,September
7431,JAMIES MARBLE CAKE 10000,PIECE,1,20000,16949,3051,20000,September
7432,FRESCO BODY OIL 100ML 4000,PIECE,2,5000,8475,1525,10000,September
7436,MOODLENA NOODLES CHICKEN 1000,PIECE,9,1000,7627,1373,9000,September
7438,YARRISON KIDS VESTS18000,PIECE,4,22000,74576,13424,88000,September
7445,COSMO SHOWER GEL CHERRY BLOSSOM ,PIECE,2,25000,42373,7627,50000,September
7454,MOPPER 3000,PIECE,4,3000,10169,1831,12000,September
7463,JAMIES CAKE @150K,PIECE,1,150000,127119,22881,150000,September
7467,C.B SALTED CARAMEL ALMOND 500ML,PIECE,1,24000,20339,3661,24000,September
7470,C.B CHOCOLATE CHOCO CHIP 2LTRS ,PIECE,1,38000,32203,5797,38000,September
7473,ARTIN MASSAGE OIL OLIVE OIL 1LTR,PIECE,3,13000,33051,5949,39000,September
7476,MENTOS MINT 29G,PIECE,11,2500,23305,4195,27500,September
7483,DOVE ROLL ON CUCUMBER 50ML,PIECE,1,11000,9322,1678,11000,September
7486,APPLES PACKED 11000,PIECE,6,11000,55932,10068,66000,September
7488,VERSMAN ACTIVE LOTION 400ML,PIECE,1,17000,14407,2593,17000,September
7492,CS MUKENESNACK 100G 3500,PIECE,1,7000,5932,1068,7000,September
7497,JAMIES SWEET BUNS BROWN 6PCS WHOLESALE,PIECE,337,2500,713983,128517,842500,September
7522,JUST WOW 250ML,PIECE,1,15000,12712,2288,15000,September
7524,TOYS 2000,PIECE,1,2000,1695,305,2000,September
7526,DOCTORS KIT DOLL 20000,PIECE,1,20000,16949,3051,20000,September
7527,BALLS 2000,PIECE,1,2000,1695,305,2000,September
7543,DOLLS3000,PIECE,1,2000,1695,305,2000,September
7544,DOLLS 5000,PIECE,1,5000,4237,763,5000,September
7547,TOYS 15000,PIECE,3,13333,33898,6102,40000,September
7550,TOYS 20000,PIECE,1,20000,16949,3051,20000,September
7552,TOYS 5000,PIECE,4,5750,19492,3508,23000,September
7553,TOYS 3000,PIECE,2,3000,5085,915,6000,September
7554,AFIA LEMON 500ML,PIECE,10,3000,25424,4576,30000,September
7560,SCOURING PAD 2000,PIECE,1,2000,1695,305,2000,September
7566,HISCENTS LADY,PIECE,1,15000,12712,2288,15000,September
7571,SAPIL PROMISE,PIECE,1,16000,13559,2441,16000,September
7581,GULF ORCHID INTO THE NIGHT,PIECE,1,15000,12712,2288,15000,September
7587,ONER TAMARIND 300ML,PIECE,11,1500,13983,2517,16500,September
7590,WEETABIX SUPER SAVER 850G,PIECE,3,27000,68644,12356,81000,September
7592,COLGATE CHARCOAL 210G 10000,PIECE,11,11000,102542,18458,121000,September
7593,COLGATE CHARCOAL 35G 2500,PIECE,13,2500,27542,4958,32500,September
7602,DURU ORGANIK KARPUZ GEL 450ML,PIECE,1,17000,14407,2593,17000,September
7605,BRUT MUSK 48H DRY ROLL 50ML,PIECE,1,10000,8475,1525,10000,September
7612,HB PICFARE PENCIL 2500,PIECE,1,2000,1695,305,2000,September
7620,SPRITE CAN 330ML,PIECE,17,3000,43220,7780,51000,September
7629,TROPIKAL FRUIT COCKTAIL FRSHENER 300ML,PIECE,2,13000,22034,3966,26000,September
7630,TROPIKAL SPECIAL EDITION FRESHENER 300ML,PIECE,2,13000,22034,3966,26000,September
7633,CLERE COCOA BUTTER 400ML,PIECE,1,8000,6780,1220,8000,September
7645,SOFTCARE GOLD XL36,PIECE,2,25000,42373,7627,50000,September
7647,SKY VIEW APPLE 320ML,PIECE,25,1000,21186,3814,25000,September
7650,JAMIES SWEET WHITE BUNS @4000,PIECE,169,4000,572881,103119,676000,September
7652,HOT DOGS 3000,PIECE,1,4000,3390,610,4000,September
7656,JAMIES MANDAZ 1000,PIECE,5,1000,4237,763,5000,September
7667,SCHOOL SOCKS WHITE 6000,PIECE,1,6000,5085,915,6000,September
7687,NOTE BOOK 6500,PIECE,5,6500,27542,4958,32500,September
7691,CONTAINER 23000,PIECE,1,23000,19492,3508,23000,September
7701,CLEAR BAGS 1500,PIECE,12,1500,15254,2746,18000,September
7703,TOYS 1000,PIECE,1,1000,847,153,1000,September
7704,JAMIES MILK BREAD 5500,PIECE,164,6000,833898,150102,984000,September
7705,JAMIES CAKE SLICE@8000,PIECE,42,8000,284746,51254,336000,September
7706,JAMIES MILK BREAD 500G,PIECE,51,3500,151271,27229,178500,September
7707,JAMIES COOKIES@20000,PIECE,14,20000,237288,42712,280000,September
7719,SECRETS PADS ULTRA DAY&NIGHT PINK,PIECE,4,5500,18644,3356,22000,September
7724,JAMIES DOUGHNUTS SMALL 6PCS,PIECE,7,3000,17797,3203,21000,September
7726,DABUR CHARCOAL 150G,PIECE,6,7000,35593,6407,42000,September
7727,JAMIES SWEET WHITE BUNS WHOLESALE,PIECE,286,2500,715000,0,715000,September
7746,SWEETS 1500,PIECE,7,1500,8898,1602,10500,September
7748,BAKEMATE LOVE 1500,PIECE,6,1000,5085,915,6000,September
7754,DOLL 10000,PIECE,1,10000,8475,1525,10000,September
7762,PRINGLES PAPRIKA,PIECE,1,5500,4661,839,5500,September
7770,PREDATOR ENERGY 350ML,PIECE,19,2000,32203,5797,38000,September
7783,MENTOS PEACH ORANGE,PIECE,12,2500,25424,4576,30000,September
7784,TOUCH AKY,PIECE,15,1267,16102,2898,19000,September
7789,JAMIES DANISH BREAD@3500,PIECE,14,3500,41525,7475,49000,September
7790,JAMIES CINNAMON BREAD,PIECE,189,6889,1103390,198610,1302000,September
7808,PICNIK CHOCOLATE 10G,PIECE,7,1000,5932,1068,7000,September
7812,FLAMINGO LEMON&HONEY 200G,PIECE,1,3500,2966,534,3500,September
7815,7UP 330ML,PIECE,45,1000,38136,6864,45000,September
7816,FRUIT VILLE STRAWBERRY BANANA 500ML,PIECE,14,3500,41525,7475,49000,September
7826,JAMIES CINNAMON BREAD 500G,PIECE,57,3500,169068,30432,199500,September
7829,KICK PRINCESS CHICKEN FLAVOUR ,PIECE,157,500,66525,11975,78500,September
7831,7UP 500ML,PIECE,19,1500,24153,4347,28500,September
7832,FANEST BEEF SAUSAGES 500G,PIECE,1,13000,11017,1983,13000,September
7837,TEMMYS CRISP RICE 250G,PIECE,1,10000,8475,1525,10000,September
7844,DOVE GO FRESH 250ML,PIECE,1,21000,17797,3203,21000,September
7856,GIFT BAG 2000,PIECE,6,2000,10169,1831,12000,September
7857,MOOISTE CHOCOLATE,PIECE,11,2500,23305,4195,27500,September
7860,WASH -Q KIDS TOOTH BRUSH ,PIECE,5,1000,4237,763,5000,September
7867,ROCK BOOM 500ML,PIECE,40,3000,101695,18305,120000,September
7871,DOVE ESSENTIAL CARE LOTION 400ML,PIECE,1,19000,16102,2898,19000,September
7874,DOVE RESTORING CARE 400ML,PIECE,2,19000,32203,5797,38000,September
7876,GRILLED GOATS MEAT 8000,PIECE,40,8050,272881,49119,322000,September
7878,BLUE BAND WITH CHOCO 250G,PIECE,10,6500,55085,9915,65000,September
7882,ELEGANT LADY BLUE A.F 300ML,PIECE,1,7000,5932,1068,7000,September
7884,ROKI COOKING OIL 1L,PIECE,5,8100,34322,6178,40500,September
7886,PAKA MATCH BOX,PIECE,1,1000,847,153,1000,September
7888,REXONA INVISIBLE DRY FRESH ROLLON 72JAM,PIECE,2,10000,16949,3051,20000,September
7895,NUVITA BUTTER COOKIES 100GM,PIECE,10,2500,21186,3814,25000,September
7899,PRETTY BE PINK PETALS PERFUMED 250ML,PIECE,1,16000,13559,2441,16000,September
7901,YULU CLASSIC BOXERS 3PCS 22000,PIECE,6,24000,122034,21966,144000,September
7903,BLUE BAND WITH CHOCO 500G,PIECE,5,11000,46610,8390,55000,September
7905,SAFEGUARD LEMON SOAP,PIECE,2,1500,2542,458,3000,September
7906,SAFEGUARD PURE WHITE ,PIECE,1,1500,1271,229,1500,September
7907,WEETABIX CORNFLAKES CRUNCHY 250G,PIECE,6,11000,55932,10068,66000,September
7909,ONER APPLE DRINK 200ML,PIECE,68,1000,57627,10373,68000,September
7910,ONER MANGO 200ML,PIECE,80,1000,67797,12203,80000,September
7911,RIHAM X ENERGY 400ML,PIECE,10,2000,16949,3051,20000,September
7912,COSMO SHOWERGELS MIX VAN.STRAW.TROPICAL 1LTR,PIECE,1,25000,21186,3814,25000,September
7913,CLERE BABY JELLY 50G,PIECE,2,2000,3390,610,4000,September
7915,"AMERICAN CROWN LAVENDER A.F, CITRU, LEMON",PIECE,1,7000,5932,1068,7000,September
7918,JAMIES MILK BREAD WHOLESALE 1KG,PIECE,2,5500,9322,1678,11000,September
7921,SOFTCARE BABY PANTS M9,PIECE,1,9000,7627,1373,9000,September
7923,7UP SODA 2LTR,PIECE,13,4500,49576,8924,58500,September
7927,AMARA MACADAMIA LOTION 400ML,PIECE,1,8500,7203,1297,8500,September
7928,MASKING TAPE 4000,PIECE,1,4000,3390,610,4000,September
7929,GROW NATURAL HONEY 400G,PIECE,3,12000,30508,5492,36000,September
7932,DOWNY LUXURY PERFUME 900ML ,PIECE,4,24000,81356,14644,96000,September
7933,WEETABIX CORNFLAKES 50G,PIECE,6,2000,10169,1831,12000,September
7937,DOWNY FRESH SCENT SUNRISE 900ML,PIECE,2,24000,40678,7322,48000,September
7939,DOWNY FRESH SCENT SNURISE 300ML,PIECE,1,8500,7203,1297,8500,September
7942,HIKMA YELLOW BAGIYA 1500,PIECE,1,1500,1271,229,1500,September
7943,HIKMA DADDIES 1000,PIECE,1,1000,847,153,1000,September
7944,HIKMA YELLOW BAGIYA 2500,PIECE,3,2500,6356,1144,7500,September
7953,SAFISHA SCOURING PAD,PIECE,7,2000,11864,2136,14000,September
7954,ROYCO 2-IN-1 200G,PIECE,1,6500,5508,992,6500,September
7955,JAMIES DADDIES TIN 7000,PIECE,1,7000,5932,1068,7000,September
7956,JAMIES COOKIES TIN 7000,PIECE,1,7000,5932,1068,7000,September
7957,NSUUBE ROASTED GROUND COFFEE 65G,PIECE,2,4000,6780,1220,8000,September
7959,"ANKIT CRIMBLES STRAWBERY BISCUIT, VAN,CHO ",PIECE,3,4500,11441,2059,13500,September
7960,BERTINI OLIVE OIL EXTRA VIRGIN 250ML,PIECE,1,15000,12712,2288,15000,September
7961,REXONA ADVANCED BRIGHTENING ROLL ON,PIECE,1,10000,8475,1525,10000,September
7962,PIAO PIAO SANITARY PADS ULTRA THIN,PIECE,6,4000,20339,3661,24000,September
7963,PIAO PIAO SANITARY PADS EXTRA LENGTH,PIECE,3,4000,10169,1831,12000,September
7966,TIFFANY NUTTYBITES ALMOND,PIECE,1,2500,2119,381,2500,September
7969,CREMCA GOLDEN BITES BUTTER COOKIES,PIECE,2,2500,4237,763,5000,September
7972,MARSHMALLOW TIANS CONFECTION 327G,PIECE,1,22000,18644,3356,22000,September
7974,KIVUUVU 1000,PIECE,67,1000,56780,10220,67000,September
7975,WISDOM JUNIOR TOOTHBRUSH,PIECE,2,2500,4237,763,5000,September
7976,ACE TOILET CLEANER OCEAN FRESH 250ML,PIECE,2,5000,8475,1525,10000,September
7977,BIRTHDAY CANDLE NO. 3500,PIECE,1,3500,2966,534,3500,September
7980,KINGKAT 1500,PIECE,2,1500,2542,458,3000,September
7987,SOFTCARE BABY PANTS L8,PIECE,3,9000,22881,4119,27000,September
7988,OASIS HAND WASH 500ML,PIECE,3,7000,17797,3203,21000,September
7990,GONJA FRIED 1500,PIECE,58,1500,73729,13271,87000,September
7991,COLGATE TOOTHBRUSH KIDS 2000,PIECE,9,2000,15254,2746,18000,September
7992,JOHNSON BABY JELLY FRANGRANCE FREE 250ML,PIECE,1,16000,13559,2441,16000,September
7994,SAVANNAH STRAWBERRY 2LTRS,PIECE,1,19000,16102,2898,19000,September
7995,SAVANNAH PUNCH 3LTRS,PIECE,2,24000,40678,7322,48000,September
7997,NUVITA COOKIES APPLE CINNAMON 100G,PIECE,7,2500,14831,2669,17500,September
7999,TIC TACK CHOCOLATE 27G 1500/ TOUCH CHOC.,PIECE,23,1500,29237,5263,34500,September
8000,BREAKTIME WAFER 1000,PIECE,7,1000,5932,1068,7000,September
8001,AMERICAN CROWN CHERRY BLOSSOM A.F,PIECE,2,7000,11864,2136,14000,September
8002,AMERICAN CROWN APPLE& CINNAMON A.F,PIECE,1,7000,5932,1068,7000,September
8003,ELEGANT AIR FRESHNER MISTIQUE,PIECE,2,7000,11864,2136,14000,September
8004,VERSMAN LOTION 100ML,PIECE,4,6000,20339,3661,24000,September
8005,DOWNY LAVENDER CALM 300ML,PIECE,1,8500,7203,1297,8500,September
8006,UKWAJU TAMARIND 500ML,PIECE,12,3000,30508,5492,36000,September
8007,SUNQUICK EXOTIC FRUITS 700ML/ MANDARIN ,PIECE,2,22000,37288,6712,44000,September
8008,RWENZORI DUPLICATING PAPER,PIECE,4,20000,67797,12203,80000,September
8009,OFFICE POINT STICK GLUE 40G,PIECE,13,3500,38559,6941,45500,September
8011,GOLDER HIGHLIGHTER 2000,PIECE,9,2000,15254,2746,18000,September
8012,OFFICE POINT STAPLER ,PIECE,1,15000,12712,2288,15000,September
8015,DAIMA BUTTERSCOTCH 250ML,PIECE,8,4500,30508,5492,36000,September
8016,DAIMA VANILLA ICECREAM 250ML,PIECE,5,4500,19068,3432,22500,September
8017,C.B JOOSTICK STRAWBERRY,PIECE,2,2500,4237,763,5000,September
8019,SKALA FOR MEN JELLY 500G,PIECE,1,10000,8475,1525,10000,September
8021,SKALA ACTIVE BODY SPRAY 50ML,PIECE,1,6000,5085,915,6000,September
8022,"DOVE BABY LOVE RESTORING CARE LOTION 250ML,LIGHT CARE",PIECE,3,15000,38136,6864,45000,September
8024,NICE&LOVELY LOTION 600ML COCOA BUTTER,PIECE,2,15000,25424,4576,30000,September
8026,OASIS AROMATIC HANDWASH 500ML MIX,PIECE,2,7000,11864,2136,14000,September
8027,MEN BOXERS 8000,PIECE,4,8000,27119,4881,32000,September
8028,CERES FRUIT JUICE RED GRAPE 1LTR,PIECE,3,17000,43220,7780,51000,September
8029,"GALAXY BELLA SPRAYS, MIDNIGHT,YOURWAY ",PIECE,2,13000,22034,3966,26000,September
8030,LEGEND FEMME BODY SPLASH 250ML ,PIECE,1,16000,13559,2441,16000,September
8031,"ARMAF BODY SPRAY DE LA,HIGH STREET ,SHADES",PIECE,1,13000,11017,1983,13000,September
8032,"SMART COLLECTION PERFUME 393,449,227",PIECE,2,20000,33898,6102,40000,September
8033,HIKMA BAGIYA BIG 5500,PIECE,3,5500,13983,2517,16500,September
8034,HIKMA HARD CONES 5000,PIECE,3,5000,12712,2288,15000,September
8035,HIKMA BAGIYA 2000,PIECE,2,3250,5508,992,6500,September
8037,PEGS SLIM 1000,PIECE,5,1000,4237,763,5000,September
8040,STICK SIENA CHOCOLATE,PIECE,4,1500,5085,915,6000,September
8041,MAGNIFICENT CHOCOLATES 1500,PIECE,11,1500,13983,2517,16500,September
8042,LUNCH BOX WITH BOTTLE SET 23000,PIECE,1,23000,19492,3508,23000,September
8045,CADBURY DAIRYMILK BUBBLY MILK CHOCOLATE,PIECE,2,4000,6780,1220,8000,September
8046,JAMIES LUSANIYA 16250,PIECE,30,16250,413136,74364,487500,September
8048,PICK 'N' PEEL RED GRAPE 1LTR,PIECE,2,9500,16102,2898,19000,September
